user_id,Business,Design,IT,Other,N_Skills
1,0,0,1,1,2
2,0,0,2,4,6
3,0,0,2,1,3
5,0,0,3,8,11
6,0,0,2,4,6
7,0,0,4,3,7
8,0,0,1,4,5
9,0,0,0,8,8
10,0,1,3,5,9
11,0,0,14,21,35
12,0,0,12,38,50
13,0,0,3,8,11
14,0,0,3,7,10
15,0,0,3,2,5
16,0,0,6,6,12
17,0,0,7,4,11
18,0,0,8,17,25
19,1,0,2,2,5
20,0,0,4,7,11
22,0,0,7,18,25
24,1,0,8,20,29
25,0,0,2,6,8
26,0,2,9,12,23
27,0,2,7,15,24
28,0,0,8,17,25
30,0,0,2,7,9
31,0,1,8,34,43
32,0,0,1,0,1
33,0,0,2,14,16
34,0,3,10,37,50
35,0,1,6,17,24
36,0,0,5,13,18
37,0,0,2,4,6
38,0,0,5,14,19
39,0,0,6,17,23
40,0,0,1,5,6
41,0,0,6,5,11
42,0,0,2,6,8
43,0,0,8,6,14
44,0,1,4,18,23
45,0,1,2,9,12
46,0,0,5,8,13
47,0,0,2,7,9
48,0,0,17,24,41
49,0,0,8,22,30
50,0,0,5,19,24
51,0,0,0,11,11
53,0,0,1,9,10
54,0,0,5,10,15
55,0,0,15,20,35
56,0,1,6,6,13
57,0,1,12,27,40
58,1,0,7,16,24
59,0,0,6,4,10
60,0,0,9,14,23
61,0,1,8,19,28
62,0,0,5,12,17
63,0,0,10,40,50
64,0,0,4,12,16
65,0,0,1,4,5
66,0,0,5,1,6
67,0,0,10,10,20
68,0,0,4,3,7
70,0,0,3,10,13
71,0,0,3,9,12
72,0,0,4,2,6
73,0,0,8,17,25
74,0,0,2,4,6
75,0,2,10,15,27
76,0,0,4,3,7
77,0,1,1,9,11
79,0,0,1,6,7
80,0,1,2,32,35
81,0,0,8,41,49
82,0,0,9,25,34
83,0,0,5,3,8
84,0,0,3,8,11
85,0,2,18,18,38
86,0,0,5,4,9
87,0,0,7,20,27
88,0,0,2,5,7
89,0,0,5,2,7
90,0,0,2,1,3
91,0,0,2,6,8
92,0,1,11,10,22
93,0,0,7,4,11
94,1,0,6,8,15
95,0,0,4,7,11
96,0,0,3,6,9
97,0,0,3,8,11
99,0,0,11,16,27
100,0,2,6,32,40
101,0,0,0,1,1
102,0,1,4,5,10
103,0,2,0,5,7
104,0,0,8,5,13
106,0,0,2,3,5
107,0,0,3,0,3
108,0,0,2,6,8
110,0,0,9,22,31
112,0,1,2,8,11
113,0,0,3,5,8
114,0,0,8,19,27
115,0,0,14,36,50
116,0,0,2,9,11
117,0,0,1,4,5
118,0,0,4,3,7
119,0,1,5,20,26
120,0,0,5,5,10
121,0,0,6,17,23
122,0,1,8,19,28
123,0,0,1,14,15
124,0,0,4,8,12
125,1,0,6,7,14
126,0,0,9,13,22
127,0,0,1,1,2
128,0,0,0,12,12
129,0,0,0,15,15
130,0,0,9,17,26
131,0,0,13,30,43
132,1,2,12,23,38
133,0,0,9,20,29
134,0,0,8,19,27
135,0,0,4,18,22
136,0,0,18,32,50
137,0,0,8,15,23
138,0,0,2,1,3
139,0,0,4,11,15
140,0,0,5,5,10
141,0,0,3,8,11
142,0,0,9,13,22
143,0,0,4,8,12
144,0,0,2,4,6
145,0,0,4,3,7
146,0,0,2,3,5
147,0,0,2,6,8
148,0,0,1,1,2
149,0,2,6,32,40
150,1,0,18,31,50
151,0,0,13,30,43
152,0,0,2,3,5
153,0,3,10,37,50
154,0,0,11,16,27
155,0,0,1,14,15
156,0,2,6,32,40
157,0,0,1,0,1
158,0,0,6,17,23
159,0,0,18,32,50
160,1,0,18,31,50
161,1,0,18,31,50
162,0,0,4,15,19
163,0,1,5,20,26
164,0,0,14,36,50
165,0,0,4,11,15
166,0,0,8,17,25
167,0,0,9,22,31
168,0,1,2,8,11
169,0,0,1,0,1
170,0,0,2,6,8
171,0,1,2,32,35
172,0,2,6,32,40
173,0,0,1,1,2
174,0,2,4,6,12
175,0,0,12,14,26
176,0,0,7,10,17
177,0,0,1,2,3
179,0,0,3,6,9
180,0,0,4,3,7
181,0,0,5,9,14
182,0,0,1,2,3
183,0,0,2,8,10
184,1,0,1,6,8
186,0,0,5,21,26
187,1,0,4,8,13
188,0,1,3,20,24
189,0,0,2,7,9
190,0,0,2,10,12
191,0,1,9,30,40
192,0,0,5,15,20
193,0,0,1,4,5
194,0,0,3,7,10
195,0,0,8,19,27
196,0,0,3,6,9
197,0,0,2,3,5
198,0,2,11,21,34
199,0,1,11,17,29
200,0,0,7,15,22
201,1,4,10,23,38
202,0,0,2,11,13
203,0,1,3,12,16
204,0,0,7,11,18
205,0,0,8,22,30
206,0,1,7,33,41
207,0,0,6,13,19
209,0,0,3,24,27
210,0,0,11,32,43
211,0,0,7,11,18
212,0,0,2,14,16
213,0,0,4,11,15
214,0,0,2,4,6
215,0,0,4,7,11
216,0,0,5,9,14
217,0,0,4,14,18
218,0,0,5,10,15
219,0,0,9,17,26
220,0,0,7,13,20
221,0,0,3,5,8
222,0,1,9,17,27
223,0,2,6,25,33
224,0,0,7,18,25
225,0,0,3,10,13
226,0,0,6,26,32
227,0,0,9,14,23
228,0,1,11,31,43
229,0,0,2,9,11
230,0,0,3,22,25
231,0,0,2,6,8
233,0,1,9,6,16
234,0,0,0,8,8
235,0,0,1,12,13
236,0,1,8,13,22
237,0,0,7,10,17
238,0,1,9,11,21
239,0,0,14,27,41
240,0,0,5,24,29
241,0,0,5,16,21
242,0,0,1,4,5
243,1,0,0,31,32
244,0,0,11,17,28
245,0,0,0,5,5
246,0,0,11,20,31
247,0,1,4,2,7
248,0,0,6,6,12
249,0,0,8,11,19
250,0,0,6,12,18
251,0,0,7,12,19
253,0,0,1,12,13
254,0,0,1,5,6
255,0,0,2,11,13
256,0,0,14,27,41
257,0,0,3,18,21
258,0,0,2,7,9
259,0,0,15,21,36
260,0,0,3,7,10
261,0,0,4,5,9
262,0,0,1,4,5
263,0,1,14,35,50
264,0,1,5,13,19
265,0,0,2,11,13
266,0,1,6,5,12
267,0,0,6,4,10
268,0,0,13,26,39
269,0,0,3,14,17
270,0,0,7,8,15
271,0,4,7,23,34
272,0,2,4,6,12
273,0,0,6,11,17
274,0,0,0,7,7
276,0,0,6,7,13
277,0,0,3,7,10
278,0,0,3,12,15
279,0,0,1,4,5
280,0,0,4,9,13
281,0,0,4,24,28
282,0,0,4,14,18
283,0,0,2,8,10
284,0,0,4,9,13
285,0,1,5,8,14
286,0,0,7,21,28
288,0,0,7,14,21
289,0,1,3,7,11
290,0,6,2,15,23
291,0,0,3,9,12
292,0,0,10,14,24
293,0,0,18,31,49
294,0,0,5,13,18
295,0,0,6,10,16
296,0,0,8,17,25
297,0,0,5,6,11
298,0,1,14,20,35
299,0,1,7,21,29
300,1,1,1,28,31
301,0,0,7,10,17
302,0,0,2,3,5
304,0,1,12,19,32
305,0,1,6,6,13
306,0,0,9,7,16
307,0,0,9,18,27
308,0,0,12,18,30
309,0,0,6,19,25
310,0,0,9,14,23
311,0,0,6,5,11
312,0,0,5,7,12
313,0,0,2,1,3
314,0,0,6,18,24
315,0,0,5,15,20
316,0,0,5,7,12
317,0,0,4,5,9
318,0,0,1,14,15
319,0,0,9,16,25
320,0,0,5,7,12
321,0,0,16,23,39
322,0,0,7,9,16
323,0,1,3,5,9
325,0,1,4,17,22
327,0,0,11,28,39
328,0,0,4,16,20
329,0,0,3,6,9
330,0,0,5,10,15
332,0,0,6,10,16
333,0,0,5,12,17
334,0,0,6,12,18
335,0,0,3,5,8
336,0,0,3,7,10
337,0,0,9,15,24
338,0,0,4,21,25
339,0,0,1,4,5
340,0,0,9,9,18
341,0,1,10,27,38
342,0,0,3,2,5
343,0,0,1,4,5
345,0,0,9,8,17
346,0,0,4,7,11
347,0,0,8,18,26
348,0,0,7,19,26
349,0,1,3,7,11
350,0,0,3,6,9
351,0,0,8,16,24
352,0,0,7,11,18
353,0,0,5,4,9
355,0,0,4,5,9
356,0,1,6,22,29
357,0,1,4,4,9
358,0,1,18,31,50
359,0,0,5,3,8
360,0,0,2,6,8
361,0,0,9,13,22
362,0,0,4,14,18
363,0,0,5,7,12
364,0,0,5,10,15
365,0,0,4,13,17
366,0,0,3,8,11
367,0,1,1,7,9
368,0,1,11,34,46
369,0,0,3,4,7
370,0,0,8,15,23
371,0,0,3,10,13
372,0,4,15,31,50
373,0,1,10,12,23
374,1,0,1,6,8
375,0,0,1,4,5
376,0,0,6,15,21
377,0,0,5,7,12
378,0,10,8,28,46
379,0,0,8,8,16
380,0,0,5,6,11
381,1,0,4,13,18
383,0,0,4,2,6
384,0,0,0,6,6
385,0,0,4,7,11
386,0,0,6,8,14
387,0,0,9,21,30
388,0,0,4,10,14
389,0,0,12,8,20
390,0,2,8,8,18
392,0,0,2,5,7
393,0,0,8,13,21
394,0,2,3,9,14
395,0,0,6,4,10
396,0,0,5,11,16
397,0,1,3,8,12
398,0,1,6,32,39
399,0,0,1,1,2
400,0,0,1,3,4
401,0,0,4,12,16
402,0,1,4,20,25
403,0,0,2,3,5
404,0,0,7,20,27
405,0,0,4,12,16
406,0,1,6,18,25
407,1,0,4,19,24
408,0,0,6,7,13
409,1,3,15,31,50
410,0,0,12,14,26
411,0,0,0,6,6
413,0,0,7,19,26
414,0,0,2,3,5
416,0,0,11,16,27
417,0,0,5,9,14
418,0,2,6,32,40
419,0,0,12,18,30
420,0,0,9,6,15
421,0,0,14,36,50
422,0,0,13,30,43
423,0,0,7,11,18
424,0,0,4,4,8
425,0,0,8,10,18
426,0,0,2,7,9
427,0,0,4,11,15
428,0,0,4,7,11
429,1,0,3,17,21
430,0,0,11,29,40
431,0,1,9,11,21
432,0,0,8,11,19
433,1,3,15,31,50
434,0,0,8,7,15
435,0,0,11,10,21
436,0,2,4,8,14
437,0,0,1,12,13
438,0,0,5,5,10
439,0,0,0,13,13
440,0,0,10,16,26
441,2,1,3,22,28
442,0,0,10,20,30
443,0,1,12,19,32
444,0,0,4,5,9
445,0,0,3,5,8
446,0,0,3,4,7
447,0,0,0,6,6
448,0,0,5,9,14
449,0,1,12,19,32
450,0,0,1,7,8
451,0,0,8,19,27
452,0,0,8,14,22
453,0,0,2,6,8
454,0,0,10,24,34
455,0,0,3,24,27
456,0,0,3,22,25
457,0,0,1,7,8
458,0,0,5,6,11
459,0,0,1,1,2
460,0,0,18,32,50
461,2,2,4,42,50
462,0,0,12,14,26
463,0,2,6,32,40
464,0,0,5,6,11
465,0,2,3,29,34
466,0,0,2,3,5
467,1,0,18,31,50
468,1,3,15,31,50
469,0,0,13,30,43
470,0,0,2,7,9
471,0,0,11,16,27
472,0,0,7,11,18
473,1,0,4,13,18
474,0,0,1,14,15
475,0,0,6,19,25
476,2,2,4,42,50
477,0,0,18,32,50
478,0,2,6,32,40
479,0,1,10,37,48
480,1,0,18,31,50
481,0,0,7,12,19
482,1,0,18,31,50
483,0,0,10,24,34
484,0,2,6,32,40
485,0,0,2,6,8
486,0,6,2,15,23
487,2,2,4,42,50
488,0,0,5,6,11
489,0,1,9,13,23
490,0,1,3,4,8
491,2,0,8,26,36
492,0,0,12,14,26
493,0,2,5,6,13
494,0,0,1,3,4
495,0,0,4,7,11
496,0,0,0,2,2
497,1,0,9,26,36
498,0,0,6,8,14
499,0,2,12,35,49
500,0,0,14,25,39
501,0,3,10,18,31
502,0,0,9,28,37
503,0,0,15,24,39
504,0,1,6,12,19
506,0,0,5,9,14
507,0,0,8,19,27
508,1,0,3,14,18
509,0,1,9,25,35
510,0,0,10,40,50
511,0,1,8,12,21
512,0,1,1,7,9
513,0,0,10,20,30
514,0,0,7,18,25
515,0,0,1,4,5
516,0,0,4,11,15
517,0,0,5,7,12
518,0,0,7,20,27
519,0,1,2,11,14
520,0,0,6,11,17
521,0,1,14,33,48
522,0,0,14,32,46
523,1,0,2,13,16
524,0,0,9,23,32
525,0,2,5,25,32
526,0,0,3,14,17
527,0,0,1,21,22
528,0,0,0,3,3
529,0,0,4,14,18
530,0,0,9,20,29
531,0,0,7,12,19
532,0,0,5,25,30
533,0,0,15,35,50
534,0,0,2,3,5
535,0,0,2,12,14
536,0,0,0,8,8
537,0,1,0,20,21
538,0,0,6,14,20
539,0,0,3,8,11
540,0,0,17,24,41
541,0,0,3,16,19
542,0,0,0,10,10
543,0,0,2,3,5
544,0,0,1,1,2
545,0,0,6,19,25
546,0,1,7,11,19
547,0,0,2,16,18
548,0,0,3,3,6
549,0,0,7,9,16
550,0,0,3,5,8
551,0,0,6,17,23
552,0,1,10,19,30
553,0,2,18,30,50
554,0,0,7,23,30
555,0,0,4,2,6
556,0,0,16,29,45
557,1,0,7,42,50
558,0,0,6,10,16
559,0,1,3,3,7
560,0,0,7,11,18
561,0,0,9,23,32
562,1,0,5,34,40
563,0,0,4,10,14
564,0,1,3,4,8
565,0,0,4,11,15
566,0,1,4,9,14
567,0,1,7,10,18
569,0,0,2,7,9
570,0,1,3,12,16
571,0,0,6,9,15
572,0,0,1,6,7
573,0,1,3,7,11
574,0,0,8,13,21
575,0,0,8,12,20
577,0,0,9,10,19
578,0,0,5,4,9
580,0,0,9,20,29
581,0,0,7,13,20
582,0,0,2,4,6
583,0,0,3,8,11
584,0,0,2,5,7
585,0,0,4,7,11
586,0,0,1,4,5
587,0,1,8,16,25
588,0,0,1,8,9
589,0,0,1,2,3
590,0,0,2,6,8
591,0,0,6,20,26
593,0,0,0,6,6
594,0,0,4,10,14
595,0,0,2,8,10
596,0,2,7,6,15
597,0,1,8,19,28
598,0,1,2,5,8
599,0,0,4,5,9
600,0,0,8,16,24
601,0,0,7,9,16
602,0,0,13,29,42
603,0,0,3,12,15
604,0,0,7,14,21
605,0,0,5,20,25
606,0,0,3,3,6
607,0,0,5,8,13
608,0,0,2,10,12
609,0,0,6,13,19
610,0,0,6,13,19
611,0,0,3,5,8
612,0,0,0,2,2
613,0,0,9,11,20
614,0,1,4,6,11
615,0,1,4,9,14
616,0,0,10,33,43
617,0,0,1,4,5
618,0,0,1,15,16
619,0,0,8,4,12
620,1,0,7,37,45
621,0,1,9,13,23
622,0,0,6,13,19
623,0,0,1,8,9
624,0,1,7,16,24
625,0,0,4,8,12
626,0,0,2,9,11
627,0,0,11,26,37
628,0,0,0,3,3
629,1,0,8,9,18
630,0,0,9,13,22
631,0,0,2,4,6
632,0,1,9,28,38
633,0,0,3,7,10
634,0,0,1,3,4
636,0,2,5,6,13
637,0,1,4,14,19
638,0,0,4,7,11
639,0,0,3,9,12
640,0,0,4,1,5
641,0,0,6,11,17
642,0,0,6,10,16
643,0,0,3,8,11
644,0,0,4,4,8
645,0,0,4,7,11
646,0,0,3,6,9
647,0,0,5,8,13
648,0,0,7,22,29
649,0,0,2,6,8
650,0,0,3,7,10
651,0,0,17,24,41
652,0,0,12,14,26
653,0,0,2,3,5
654,1,0,14,23,38
655,0,0,6,19,25
656,2,0,8,26,36
657,0,2,6,32,40
658,0,0,11,23,34
659,0,0,1,0,1
660,0,0,7,12,19
661,0,0,5,11,16
662,0,1,11,36,48
663,0,1,6,18,25
664,0,0,0,7,7
665,0,0,6,26,32
666,0,0,5,10,15
667,0,0,9,28,37
668,0,1,11,14,26
669,0,5,13,28,46
670,0,0,1,6,7
671,0,0,10,17,27
672,0,0,6,6,12
673,0,0,3,20,23
674,0,3,7,39,49
675,0,0,9,13,22
676,0,0,13,16,29
677,0,0,9,23,32
678,0,0,8,17,25
679,0,1,8,17,26
680,0,0,12,14,26
681,0,0,0,6,6
682,0,0,11,23,34
683,0,2,6,32,40
684,0,0,3,6,9
685,0,0,2,6,8
686,0,0,4,4,8
687,0,0,6,9,15
688,0,0,1,4,5
689,1,0,18,31,50
690,0,1,8,20,29
691,0,0,3,3,6
692,0,2,6,32,40
693,1,0,18,31,50
694,1,0,18,31,50
695,0,0,2,6,8
696,0,2,6,32,40
697,0,0,9,5,14
698,0,0,5,9,14
699,0,0,6,6,12
700,0,0,2,7,9
701,0,1,9,17,27
702,0,0,17,33,50
703,0,0,5,2,7
704,0,0,15,35,50
705,0,0,8,25,33
706,0,1,3,5,9
707,0,0,7,14,21
708,0,1,5,20,26
709,0,0,19,26,45
711,0,0,16,34,50
712,0,0,5,2,7
713,0,0,7,16,23
714,0,0,6,14,20
715,0,0,7,38,45
716,0,0,6,26,32
717,0,0,3,8,11
718,0,0,3,10,13
719,0,0,6,11,17
720,0,0,6,12,18
721,0,0,6,12,18
722,0,0,7,7,14
723,0,0,7,11,18
724,0,0,21,28,49
725,0,0,7,9,16
726,0,0,12,28,40
727,0,0,9,15,24
728,0,0,1,4,5
729,1,1,7,18,27
730,0,1,7,4,12
731,0,0,14,22,36
732,0,1,7,26,34
733,0,0,2,10,12
734,0,0,13,25,38
735,0,0,7,18,25
736,0,0,5,22,27
737,0,0,1,4,5
738,0,0,1,11,12
739,0,0,10,26,36
740,0,0,6,12,18
741,1,0,6,7,14
742,1,0,3,10,14
743,0,0,15,29,44
744,0,1,12,14,27
745,0,0,3,2,5
746,0,0,0,5,5
747,2,3,10,35,50
748,0,2,9,12,23
749,0,0,5,8,13
750,0,0,8,19,27
751,0,0,2,4,6
752,0,0,6,11,17
753,0,0,6,17,23
754,0,0,9,20,29
755,0,0,0,3,3
756,0,1,7,4,12
757,1,0,1,4,6
758,0,0,3,14,17
759,0,0,8,12,20
761,0,0,6,6,12
762,0,0,4,8,12
763,0,0,12,31,43
764,0,0,1,11,12
765,0,1,4,8,13
766,0,0,8,21,29
767,0,0,12,10,22
768,0,0,11,20,31
769,1,0,7,20,28
770,0,0,6,11,17
771,0,0,5,0,5
773,0,4,1,11,16
774,0,0,0,5,5
775,0,1,3,13,17
776,0,1,8,16,25
777,0,0,4,4,8
778,0,0,0,5,5
779,0,0,2,6,8
780,0,0,0,5,5
781,0,0,5,13,18
782,0,1,5,12,18
783,1,3,15,31,50
784,0,0,6,4,10
785,0,0,15,35,50
786,0,0,8,8,16
787,0,0,6,16,22
788,0,1,12,25,38
789,0,0,4,12,16
790,0,0,1,4,5
791,0,2,6,32,40
792,0,0,7,13,20
793,0,0,2,7,9
794,0,0,2,17,19
795,0,0,5,9,14
796,0,1,8,27,36
797,0,0,8,22,30
798,0,0,15,24,39
799,0,0,5,2,7
800,0,2,7,25,34
801,0,0,12,18,30
802,0,0,4,33,37
803,0,0,3,15,18
804,0,0,4,20,24
805,0,0,5,3,8
806,0,0,11,26,37
807,1,1,8,22,32
808,0,0,10,16,26
809,0,0,13,20,33
810,0,1,16,18,35
811,0,2,9,12,23
812,0,0,8,21,29
813,0,0,15,10,25
814,0,0,3,12,15
815,0,0,2,19,21
816,0,0,4,11,15
817,1,3,15,31,50
818,0,0,15,35,50
819,0,0,7,13,20
820,0,0,0,11,11
821,0,2,6,32,40
822,0,1,18,16,35
823,0,0,2,17,19
824,0,1,4,27,32
825,1,3,15,31,50
827,0,1,7,26,34
828,0,0,15,35,50
829,0,1,5,12,18
830,0,2,6,32,40
831,0,0,6,17,23
832,0,1,10,37,48
833,0,2,6,32,40
834,0,1,5,20,26
835,2,3,10,35,50
836,0,0,4,11,15
837,0,0,12,14,26
838,0,0,7,16,23
839,0,2,4,5,11
840,0,2,12,35,49
841,0,0,7,19,26
842,1,0,4,15,20
843,0,0,4,15,19
844,0,0,2,9,11
846,0,0,4,3,7
847,0,0,0,19,19
848,0,1,5,4,10
849,1,0,3,16,20
850,0,0,5,14,19
851,0,0,18,27,45
852,0,1,5,13,19
853,0,0,11,12,23
855,0,0,4,14,18
856,0,1,0,20,21
857,0,0,2,6,8
858,0,0,14,33,47
859,0,2,2,15,19
860,0,0,8,23,31
862,0,0,7,10,17
863,0,0,4,5,9
864,0,0,3,7,10
865,0,0,2,16,18
866,0,0,10,17,27
867,0,0,8,26,34
868,0,0,1,7,8
869,0,0,4,16,20
870,0,0,4,3,7
871,0,7,1,13,21
872,0,0,9,11,20
873,0,1,8,22,31
874,0,0,4,7,11
875,0,0,2,17,19
876,0,0,5,18,23
878,0,0,4,6,10
879,0,0,4,3,7
880,0,2,7,19,28
881,0,0,0,12,12
882,0,0,9,15,24
883,0,1,6,17,24
884,0,0,1,7,8
885,0,0,4,2,6
886,0,0,4,17,21
887,0,0,5,5,10
888,0,1,5,7,13
889,0,0,7,7,14
890,0,0,2,5,7
891,0,0,12,14,26
892,0,0,6,1,7
893,0,0,9,19,28
894,0,0,1,5,6
895,0,0,2,6,8
896,0,0,0,1,1
897,0,0,5,3,8
898,2,2,8,36,48
899,0,0,17,24,41
900,0,1,9,11,21
901,0,0,1,8,9
902,0,0,8,26,34
903,1,1,10,32,44
904,0,0,10,38,48
905,0,0,5,18,23
906,0,0,9,17,26
907,0,0,1,13,14
908,0,0,12,26,38
909,0,0,3,7,10
911,0,1,16,23,40
912,0,0,19,31,50
913,0,0,12,14,26
914,0,0,11,19,30
915,0,0,10,7,17
916,2,2,8,36,48
918,2,2,8,36,48
919,0,0,2,4,6
920,0,0,0,5,5
921,0,0,12,14,26
922,0,0,6,9,15
923,0,0,8,9,17
924,0,0,4,12,16
925,2,0,8,26,36
926,0,1,3,4,8
927,0,0,1,2,3
928,0,1,9,13,23
929,0,2,11,32,45
930,0,0,6,10,16
931,2,0,8,26,36
932,2,3,9,23,37
933,0,2,11,30,43
934,0,0,2,26,28
935,0,0,9,17,26
936,0,0,8,21,29
938,0,0,4,10,14
939,1,1,6,13,21
940,0,0,6,9,15
941,0,2,12,35,49
942,0,0,2,7,9
943,0,0,1,6,7
944,0,0,8,27,35
945,0,0,3,3,6
946,0,0,4,10,14
947,0,0,12,31,43
948,0,1,2,8,11
949,0,0,9,23,32
950,1,0,5,12,18
951,0,0,4,15,19
952,0,1,6,24,31
953,0,0,5,4,9
954,0,0,9,16,25
955,0,0,9,27,36
957,0,0,10,16,26
958,0,1,5,11,17
959,0,0,3,3,6
960,1,0,3,10,14
961,0,0,8,19,27
962,0,0,8,8,16
963,0,0,10,11,21
964,0,0,6,11,17
965,2,2,9,30,43
966,0,0,5,10,15
968,0,0,4,8,12
969,0,0,2,12,14
970,0,0,2,11,13
971,0,0,7,22,29
972,0,0,6,14,20
973,0,0,8,21,29
974,1,1,6,24,32
975,0,1,7,11,19
976,0,0,9,15,24
977,0,0,3,11,14
978,0,0,2,14,16
979,0,0,12,26,38
980,0,0,2,4,6
981,0,0,18,26,44
982,0,0,9,16,25
983,0,0,2,5,7
984,0,1,13,30,44
985,1,0,7,26,34
986,0,0,7,16,23
987,0,0,3,2,5
988,0,2,8,18,28
989,0,1,5,23,29
990,0,0,3,21,24
991,0,0,8,20,28
992,0,0,6,30,36
993,1,2,12,24,39
994,0,0,6,6,12
995,0,0,2,9,11
996,0,0,7,15,22
997,0,0,7,11,18
998,1,0,4,21,26
999,0,1,13,32,46
1000,0,1,10,19,30
1001,1,2,3,8,14
1002,0,0,9,15,24
1004,0,0,4,1,5
1005,1,0,2,6,9
1006,0,0,8,14,22
1007,0,0,3,4,7
1008,0,0,7,18,25
1009,0,0,16,22,38
1011,0,0,3,11,14
1012,0,0,8,14,22
1013,0,0,17,27,44
1014,0,0,10,26,36
1015,0,1,1,14,16
1016,0,0,4,5,9
1017,0,0,6,10,16
1018,0,0,1,4,5
1019,0,0,17,26,43
1020,0,0,6,13,19
1021,0,0,5,16,21
1022,0,0,6,8,14
1023,0,0,9,23,32
1024,0,0,2,14,16
1025,1,0,8,26,35
1026,0,0,10,35,45
1027,0,0,5,2,7
1028,0,0,2,16,18
1029,1,0,11,25,37
1030,0,0,4,7,11
1031,0,0,6,5,11
1032,2,0,11,37,50
1033,0,0,12,21,33
1034,0,3,13,17,33
1035,0,0,8,16,24
1036,0,1,4,8,13
1037,0,0,2,10,12
1039,0,0,8,9,17
1040,0,0,9,16,25
1041,0,0,5,7,12
1042,0,0,11,21,32
1043,0,0,2,4,6
1044,0,0,11,17,28
1045,0,1,2,9,12
1046,0,0,3,9,12
1047,0,1,7,22,30
1049,0,0,3,5,8
1050,0,0,3,6,9
1051,0,0,9,19,28
1052,0,0,2,14,16
1053,0,0,3,4,7
1054,0,7,1,13,21
1055,0,0,0,7,7
1056,0,3,15,32,50
1057,0,0,6,16,22
1058,0,0,4,8,12
1059,0,0,3,4,7
1060,0,0,6,7,13
1061,0,0,3,9,12
1062,0,0,4,12,16
1063,0,0,7,17,24
1064,0,0,4,3,7
1065,0,0,9,24,33
1066,0,0,4,6,10
1067,0,0,3,8,11
1068,0,1,9,26,36
1069,1,1,0,11,13
1070,0,0,14,18,32
1071,0,0,11,12,23
1072,0,2,8,29,39
1073,0,0,2,7,9
1074,0,1,11,21,33
1075,0,0,11,23,34
1076,0,0,11,27,38
1077,0,0,11,23,34
1078,0,0,1,7,8
1079,0,0,11,33,44
1080,0,0,7,12,19
1081,0,0,6,11,17
1082,0,0,3,6,9
1083,0,0,6,16,22
1084,0,1,7,6,14
1085,0,0,7,8,15
1086,0,0,2,17,19
1087,0,0,6,8,14
1089,0,2,5,5,12
1090,0,1,12,21,34
1091,0,0,1,5,6
1092,0,0,12,24,36
1093,1,2,13,27,43
1094,0,0,4,7,11
1095,0,1,8,19,28
1096,0,0,10,11,21
1097,0,0,5,15,20
1099,0,0,0,3,3
1100,0,2,2,23,27
1101,0,0,1,6,7
1102,0,0,7,24,31
1103,0,0,5,6,11
1104,0,0,7,14,21
1105,1,0,10,21,32
1106,0,0,9,17,26
1107,0,0,6,3,9
1108,0,0,6,5,11
1109,0,0,1,4,5
1111,0,0,12,38,50
1112,0,0,12,14,26
1113,0,0,10,20,30
1114,0,1,3,4,8
1115,0,0,4,12,16
1116,0,0,4,13,17
1117,0,0,6,9,15
1118,0,0,0,5,5
1119,0,1,9,13,23
1120,0,0,7,15,22
1121,0,0,2,3,5
1122,0,0,4,8,12
1123,0,0,2,4,6
1124,0,0,0,9,9
1125,0,1,7,10,18
1126,0,1,5,19,25
1127,0,0,1,23,24
1128,0,0,13,25,38
1129,0,0,6,31,37
1130,0,0,11,39,50
1131,0,0,1,6,7
1132,0,0,4,12,16
1133,0,0,5,24,29
1134,0,0,1,13,14
1135,0,0,11,37,48
1136,0,2,5,11,18
1137,0,0,8,14,22
1138,0,1,11,22,34
1139,0,2,5,32,39
1140,0,0,9,29,38
1141,1,0,9,20,30
1142,0,0,4,28,32
1143,2,0,7,14,23
1144,1,0,9,18,28
1145,0,0,4,4,8
1146,0,0,4,13,17
1147,0,0,5,21,26
1148,0,1,16,30,47
1149,0,0,9,8,17
1150,0,0,5,25,30
1151,0,0,5,11,16
1152,0,0,11,24,35
1153,0,0,9,10,19
1154,0,0,16,32,48
1156,0,1,9,27,37
1157,0,0,3,6,9
1158,0,0,9,20,29
1159,0,0,7,13,20
1160,0,0,14,36,50
1161,0,0,11,18,29
1162,0,0,13,37,50
1163,0,0,6,12,18
1164,0,0,3,18,21
1165,0,1,6,43,50
1167,1,0,16,24,41
1168,0,0,13,25,38
1169,0,0,12,22,34
1170,2,3,9,23,37
1171,0,0,6,10,16
1172,0,1,11,24,36
1173,0,0,8,21,29
1174,0,0,7,11,18
1176,0,0,0,9,9
1177,0,0,11,23,34
1178,0,0,12,38,50
1179,0,0,12,14,26
1180,1,2,12,24,39
1182,0,0,0,5,5
1183,0,0,2,17,19
1184,0,0,4,8,12
1185,0,0,2,3,5
1186,0,0,0,24,24
1187,0,1,6,43,50
1188,0,1,6,43,50
1189,0,1,2,8,11
1190,0,1,6,10,17
1191,0,0,3,11,14
1192,0,1,4,9,14
1193,1,0,2,4,7
1194,0,0,4,14,18
1195,0,0,2,7,9
1196,0,0,4,8,12
1197,0,0,3,8,11
1198,0,0,5,6,11
1199,0,0,2,4,6
1200,0,0,6,9,15
1201,0,2,4,23,29
1202,0,0,5,19,24
1203,0,0,6,9,15
1204,0,0,0,4,4
1205,0,0,9,22,31
1206,0,0,5,16,21
1207,1,0,5,10,16
1208,0,0,9,24,33
1209,0,0,3,8,11
1210,0,0,2,11,13
1212,0,0,6,5,11
1213,0,0,7,11,18
1214,0,0,1,7,8
1215,0,0,9,16,25
1216,2,3,9,23,37
1217,0,0,2,6,8
1218,0,0,6,10,16
1219,0,0,5,18,23
1221,2,3,9,23,37
1222,0,0,4,12,16
1223,0,0,5,18,23
1224,0,1,14,35,50
1225,0,0,5,4,9
1226,0,0,11,27,38
1227,1,0,2,4,7
1228,0,0,7,25,32
1229,0,1,0,7,8
1230,0,0,5,25,30
1231,0,0,11,17,28
1232,1,0,5,10,16
1233,0,0,11,18,29
1234,0,0,1,12,13
1235,0,0,6,10,16
1236,0,0,7,5,12
1237,0,0,3,14,17
1238,0,0,1,12,13
1239,0,0,2,8,10
1240,0,0,9,22,31
1241,0,0,4,3,7
1242,0,0,4,12,16
1243,0,0,2,7,9
1244,0,0,5,12,17
1245,0,0,0,5,5
1246,0,0,10,21,31
1247,0,0,3,11,14
1248,0,0,2,4,6
1249,0,0,1,14,15
1250,0,0,7,31,38
1251,0,1,7,14,22
1252,0,0,11,39,50
1253,0,0,5,5,10
1254,0,0,2,14,16
1255,0,0,3,7,10
1256,0,0,0,24,24
1257,0,1,5,10,16
1258,0,1,16,28,45
1259,0,0,4,10,14
1260,0,1,14,33,48
1261,0,0,5,20,25
1262,0,1,13,29,43
1263,0,1,12,13,26
1264,0,1,5,12,18
1266,0,1,7,3,11
1267,0,0,6,13,19
1268,0,1,14,25,40
1269,1,0,2,6,9
1270,0,2,18,30,50
1271,0,0,7,13,20
1272,0,0,9,27,36
1273,0,0,3,5,8
1276,0,0,4,18,22
1277,0,0,9,9,18
1278,0,0,12,38,50
1279,0,0,4,12,16
1280,0,0,12,23,35
1281,0,0,3,2,5
1282,0,0,17,24,41
1283,1,0,2,12,15
1284,0,0,4,34,38
1285,1,1,10,15,27
1286,2,0,3,15,20
1287,0,0,4,33,37
1288,0,0,14,36,50
1289,0,0,10,27,37
1290,0,1,9,16,26
1291,0,0,6,12,18
1292,0,0,0,9,9
1293,0,0,10,15,25
1294,0,0,11,7,18
1295,0,0,5,14,19
1296,0,1,5,7,13
1297,0,0,4,14,18
1298,0,1,8,7,16
1299,0,0,8,4,12
1300,0,1,12,33,46
1301,2,0,4,17,23
1302,0,0,8,28,36
1303,0,0,1,3,4
1304,0,0,13,24,37
1305,1,0,19,29,49
1306,0,0,5,12,17
1307,0,0,1,8,9
1308,0,0,8,17,25
1309,0,0,8,8,16
1310,0,0,7,7,14
1311,1,0,6,17,24
1312,0,0,5,9,14
1313,1,0,2,19,22
1314,0,0,8,16,24
1315,0,0,9,17,26
1316,0,0,7,23,30
1317,0,0,12,32,44
1318,0,0,4,6,10
1319,0,0,0,3,3
1320,0,1,12,37,50
1321,0,0,0,8,8
1322,0,0,0,6,6
1323,0,0,4,9,13
1324,1,0,2,35,38
1325,0,0,1,0,1
1326,0,0,2,19,21
1327,0,0,0,5,5
1328,1,0,2,20,23
1329,0,0,6,6,12
1330,0,0,1,2,3
1331,0,1,9,15,25
1332,0,0,8,14,22
1333,0,0,0,5,5
1334,0,0,2,3,5
1335,0,0,7,11,18
1336,0,0,4,9,13
1337,0,0,8,16,24
1339,0,0,1,7,8
1340,0,1,6,6,13
1341,0,0,2,3,5
1342,0,0,0,9,9
1343,0,0,0,5,5
1344,0,0,6,10,16
1345,1,0,2,8,11
1346,0,0,3,7,10
1347,0,1,4,15,20
1348,0,0,8,7,15
1349,0,0,3,1,4
1350,0,0,3,6,9
1351,0,0,8,21,29
1352,0,0,4,3,7
1353,0,0,0,8,8
1354,0,1,7,26,34
1355,0,0,5,11,16
1356,0,0,2,7,9
1357,0,2,6,32,40
1358,0,0,3,6,9
1359,2,2,8,36,48
1360,2,3,10,35,50
1361,0,0,0,3,3
1362,0,0,4,10,14
1364,0,0,3,7,10
1365,0,0,4,10,14
1366,0,0,0,3,3
1367,1,0,8,40,49
1368,0,0,5,32,37
1369,0,0,13,25,38
1370,0,0,11,34,45
1371,0,0,5,15,20
1372,0,0,8,21,29
1373,0,1,7,10,18
1374,1,0,5,18,24
1375,0,2,9,31,42
1376,1,0,4,12,17
1377,0,1,6,22,29
1378,0,0,3,3,6
1379,0,0,10,29,39
1380,0,0,6,8,14
1381,0,0,6,8,14
1382,0,0,1,4,5
1383,0,0,8,9,17
1384,0,0,8,20,28
1385,0,2,8,32,42
1386,0,0,6,15,21
1387,2,1,8,21,32
1388,0,0,3,7,10
1389,1,1,3,45,50
1390,2,0,8,17,27
1391,1,0,12,35,48
1392,0,0,3,11,14
1393,0,0,1,16,17
1394,0,0,10,24,34
1395,0,0,3,6,9
1396,0,2,6,32,40
1397,2,2,8,36,48
1398,0,0,4,3,7
1399,0,0,0,9,9
1400,0,0,0,5,5
1401,0,0,1,7,8
1402,1,0,4,12,17
1403,0,0,1,9,10
1404,0,0,0,24,24
1405,0,0,9,18,27
1406,0,1,5,12,18
1407,0,1,7,26,34
1408,0,2,6,32,40
1409,2,0,3,15,20
1410,2,3,10,35,50
1411,0,2,6,32,40
1412,0,0,10,24,34
1413,0,0,14,36,50
1414,2,2,8,36,48
1415,0,0,3,12,15
1416,0,0,4,9,13
1417,0,0,1,11,12
1418,0,1,13,27,41
1419,0,0,10,18,28
1420,0,0,8,20,28
1421,0,2,7,39,48
1422,0,0,10,18,28
1423,0,2,7,39,48
1424,0,1,13,27,41
1425,0,0,10,18,28
1426,0,0,3,12,15
1427,0,0,3,3,6
1428,0,0,6,16,22
1429,0,0,11,21,32
1430,0,2,6,21,29
1431,0,0,3,11,14
1432,0,0,8,23,31
1433,0,0,3,10,13
1434,0,0,2,7,9
1435,0,0,11,19,30
1436,0,0,2,17,19
1437,0,0,9,25,34
1438,0,0,5,14,19
1439,1,1,11,22,35
1440,0,0,3,9,12
1441,0,0,7,15,22
1442,0,0,5,19,24
1444,0,0,6,24,30
1445,0,2,1,14,17
1446,0,0,6,13,19
1447,0,0,1,11,12
1448,0,0,1,1,2
1449,0,0,7,7,14
1450,0,0,5,17,22
1451,0,0,4,13,17
1452,1,0,9,14,24
1453,0,2,10,38,50
1454,0,0,2,23,25
1455,2,0,4,32,38
1456,0,0,9,12,21
1457,0,0,7,5,12
1458,0,1,6,12,19
1459,1,3,14,29,47
1460,6,1,4,20,31
1461,0,0,6,18,24
1462,1,0,6,29,36
1463,0,0,4,17,21
1464,0,0,7,11,18
1465,0,1,6,39,46
1466,0,0,4,2,6
1467,0,0,0,5,5
1468,0,1,2,4,7
1469,0,0,3,8,11
1470,0,0,1,11,12
1471,0,1,8,8,17
1472,0,0,3,5,8
1473,1,0,2,10,13
1474,0,0,2,8,10
1475,0,1,4,1,6
1476,0,0,2,11,13
1477,2,2,4,23,31
1478,0,0,1,6,7
1480,0,0,1,5,6
1482,0,0,9,15,24
1483,0,0,3,5,8
1484,0,0,5,5,10
1485,0,0,5,9,14
1486,0,0,4,14,18
1487,0,0,6,2,8
1488,3,1,9,37,50
1489,0,0,3,19,22
1491,0,1,13,27,41
1492,0,0,2,5,7
1493,0,2,13,19,34
1494,0,1,5,9,15
1495,0,0,4,9,13
1496,0,0,3,12,15
1497,0,6,1,14,21
1498,0,2,1,8,11
1499,0,0,9,22,31
1500,0,0,1,4,5
1501,0,0,6,21,27
1502,1,0,18,31,50
1503,0,1,10,13,24
1504,0,0,16,32,48
1505,0,0,11,16,27
1506,0,0,11,21,32
1507,0,0,14,23,37
1509,0,0,17,33,50
1510,0,0,16,32,48
1511,1,2,8,38,49
1512,1,1,12,31,45
1513,0,0,5,17,22
1514,0,0,3,19,22
1515,0,0,10,20,30
1516,0,0,8,20,28
1517,1,1,0,14,16
1518,0,1,14,35,50
1519,0,1,10,13,24
1521,0,1,6,39,46
1522,1,0,18,31,50
1523,0,0,19,24,43
1524,0,1,4,45,50
1525,0,2,6,21,29
1526,0,0,5,14,19
1527,1,1,11,22,35
1528,0,1,6,12,19
1529,0,0,6,21,27
1530,0,0,12,19,31
1531,0,4,1,16,21
1532,0,0,1,4,5
1533,0,0,7,11,18
1534,0,1,12,34,47
1535,1,2,8,38,49
1536,1,0,2,19,22
1537,0,1,4,45,50
1538,0,0,3,3,6
1539,0,1,10,13,24
1541,0,4,1,16,21
1542,0,0,11,39,50
1543,2,1,6,39,48
1544,0,0,16,32,48
1545,0,0,7,11,18
1546,1,0,9,14,24
1547,0,1,4,45,50
1548,0,0,11,39,50
1549,0,2,10,26,38
1550,0,2,11,9,22
1551,0,2,13,19,34
1552,0,1,13,27,41
1553,2,1,6,39,48
1554,0,0,4,9,13
1555,0,0,9,25,34
1556,3,1,9,37,50
1557,0,0,3,12,15
1558,1,0,2,19,22
1559,0,0,11,21,32
1560,0,1,10,13,24
1561,0,0,19,24,43
1562,0,0,16,32,48
1563,0,0,11,16,27
1564,1,1,12,31,45
1565,0,0,14,23,37
1566,0,0,5,17,22
1567,0,0,5,14,19
1568,1,0,18,31,50
1569,0,0,11,39,50
1570,0,0,12,19,31
1571,0,1,6,12,19
1572,0,2,1,8,11
1573,0,0,9,22,31
1574,0,0,7,11,18
1575,0,0,1,8,9
1576,0,0,6,19,25
1577,0,0,2,4,6
1578,0,0,2,9,11
1579,0,0,5,5,10
1580,0,0,3,9,12
1581,0,0,0,3,3
1582,0,0,5,6,11
1583,0,0,4,7,11
1584,0,0,2,3,5
1585,0,0,4,15,19
1586,1,0,13,24,38
1587,0,0,12,23,35
1588,0,1,4,16,21
1589,0,1,6,14,21
1590,0,2,13,19,34
1591,0,2,5,5,12
1592,0,0,11,37,48
1593,0,0,5,26,31
1594,0,0,2,15,17
1595,0,0,5,15,20
1596,0,0,9,25,34
1597,0,0,2,11,13
1598,0,0,5,8,13
1599,0,0,0,7,7
1600,0,0,6,5,11
1601,0,0,3,8,11
1602,0,0,7,8,15
1603,0,0,2,3,5
1604,0,0,8,23,31
1605,0,0,5,3,8
1606,0,0,7,29,36
1607,0,0,8,16,24
1608,0,1,1,9,11
1609,0,0,14,28,42
1610,0,0,5,10,15
1611,0,0,8,10,18
1612,0,0,3,19,22
1613,0,0,6,14,20
1614,0,0,11,16,27
1615,0,0,1,5,6
1616,0,0,3,15,18
1617,0,0,0,5,5
1618,0,0,2,12,14
1619,0,0,14,23,37
1620,0,0,7,9,16
1621,0,0,5,27,32
1622,0,1,13,28,42
1623,0,0,4,8,12
1624,0,0,5,24,29
1625,0,0,6,21,27
1626,0,0,3,8,11
1627,0,1,13,32,46
1628,0,0,10,16,26
1629,0,2,15,27,44
1630,0,0,3,11,14
1631,0,0,14,27,41
1632,0,0,8,20,28
1633,0,2,3,11,16
1634,0,0,1,22,23
1635,0,0,3,5,8
1636,0,2,1,19,22
1637,0,0,3,2,5
1638,0,0,6,26,32
1639,0,0,1,2,3
1640,0,0,16,28,44
1641,0,0,4,9,13
1642,0,0,5,10,15
1643,0,1,4,17,22
1645,0,1,9,25,35
1646,0,0,10,13,23
1647,0,0,8,16,24
1648,0,0,1,7,8
1649,0,0,9,23,32
1650,0,0,6,9,15
1651,0,0,2,10,12
1652,0,1,7,38,46
1653,0,1,8,16,25
1654,0,0,8,17,25
1655,0,0,3,4,7
1656,0,0,5,7,12
1657,0,0,3,4,7
1658,0,0,4,4,8
1659,0,0,1,9,10
1660,0,1,7,17,25
1661,0,0,4,14,18
1662,0,0,2,7,9
1663,0,1,13,19,33
1664,0,0,2,7,9
1665,0,0,0,10,10
1666,0,0,6,4,10
1667,0,0,10,16,26
1668,0,0,11,19,30
1669,0,0,6,10,16
1670,0,1,4,13,18
1671,1,0,1,24,26
1672,0,0,6,9,15
1673,0,0,0,5,5
1674,0,0,6,19,25
1675,0,1,7,13,21
1676,0,0,3,10,13
1678,0,0,2,3,5
1679,0,0,1,4,5
1680,0,1,5,16,22
1681,0,5,12,26,43
1682,0,0,1,9,10
1683,0,0,4,21,25
1684,0,0,7,9,16
1685,0,0,6,4,10
1686,0,0,3,11,14
1687,0,0,5,3,8
1688,1,1,4,20,26
1689,1,1,3,10,15
1690,0,0,1,4,5
1691,0,2,0,2,4
1692,0,0,9,24,33
1693,0,1,14,32,47
1694,0,0,4,16,20
1695,0,0,6,9,15
1696,0,0,1,5,6
1697,0,0,5,3,8
1698,0,0,1,4,5
1699,0,0,1,5,6
1700,0,1,6,30,37
1701,0,0,4,13,17
1702,0,0,4,7,11
1703,0,0,2,8,10
1704,0,1,4,19,24
1705,0,0,10,28,38
1706,0,0,2,6,8
1707,0,1,7,31,39
1709,0,1,9,21,31
1710,0,2,0,6,8
1711,0,0,8,9,17
1712,0,0,9,12,21
1714,0,0,1,7,8
1715,0,0,5,18,23
1716,1,0,4,14,19
1717,0,3,4,13,20
1719,0,2,8,13,23
1720,0,2,8,12,22
1721,0,2,2,17,21
1722,0,0,5,3,8
1723,0,0,8,3,11
1724,0,0,8,8,16
1726,0,0,7,17,24
1727,0,1,1,8,10
1729,0,1,14,35,50
1730,0,0,2,5,7
1731,0,0,3,3,6
1732,0,0,2,14,16
1733,0,0,3,15,18
1734,0,0,3,6,9
1735,0,0,0,8,8
1736,0,1,3,16,20
1737,1,0,3,10,14
1738,0,0,2,4,6
1739,0,0,1,4,5
1740,0,0,5,6,11
1741,0,0,2,4,6
1742,0,0,3,6,9
1743,0,0,4,12,16
1744,0,1,8,14,23
1745,0,1,1,9,11
1746,0,0,1,7,8
1747,0,1,2,8,11
1748,0,0,0,12,12
1749,1,0,7,19,27
1750,0,0,2,19,21
1751,0,0,3,6,9
1752,0,3,1,19,23
1753,0,0,5,7,12
1755,0,0,4,15,19
1756,0,0,6,5,11
1757,0,0,2,7,9
1759,0,0,2,6,8
1760,1,1,11,22,35
1761,0,0,1,7,8
1762,0,0,0,5,5
1763,0,0,0,10,10
1764,0,1,5,15,21
1765,0,0,1,8,9
1767,3,2,7,36,48
1768,1,0,13,24,38
1769,0,0,4,14,18
1770,0,1,6,12,19
1771,0,1,6,9,16
1772,0,0,3,16,19
1773,0,0,12,17,29
1774,0,0,10,26,36
1775,0,1,12,14,27
1776,0,0,10,23,33
1777,0,1,8,13,22
1778,0,1,2,19,22
1779,0,1,8,7,16
1780,1,1,8,17,27
1781,1,0,6,21,28
1782,0,0,9,24,33
1783,0,0,7,15,22
1784,0,0,18,32,50
1785,0,1,10,28,39
1788,0,0,8,42,50
1789,0,0,7,15,22
1790,0,0,4,16,20
1791,0,0,4,11,15
1792,0,0,11,17,28
1793,0,0,11,36,47
1794,0,0,19,24,43
1795,0,0,3,14,17
1796,0,0,7,11,18
1797,0,1,9,22,32
1798,0,0,14,27,41
1799,1,0,15,33,49
1800,1,1,11,22,35
1801,0,0,10,22,32
1802,0,0,15,34,49
1803,0,0,4,6,10
1804,2,0,1,7,10
1805,0,0,3,9,12
1806,0,0,8,21,29
1807,0,0,1,17,18
1808,0,0,17,30,47
1810,0,0,8,28,36
1811,0,0,11,39,50
1812,0,0,13,18,31
1813,4,1,12,30,47
1815,0,0,0,11,11
1816,0,0,13,24,37
1817,0,0,10,40,50
1818,0,0,10,23,33
1819,0,0,2,6,8
1820,0,0,8,13,21
1821,0,0,1,14,15
1822,0,0,3,3,6
1823,0,0,0,4,4
1824,0,1,7,38,46
1825,0,3,1,19,23
1826,3,2,7,36,48
1827,0,0,9,24,33
1828,0,1,6,12,19
1829,0,0,4,14,18
1830,0,0,3,19,22
1831,0,0,1,4,5
1832,0,0,6,19,25
1833,0,0,5,7,12
1834,1,2,14,33,50
1835,0,0,0,8,8
1836,0,0,11,11,22
1838,0,1,8,13,22
1840,1,0,6,21,28
1841,0,0,3,9,12
1842,0,0,11,39,50
1844,0,0,4,7,11
1845,0,0,4,14,18
1846,0,0,11,39,50
1848,0,1,6,9,16
1849,0,0,19,24,43
1850,0,0,11,16,27
1851,0,0,11,39,50
1852,0,0,2,11,13
1853,0,2,13,19,34
1854,0,0,9,25,34
1855,0,1,6,12,19
1856,0,0,14,23,37
1857,1,0,13,24,38
1858,1,0,8,21,30
1859,0,0,2,6,8
1860,1,0,8,38,47
1862,1,1,3,15,20
1863,0,0,8,33,41
1864,0,0,13,17,30
1866,0,0,3,4,7
1867,0,0,2,4,6
1868,0,1,13,26,40
1869,1,0,2,13,16
1870,0,0,12,15,27
1871,0,0,3,9,12
1872,0,0,5,21,26
1873,1,1,3,15,20
1874,0,1,5,19,25
1876,0,0,4,9,13
1877,0,0,4,16,20
1878,1,0,2,13,16
1879,1,1,2,37,41
1880,1,1,10,22,34
1881,0,0,2,5,7
1882,0,0,8,14,22
1883,0,0,5,18,23
1884,0,0,11,24,35
1885,0,0,2,21,23
1886,0,0,4,10,14
1887,0,1,1,5,7
1888,0,0,5,28,33
1889,0,0,5,21,26
1890,1,0,0,44,45
1892,1,0,18,31,50
1893,0,0,3,8,11
1894,0,0,2,5,7
1895,0,1,3,15,19
1896,0,0,4,20,24
1897,1,0,6,13,20
1898,0,0,6,18,24
1899,0,0,4,9,13
1900,0,0,5,8,13
1901,0,1,2,11,14
1903,0,0,11,21,32
1904,0,7,3,13,23
1905,0,1,6,17,24
1906,0,0,6,23,29
1907,0,0,3,4,7
1908,0,0,4,18,22
1909,0,0,4,5,9
1910,1,1,9,24,35
1911,0,3,17,25,45
1912,0,1,5,19,25
1913,0,1,4,20,25
1914,0,0,5,3,8
1915,0,0,7,4,11
1916,0,0,3,8,11
1917,0,0,5,9,14
1918,0,0,4,2,6
1919,0,0,4,16,20
1920,0,0,3,16,19
1921,0,1,4,17,22
1922,0,2,8,27,37
1923,0,0,4,7,11
1924,0,1,6,33,40
1925,0,0,7,18,25
1926,0,0,2,3,5
1927,1,0,3,12,16
1928,0,1,10,13,24
1929,0,0,1,5,6
1930,0,0,9,39,48
1931,0,0,6,12,18
1932,0,0,11,22,33
1933,0,0,8,14,22
1934,0,3,13,22,38
1935,0,0,4,17,21
1936,0,1,10,31,42
1937,1,1,3,26,31
1938,0,0,2,15,17
1939,0,0,2,3,5
1941,0,0,6,7,13
1942,1,0,8,11,20
1943,0,0,5,3,8
1944,0,6,9,21,36
1945,0,0,1,14,15
1946,0,0,6,6,12
1947,0,0,10,19,29
1948,0,0,15,35,50
1949,0,0,4,1,5
1950,0,0,7,24,31
1951,0,0,5,5,10
1952,0,2,4,14,20
1953,0,0,1,10,11
1954,0,1,7,15,23
1955,0,0,8,6,14
1956,0,0,3,7,10
1957,0,0,9,10,19
1958,0,0,5,7,12
1959,0,0,2,4,6
1960,0,1,11,19,31
1961,0,0,4,16,20
1962,0,0,6,7,13
1963,0,0,6,6,12
1964,0,0,11,16,27
1965,0,0,4,12,16
1966,0,0,4,4,8
1967,0,0,10,15,25
1968,0,0,3,5,8
1969,0,0,4,4,8
1970,0,0,17,33,50
1971,0,0,3,6,9
1973,1,0,13,24,38
1974,1,1,2,37,41
1976,0,0,7,9,16
1977,0,0,0,18,18
1978,0,0,1,13,14
1979,0,0,3,9,12
1980,0,0,5,4,9
1981,0,0,3,2,5
1982,0,1,9,20,30
1983,0,0,7,13,20
1984,0,1,5,16,22
1985,0,1,6,25,32
1986,2,2,4,23,31
1987,0,0,5,5,10
1988,0,0,4,6,10
1989,0,0,5,4,9
1990,2,0,4,21,27
1991,0,2,8,16,26
1992,0,1,1,5,7
1993,0,0,2,7,9
1994,0,0,2,5,7
1995,0,0,8,11,19
1996,0,0,3,12,15
1998,0,0,4,18,22
1999,0,0,5,10,15
2000,0,0,8,28,36
2002,0,0,2,16,18
2003,0,0,3,10,13
2004,0,0,2,7,9
2005,0,1,9,40,50
2006,0,0,12,15,27
2007,0,1,8,8,17
2008,0,0,4,3,7
2009,0,0,0,5,5
2010,0,0,4,11,15
2011,0,0,2,4,6
2012,1,0,3,28,32
2013,0,0,2,3,5
2014,0,0,6,10,16
2015,0,0,8,20,28
2016,0,0,7,18,25
2017,0,0,3,7,10
2018,1,0,0,8,9
2019,0,0,2,3,5
2020,0,0,0,5,5
2022,0,0,2,8,10
2023,0,0,5,12,17
2024,0,0,2,7,9
2025,0,0,5,5,10
2026,0,1,13,26,40
2027,0,0,16,22,38
2028,0,0,3,15,18
2029,0,0,1,6,7
2030,3,0,2,8,13
2031,3,2,6,39,50
2032,0,0,6,11,17
2033,1,0,6,29,36
2034,0,0,2,11,13
2035,0,1,3,6,10
2036,0,0,2,7,9
2037,0,0,2,6,8
2038,0,0,7,11,18
2039,0,0,9,6,15
2040,0,0,5,10,15
2041,0,1,14,35,50
2042,0,0,7,27,34
2043,0,2,12,36,50
2044,0,0,9,41,50
2045,0,1,10,31,42
2046,4,2,6,35,47
2047,0,0,2,11,13
2048,0,0,3,7,10
2049,0,0,22,27,49
2050,0,1,7,20,28
2051,0,0,10,27,37
2052,0,0,2,4,6
2053,0,0,1,8,9
2054,0,0,6,18,24
2055,0,0,9,31,40
2056,0,2,11,37,50
2057,1,0,14,30,45
2058,1,1,10,32,44
2059,0,0,3,6,9
2060,2,0,2,12,16
2061,0,0,2,12,14
2062,0,0,6,26,32
2063,0,0,8,28,36
2064,0,0,3,8,11
2065,0,0,8,10,18
2066,1,1,7,20,29
2067,0,0,5,4,9
2068,0,0,0,11,11
2069,0,0,9,7,16
2070,0,0,3,5,8
2071,0,1,11,31,43
2072,0,0,3,8,11
2073,0,2,7,39,48
2074,0,0,16,33,49
2075,0,0,10,13,23
2076,0,0,17,19,36
2077,0,0,5,16,21
2078,0,0,3,23,26
2079,1,0,6,23,30
2080,1,0,4,15,20
2081,0,0,16,34,50
2082,0,0,10,28,38
2083,0,2,6,29,37
2084,0,0,8,16,24
2085,1,0,3,18,22
2086,1,0,5,12,18
2087,0,0,7,5,12
2088,0,1,14,33,48
2089,0,0,10,40,50
2090,0,1,17,32,50
2091,0,1,4,6,11
2092,0,0,5,11,16
2093,0,0,13,20,33
2094,0,0,9,15,24
2095,0,0,5,35,40
2096,0,0,5,7,12
2097,0,0,5,14,19
2098,1,1,8,19,29
2099,0,0,1,4,5
2100,0,0,3,3,6
2101,1,0,5,12,18
2102,1,0,6,21,28
2103,0,1,13,18,32
2104,0,0,13,37,50
2105,1,1,3,15,20
2106,0,4,7,12,23
2107,0,0,3,6,9
2108,0,0,3,3,6
2109,0,0,1,7,8
2110,3,0,2,8,13
2111,0,0,6,11,17
2112,1,1,10,22,34
2113,0,0,5,21,26
2114,0,1,10,13,24
2115,0,3,17,25,45
2116,1,0,18,31,50
2117,0,0,7,11,18
2118,0,0,3,8,11
2119,0,0,1,0,1
2120,1,0,3,13,17
2121,0,0,8,23,31
2122,0,2,6,29,37
2123,1,0,7,37,45
2124,0,0,14,36,50
2125,0,0,3,13,16
2126,0,0,8,27,35
2127,1,0,2,13,16
2128,1,0,12,16,29
2129,0,0,13,37,50
2130,0,0,5,14,19
2131,0,0,7,15,22
2132,0,1,10,13,24
2133,1,0,6,21,28
2134,0,0,3,6,9
2135,0,1,3,15,19
2136,0,1,3,15,19
2137,0,0,7,11,18
2138,0,0,1,7,8
2139,3,2,6,39,50
2140,0,1,10,13,24
2141,0,2,7,39,48
2142,1,0,2,6,9
2143,0,0,13,37,50
2144,1,0,18,31,50
2145,0,0,5,14,19
2146,0,1,3,6,10
2147,0,0,11,21,32
2148,0,0,7,11,18
2149,0,0,3,9,12
2150,1,0,2,9,12
2151,0,0,2,6,8
2152,0,0,4,7,11
2153,0,0,9,6,15
2154,0,0,0,5,5
2155,0,1,11,34,46
2156,0,1,2,13,16
2157,0,0,4,11,15
2158,0,0,10,9,19
2159,0,0,11,21,32
2160,0,0,6,10,16
2161,0,0,4,9,13
2162,0,0,6,21,27
2163,0,1,6,22,29
2164,0,0,8,27,35
2165,0,1,4,18,23
2166,0,1,9,24,34
2167,1,0,8,21,30
2168,0,1,5,22,28
2169,0,0,1,5,6
2170,0,1,6,29,36
2171,0,0,16,33,49
2172,0,0,4,13,17
2173,0,0,6,15,21
2174,1,0,5,18,24
2175,0,0,4,11,15
2176,1,1,6,29,37
2177,0,0,2,12,14
2178,3,0,2,20,25
2179,0,1,9,18,28
2180,0,1,10,31,42
2181,0,0,5,9,14
2182,0,0,2,10,12
2183,0,0,4,6,10
2184,0,0,1,4,5
2185,0,0,5,8,13
2186,0,0,3,2,5
2187,0,0,6,6,12
2188,0,0,10,22,32
2189,0,0,0,7,7
2190,0,0,1,8,9
2191,0,0,8,16,24
2192,0,0,7,14,21
2193,0,0,6,12,18
2194,0,0,6,21,27
2195,0,0,9,8,17
2196,0,0,7,10,17
2197,0,0,6,29,35
2198,0,1,5,24,30
2199,0,0,11,16,27
2200,0,0,2,5,7
2201,0,0,3,13,16
2202,0,0,4,16,20
2203,0,0,3,3,6
2204,0,0,16,13,29
2205,0,0,4,13,17
2206,0,0,4,43,47
2207,0,0,0,6,6
2208,0,0,3,10,13
2209,0,0,12,35,47
2210,0,0,7,9,16
2211,2,1,9,21,33
2212,0,0,6,9,15
2213,1,2,10,31,44
2214,0,0,4,6,10
2215,1,0,1,8,10
2216,0,0,8,14,22
2217,0,0,5,10,15
2218,0,4,9,24,37
2219,0,0,3,5,8
2220,0,0,10,18,28
2221,0,0,3,4,7
2222,0,0,3,18,21
2223,0,0,0,3,3
2224,0,0,1,9,10
2225,0,0,0,3,3
2226,1,4,0,10,15
2228,0,0,6,7,13
2229,0,0,10,14,24
2230,0,0,0,1,1
2231,0,0,1,6,7
2232,0,0,3,9,12
2233,0,0,13,20,33
2234,0,1,4,4,9
2235,0,0,7,43,50
2236,1,0,9,14,24
2237,0,0,2,23,25
2238,0,0,6,11,17
2239,0,1,6,21,28
2240,0,0,6,9,15
2241,0,0,2,6,8
2243,0,0,0,9,9
2244,0,0,8,28,36
2245,0,0,5,5,10
2246,0,0,6,11,17
2247,0,0,11,24,35
2248,1,0,11,24,36
2249,0,0,10,22,32
2250,0,0,9,14,23
2251,0,0,11,36,47
2252,0,0,5,13,18
2253,1,0,6,8,15
2254,2,0,3,6,11
2255,0,0,6,26,32
2256,0,1,6,21,28
2257,0,0,10,18,28
2258,0,1,4,2,7
2259,0,0,5,11,16
2260,0,1,8,24,33
2261,0,0,4,6,10
2262,0,2,4,17,23
2263,0,0,16,34,50
2264,0,0,1,19,20
2265,0,0,5,5,10
2266,0,0,1,6,7
2268,0,0,2,3,5
2269,1,0,11,28,40
2270,1,0,5,26,32
2271,0,0,7,43,50
2272,1,0,2,24,27
2273,2,0,1,14,17
2274,1,0,3,12,16
2275,0,0,11,39,50
2276,0,0,1,3,4
2277,0,3,6,41,50
2278,1,1,5,43,50
2279,0,0,8,16,24
2280,0,0,0,9,9
2281,0,0,8,28,36
2282,2,0,12,33,47
2283,1,3,9,37,50
2284,0,1,12,18,31
2285,0,1,4,20,25
2287,0,0,3,9,12
2288,0,0,0,9,9
2289,1,0,9,14,24
2290,0,0,10,18,28
2291,0,0,4,7,11
2292,0,0,10,18,28
2293,0,0,4,9,13
2294,0,0,2,6,8
2295,0,0,0,1,1
2296,0,0,5,7,12
2297,0,0,0,15,15
2298,0,1,4,20,25
2299,0,0,15,27,42
2300,0,0,1,1,2
2301,0,0,5,8,13
2302,0,0,3,5,8
2303,0,0,6,22,28
2304,0,1,8,19,28
2306,0,0,4,11,15
2307,0,0,2,8,10
2308,0,0,12,23,35
2309,0,0,6,15,21
2310,0,0,5,29,34
2311,0,0,2,3,5
2312,0,0,6,8,14
2313,0,0,8,10,18
2314,0,0,2,12,14
2315,0,0,0,5,5
2316,0,1,12,18,31
2318,0,0,9,18,27
2319,0,0,1,11,12
2320,0,2,7,20,29
2321,0,0,0,5,5
2322,0,0,1,3,4
2323,0,0,5,9,14
2324,0,0,8,9,17
2325,0,1,5,11,17
2326,0,0,6,18,24
2327,0,0,3,9,12
2328,1,0,8,17,26
2329,0,0,7,18,25
2330,0,0,7,14,21
2331,0,0,3,11,14
2332,0,0,4,16,20
2333,0,0,5,12,17
2334,0,0,5,10,15
2335,0,0,3,16,19
2336,0,2,1,24,27
2337,0,0,12,26,38
2338,0,1,5,10,16
2339,0,1,13,23,37
2340,1,0,9,13,23
2341,0,0,8,25,33
2342,0,0,5,12,17
2343,0,1,5,13,19
2344,1,0,1,8,10
2345,0,0,4,6,10
2347,0,0,7,7,14
2348,0,0,4,11,15
2349,0,0,5,15,20
2350,0,0,9,10,19
2351,1,0,0,15,16
2352,0,0,3,5,8
2353,0,0,1,6,7
2354,2,0,1,6,9
2355,0,0,0,12,12
2356,1,0,2,7,10
2357,0,0,8,16,24
2358,0,1,7,20,28
2359,0,0,6,5,11
2360,0,5,1,4,10
2361,0,3,14,33,50
2362,0,0,9,29,38
2363,1,1,4,18,24
2364,0,0,4,12,16
2365,0,0,2,11,13
2366,0,0,13,35,48
2367,0,0,5,11,16
2368,0,0,11,28,39
2369,0,1,7,20,28
2370,0,0,2,16,18
2371,0,0,2,8,10
2372,0,0,6,26,32
2373,1,0,12,26,39
2374,0,1,15,22,38
2375,0,0,8,19,27
2376,0,0,0,12,12
2377,0,0,9,25,34
2378,0,1,7,23,31
2379,3,0,1,10,14
2380,0,0,8,16,24
2381,1,0,5,32,38
2382,0,0,0,3,3
2384,0,0,3,6,9
2385,0,1,2,47,50
2386,0,1,13,28,42
2387,0,3,11,33,47
2388,1,0,1,16,18
2389,1,0,11,22,34
2390,0,0,6,11,17
2391,0,0,15,29,44
2392,2,0,1,6,9
2393,0,0,11,13,24
2394,1,0,9,5,15
2395,1,0,8,13,22
2396,0,0,9,29,38
2397,1,0,1,8,10
2398,0,0,3,12,15
2399,0,0,8,16,24
2400,1,0,9,11,21
2401,0,1,5,11,17
2402,0,5,1,4,10
2403,0,0,13,37,50
2404,0,0,0,12,12
2405,0,0,13,37,50
2406,0,0,4,21,25
2407,0,0,0,15,15
2408,0,0,1,22,23
2409,1,0,2,10,13
2410,0,0,13,37,50
2411,0,2,3,17,22
2412,0,1,6,26,33
2413,1,1,8,30,40
2414,0,0,4,3,7
2415,0,4,15,28,47
2416,0,0,7,10,17
2417,0,0,1,7,8
2418,0,0,3,10,13
2419,0,0,5,31,36
2420,0,0,2,2,4
2421,0,0,3,3,6
2422,0,1,7,10,18
2423,0,0,4,4,8
2424,0,0,8,22,30
2425,0,0,3,4,7
2426,0,0,6,10,16
2427,0,0,3,21,24
2428,0,1,6,21,28
2429,0,0,0,8,8
2430,0,0,4,25,29
2431,0,0,2,9,11
2432,0,0,3,41,44
2433,0,0,3,7,10
2434,0,0,0,11,11
2435,0,0,6,13,19
2436,0,0,12,38,50
2437,0,0,3,21,24
2438,0,0,0,6,6
2439,0,0,7,10,17
2440,0,0,2,11,13
2441,0,0,0,1,1
2442,0,0,7,22,29
2443,0,0,6,10,16
2444,0,0,15,35,50
2445,0,0,9,25,34
2446,0,1,16,33,50
2447,0,0,5,21,26
2448,0,1,2,40,43
2449,0,0,3,11,14
2450,0,0,2,15,17
2451,0,0,5,5,10
2452,0,0,7,4,11
2453,0,1,2,4,7
2454,0,0,6,7,13
2455,0,1,8,19,28
2456,1,0,13,22,36
2457,0,0,4,9,13
2458,0,0,4,8,12
2459,0,0,1,4,5
2460,0,0,6,8,14
2461,0,0,2,4,6
2462,1,1,8,21,31
2463,2,0,4,13,19
2464,0,0,6,22,28
2465,0,0,12,37,49
2466,0,3,6,22,31
2467,0,1,1,15,17
2468,0,1,5,18,24
2469,0,0,4,19,23
2470,1,0,3,28,32
2471,0,1,6,13,20
2472,0,0,1,8,9
2473,1,0,6,9,16
2474,1,0,6,25,32
2475,0,0,5,17,22
2476,0,0,5,5,10
2477,2,0,5,33,40
2478,0,0,7,17,24
2479,0,0,11,6,17
2480,0,0,15,28,43
2481,0,0,0,6,6
2482,0,0,7,4,11
2483,1,0,0,8,9
2484,0,0,6,11,17
2485,0,0,1,6,7
2486,0,0,9,29,38
2487,0,0,5,8,13
2488,0,0,10,15,25
2489,0,0,2,13,15
2490,0,0,9,17,26
2491,0,0,5,1,6
2493,0,0,6,7,13
2494,0,0,7,14,21
2495,0,0,2,48,50
2496,0,0,2,4,6
2497,1,0,2,5,8
2498,0,0,2,6,8
2499,0,0,7,8,15
2500,0,0,0,8,8
2501,0,0,2,3,5
2502,0,0,0,1,1
2503,0,1,5,4,10
2504,0,0,1,7,8
2505,0,0,7,3,10
2506,1,1,9,21,32
2507,0,0,9,14,23
2508,1,1,3,25,30
2509,0,0,3,4,7
2510,0,0,7,8,15
2511,0,0,12,38,50
2512,0,1,4,20,25
2513,0,0,13,32,45
2515,0,0,9,22,31
2516,0,0,6,4,10
2517,0,0,1,7,8
2518,0,0,1,5,6
2519,0,0,5,9,14
2520,0,0,1,11,12
2522,0,1,2,14,17
2523,0,0,10,24,34
2524,0,0,1,5,6
2525,0,0,8,28,36
2526,0,0,6,5,11
2527,0,0,4,11,15
2528,0,0,3,10,13
2529,0,0,0,9,9
2530,0,0,11,18,29
2532,0,1,1,4,6
2533,0,0,3,4,7
2534,0,0,10,17,27
2535,1,0,3,8,12
2536,0,0,13,23,36
2537,1,0,6,16,23
2538,0,0,1,16,17
2539,1,0,0,15,16
2542,0,1,7,22,30
2543,0,0,10,22,32
2544,1,0,11,25,37
2545,0,0,8,16,24
2546,1,0,2,10,13
2547,0,0,0,6,6
2548,0,0,7,6,13
2549,0,0,4,2,6
2550,1,0,2,9,12
2551,0,0,4,9,13
2553,0,1,2,14,17
2554,0,0,2,4,6
2555,0,0,11,10,21
2556,0,2,1,8,11
2558,0,0,6,11,17
2559,0,0,3,8,11
2560,0,0,4,14,18
2561,0,1,10,29,40
2562,0,2,6,21,29
2563,3,2,7,36,48
2564,0,3,17,25,45
2565,1,0,0,4,5
2566,0,0,9,24,33
2567,0,0,4,7,11
2568,0,5,1,4,10
2569,1,2,5,35,43
2570,0,1,14,35,50
2571,0,0,7,10,17
2572,1,0,10,17,28
2573,1,0,9,40,50
2574,0,0,14,36,50
2575,0,0,5,26,31
2576,0,0,17,32,49
2578,0,0,0,5,5
2579,0,0,4,33,37
2580,0,0,5,5,10
2581,0,0,0,11,11
2582,0,1,16,33,50
2583,0,0,1,7,8
2584,0,1,10,39,50
2585,0,0,10,26,36
2586,0,1,14,35,50
2587,0,2,6,21,29
2588,0,0,2,3,5
2589,0,0,16,34,50
2590,0,1,10,24,35
2591,1,0,15,33,49
2592,0,2,11,28,41
2593,1,0,4,23,28
2594,0,0,7,4,11
2595,2,0,2,13,17
2596,0,0,8,32,40
2597,0,1,11,16,28
2598,0,0,8,42,50
2599,0,1,6,22,29
2600,0,1,11,38,50
2601,0,0,6,7,13
2602,0,0,9,22,31
2603,0,0,5,37,42
2604,0,0,3,4,7
2605,0,0,1,13,14
2606,0,1,17,32,50
2607,0,0,6,21,27
2608,1,0,19,18,38
2609,0,0,5,16,21
2610,0,0,4,15,19
2611,1,0,15,30,46
2612,0,0,12,20,32
2613,0,0,4,22,26
2614,0,1,9,21,31
2615,0,0,12,32,44
2616,0,1,8,16,25
2617,0,0,12,26,38
2619,1,0,10,39,50
2620,0,2,16,17,35
2621,0,3,17,25,45
2622,1,0,6,25,32
2623,0,0,8,15,23
2624,0,0,16,33,49
2625,0,0,8,10,18
2626,0,0,8,26,34
2627,0,2,10,38,50
2629,0,0,8,33,41
2630,1,0,7,23,31
2631,0,0,10,40,50
2632,0,2,4,18,24
2633,0,1,16,30,47
2634,0,0,9,25,34
2635,0,0,5,7,12
2636,0,0,4,8,12
2637,0,1,4,12,17
2638,0,0,14,25,39
2639,0,0,15,24,39
2640,0,0,17,22,39
2641,0,0,6,13,19
2642,0,0,4,9,13
2643,0,0,7,10,17
2644,0,0,0,1,1
2645,0,0,9,31,40
2646,0,0,11,24,35
2647,0,0,1,4,5
2648,0,2,13,17,32
2649,1,1,6,22,30
2650,0,0,2,10,12
2651,0,0,12,38,50
2652,1,0,7,8,16
2653,1,0,10,18,29
2654,0,0,9,14,23
2655,0,0,15,29,44
2656,0,1,8,41,50
2657,0,0,7,13,20
2658,0,0,7,10,17
2659,0,0,2,1,3
2661,0,0,2,24,26
2663,0,0,7,32,39
2664,0,1,4,11,16
2665,0,0,3,15,18
2666,0,0,6,5,11
2667,1,0,4,5,10
2668,0,0,1,7,8
2669,0,0,2,16,18
2670,0,0,8,36,44
2671,0,0,5,14,19
2672,0,0,0,4,4
2673,0,0,6,11,17
2674,0,0,12,37,49
2675,0,0,3,1,4
2676,0,0,1,5,6
2677,3,2,7,36,48
2678,0,0,8,38,46
2679,0,0,3,18,21
2680,0,1,8,26,35
2681,0,0,2,11,13
2682,0,2,8,40,50
2683,0,0,8,5,13
2684,0,1,6,21,28
2685,0,0,4,3,7
2686,1,0,1,8,10
2688,0,0,3,3,6
2689,1,0,4,21,26
2690,0,3,6,41,50
2691,0,0,9,29,38
2692,0,5,1,4,10
2693,0,0,9,24,33
2694,1,0,0,4,5
2695,0,1,10,29,40
2696,0,0,9,14,23
2697,0,1,2,14,17
2698,1,0,15,28,44
2699,0,0,13,32,45
2700,0,0,6,25,31
2701,0,1,11,38,50
2702,0,0,5,37,42
2703,1,0,3,17,21
2704,0,0,9,13,22
2705,1,0,7,12,20
2706,0,1,14,35,50
2707,1,0,12,37,50
2708,1,0,10,39,50
2709,0,0,0,11,11
2710,0,0,7,31,38
2711,0,0,8,36,44
2712,0,0,0,1,1
2713,0,1,10,28,39
2714,0,3,6,22,31
2715,0,0,1,7,8
2716,0,2,1,8,11
2717,0,4,8,23,35
2718,0,4,8,23,35
2719,0,0,7,6,13
2720,0,2,6,26,34
2721,0,0,4,4,8
2722,0,0,2,10,12
2723,0,0,4,15,19
2724,0,0,8,20,28
2725,0,0,0,8,8
2726,1,0,5,31,37
2727,0,0,9,39,48
2728,1,1,2,24,28
2729,0,0,6,16,22
2730,0,1,6,13,20
2731,0,1,12,13,26
2732,0,0,13,20,33
2733,0,0,3,9,12
2734,1,0,4,13,18
2735,2,0,7,26,35
2736,0,1,3,35,39
2737,1,0,0,14,15
2738,0,0,5,26,31
2739,0,0,5,5,10
2740,0,0,8,18,26
2741,0,0,4,4,8
2742,0,0,1,2,3
2743,1,0,5,17,23
2744,0,0,11,37,48
2745,0,0,14,23,37
2746,0,4,14,31,49
2748,0,0,12,30,42
2749,0,0,1,4,5
2750,0,0,8,6,14
2751,2,0,3,33,38
2752,0,0,11,29,40
2753,0,1,8,19,28
2754,0,0,0,5,5
2755,0,0,6,6,12
2756,4,0,2,40,46
2757,0,1,1,10,12
2758,1,0,11,21,33
2759,0,0,13,22,35
2760,0,0,3,14,17
2761,0,1,13,14,28
2762,0,0,0,7,7
2763,0,0,3,20,23
2764,0,0,3,17,20
2765,0,0,2,4,6
2766,1,0,3,16,20
2767,0,0,3,13,16
2768,0,0,2,24,26
2769,0,0,2,2,4
2770,0,0,4,18,22
2771,0,0,2,10,12
2772,0,0,13,14,27
2773,0,0,8,20,28
2774,0,0,13,26,39
2775,0,0,3,7,10
2776,1,0,11,25,37
2777,0,0,8,21,29
2778,0,0,11,11,22
2779,0,0,2,5,7
2780,1,0,6,41,48
2781,0,0,5,4,9
2782,0,1,10,11,22
2783,0,0,7,11,18
2784,0,0,6,14,20
2785,0,0,1,4,5
2786,0,1,0,7,8
2787,0,0,6,13,19
2788,0,0,3,10,13
2790,0,0,2,3,5
2791,0,1,3,1,5
2792,0,0,3,17,20
2793,0,0,9,31,40
2794,0,1,3,6,10
2795,0,0,0,9,9
2796,0,1,9,14,24
2797,2,0,5,26,33
2798,0,0,1,16,17
2800,0,1,1,17,19
2802,0,0,4,11,15
2803,0,0,5,18,23
2804,0,5,6,8,19
2805,0,0,1,11,12
2806,0,0,0,5,5
2807,0,0,7,11,18
2808,0,0,5,9,14
2809,0,0,6,10,16
2810,0,0,0,4,4
2811,1,0,1,4,6
2812,0,0,4,6,10
2813,0,0,10,7,17
2814,0,2,3,6,11
2815,0,0,11,6,17
2816,0,0,0,6,6
2817,0,0,5,4,9
2818,0,0,8,16,24
2819,0,0,4,10,14
2820,1,0,4,10,15
2821,1,0,2,4,7
2823,0,4,8,23,35
2824,1,0,5,4,10
2825,0,0,2,9,11
2826,0,0,3,8,11
2828,0,0,3,5,8
2829,0,0,0,5,5
2830,1,0,0,9,10
2831,0,0,3,12,15
2832,0,1,5,11,17
2833,1,0,13,36,50
2834,0,0,8,15,23
2835,1,0,22,27,50
2836,0,0,4,13,17
2837,0,1,4,45,50
2838,1,0,8,41,50
2839,1,0,10,39,50
2840,1,0,1,8,10
2841,0,0,1,7,8
2842,1,0,2,13,16
2843,1,1,14,27,43
2844,0,0,5,6,11
2845,0,2,11,28,41
2846,2,1,1,12,16
2847,0,0,0,9,9
2848,0,1,18,25,44
2849,0,0,9,41,50
2850,0,2,11,37,50
2851,1,2,8,38,49
2852,0,0,7,20,27
2853,0,0,4,8,12
2854,1,0,12,29,42
2856,0,0,11,18,29
2857,0,1,4,42,47
2858,1,0,14,35,50
2859,0,0,9,28,37
2860,0,0,6,15,21
2861,0,0,8,21,29
2862,0,0,2,11,13
2863,0,0,5,9,14
2864,0,0,0,6,6
2865,0,0,8,25,33
2866,0,0,13,13,26
2867,0,0,4,22,26
2868,0,0,12,38,50
2869,1,0,13,25,39
2870,0,0,3,8,11
2871,0,0,5,18,23
2872,1,0,3,16,20
2873,1,0,5,29,35
2874,1,0,10,15,26
2875,1,0,4,10,15
2876,0,1,8,41,50
2877,0,0,7,20,27
2878,1,0,6,21,28
2879,0,0,5,2,7
2880,0,0,14,27,41
2881,0,2,8,23,33
2882,0,1,5,11,17
2883,0,0,20,30,50
2884,0,0,3,9,12
2885,0,0,3,17,20
2886,0,0,7,15,22
2887,0,1,6,43,50
2888,0,0,6,12,18
2889,0,1,13,26,40
2890,0,0,4,17,21
2891,1,0,12,35,48
2892,0,1,3,29,33
2893,0,0,11,28,39
2894,1,0,8,36,45
2895,1,1,6,35,43
2896,0,1,14,23,38
2897,1,0,6,40,47
2898,1,0,0,11,12
2899,1,0,0,9,10
2900,1,0,10,39,50
2901,0,0,8,16,24
2902,0,2,3,6,11
2903,0,0,12,23,35
2904,0,1,2,12,15
2905,1,2,8,38,49
2906,1,0,10,39,50
2907,0,1,4,45,50
2908,1,0,6,21,28
2909,0,0,4,13,17
2910,1,0,8,41,50
2911,0,2,16,20,38
2912,1,1,10,38,50
2913,0,1,4,45,50
2914,0,0,8,14,22
2915,1,0,7,16,24
2916,1,2,9,38,50
2917,0,0,11,16,27
2918,1,0,14,35,50
2919,2,0,1,6,9
2920,0,0,16,32,48
2921,0,1,6,22,29
2922,0,0,3,15,18
2923,0,1,7,25,33
2924,0,0,3,19,22
2925,0,3,11,30,44
2926,0,0,6,19,25
2927,0,0,14,30,44
2928,0,1,7,11,19
2929,0,1,5,24,30
2930,0,0,6,6,12
2931,0,2,8,12,22
2932,0,0,10,18,28
2933,0,0,4,10,14
2935,1,0,2,7,10
2936,0,0,8,7,15
2937,0,0,6,10,16
2938,0,0,9,40,49
2939,0,0,1,10,11
2940,0,0,7,20,27
2941,0,1,12,23,36
2942,0,1,2,29,32
2943,0,0,14,21,35
2944,0,1,5,29,35
2945,0,0,9,18,27
2946,0,0,5,14,19
2947,0,0,3,10,13
2948,0,0,7,11,18
2949,0,0,7,13,20
2950,1,0,2,7,10
2951,0,0,9,31,40
2952,0,0,10,15,25
2953,0,0,3,8,11
2954,0,0,6,10,16
2955,0,0,1,5,6
2956,2,0,2,24,28
2957,0,0,14,32,46
2958,1,0,3,44,48
2959,0,0,1,0,1
2960,0,0,12,24,36
2961,0,0,13,37,50
2962,0,0,4,3,7
2963,0,1,6,11,18
2964,2,0,11,36,49
2965,1,1,5,10,17
2966,1,0,1,3,5
2967,2,0,1,6,9
2968,0,0,13,37,50
2969,0,0,9,13,22
2970,0,0,1,49,50
2971,0,0,8,7,15
2972,1,0,12,21,34
2973,0,0,5,14,19
2974,0,0,16,32,48
2975,0,0,13,37,50
2976,0,0,16,32,48
2977,0,0,11,16,27
2978,0,0,8,17,25
2979,1,1,1,27,30
2980,3,3,7,18,31
2982,3,3,7,18,31
2983,0,0,4,6,10
2984,0,0,4,8,12
2985,0,0,8,17,25
2986,3,3,7,18,31
2987,0,1,3,15,19
2988,1,1,1,27,30
2990,1,0,3,16,20
2992,0,0,2,2,4
2993,0,0,2,11,13
2994,0,0,3,8,11
2995,0,0,6,14,20
2996,0,0,4,14,18
2997,0,0,14,22,36
2998,0,0,6,6,12
2999,0,1,0,5,6
3000,0,1,5,8,14
3001,0,1,6,12,19
3002,0,0,13,13,26
3003,0,1,1,15,17
3004,0,0,2,8,10
3005,0,0,1,8,9
3006,0,2,5,19,26
3007,0,0,1,6,7
3008,0,4,9,18,31
3009,1,0,0,7,8
3010,0,1,4,12,17
3011,0,2,4,40,46
3012,0,0,1,4,5
3013,0,0,9,5,14
3014,0,0,5,2,7
3015,0,0,1,4,5
3016,0,1,13,17,31
3017,0,0,12,29,41
3018,0,0,3,9,12
3019,0,0,12,27,39
3020,0,0,8,15,23
3021,0,1,5,5,11
3022,0,0,2,11,13
3023,0,0,4,15,19
3026,0,0,5,10,15
3027,0,0,2,7,9
3028,0,0,10,15,25
3029,1,0,14,35,50
3030,0,0,4,9,13
3031,0,0,6,29,35
3032,0,0,7,10,17
3033,0,7,0,4,11
3034,0,0,0,4,4
3035,0,1,6,9,16
3036,0,0,7,5,12
3037,0,0,6,3,9
3038,0,0,1,6,7
3040,0,0,5,6,11
3041,0,1,3,7,11
3043,0,2,13,10,25
3044,0,0,5,6,11
3045,0,0,17,30,47
3046,0,0,10,22,32
3048,0,0,5,15,20
3049,0,1,0,7,8
3050,0,1,6,8,15
3051,0,1,8,6,15
3052,0,0,3,9,12
3053,0,1,0,5,6
3054,0,0,3,5,8
3055,0,0,6,4,10
3056,0,0,0,6,6
3057,0,0,3,5,8
3058,0,0,9,6,15
3059,0,1,5,6,12
3060,0,0,8,34,42
3061,1,0,5,6,12
3062,0,0,3,3,6
3063,0,0,8,12,20
3064,0,2,6,7,15
3065,0,1,3,11,15
3067,0,0,6,4,10
3068,0,0,2,2,4
3070,0,0,4,7,11
3071,0,0,1,15,16
3073,0,0,0,7,7
3074,0,0,7,40,47
3075,0,0,3,11,14
3076,0,0,14,14,28
3077,3,3,7,18,31
3078,0,0,12,14,26
3079,0,0,4,5,9
3080,1,0,3,16,20
3081,0,0,3,2,5
3083,0,0,5,13,18
3084,0,0,3,43,46
3085,0,0,9,22,31
3086,0,0,13,13,26
3087,1,0,10,19,30
3088,0,0,3,8,11
3089,0,0,2,6,8
3090,0,2,6,7,15
3091,0,0,10,16,26
3092,1,1,2,4,8
3093,0,0,11,11,22
3094,0,0,6,20,26
3095,0,0,2,10,12
3096,0,0,7,40,47
3097,0,0,10,21,31
3098,1,0,12,22,35
3099,0,0,4,5,9
3100,0,0,3,15,18
3101,0,0,4,19,23
3102,0,0,14,14,28
3103,0,0,12,14,26
3104,3,3,7,18,31
3105,0,0,2,3,5
3106,0,7,0,4,11
3107,0,0,2,6,8
3108,0,1,12,34,47
3109,0,0,8,12,20
3110,0,0,4,11,15
3111,0,0,3,43,46
3112,0,0,1,5,6
3113,0,0,3,11,14
3114,3,3,7,18,31
3115,0,0,4,11,15
3116,0,0,6,20,26
3117,0,0,3,11,14
3118,0,1,8,6,15
3119,0,0,14,14,28
3120,0,0,6,20,26
3121,0,0,1,15,16
3122,1,0,11,21,33
3123,0,0,2,3,5
3124,0,1,6,9,16
3125,0,0,5,0,5
3126,0,0,10,16,26
3127,0,0,2,2,4
3128,0,0,4,10,14
3129,0,0,11,19,30
3130,0,0,3,3,6
3131,0,0,1,4,5
3132,1,0,3,16,20
3134,0,0,1,5,6
3135,0,0,18,23,41
3136,0,4,3,10,17
3137,0,0,5,10,15
3138,0,0,0,3,3
3139,0,0,12,28,40
3140,0,0,8,17,25
3141,0,0,6,6,12
3142,0,3,6,5,14
3143,0,0,11,22,33
3144,0,0,3,13,16
3145,0,0,11,25,36
3146,0,0,8,2,10
3147,0,0,6,20,26
3148,0,0,4,9,13
3149,0,0,4,10,14
3150,0,0,2,9,11
3151,0,0,5,17,22
3152,0,0,2,4,6
3153,0,0,4,8,12
3154,2,1,5,12,20
3155,0,1,15,12,28
3156,0,0,7,7,14
3157,0,0,7,8,15
3158,0,0,11,16,27
3159,0,0,7,7,14
3160,0,0,5,4,9
3161,0,0,6,4,10
3162,0,1,21,27,49
3163,0,0,1,6,7
3164,0,0,2,5,7
3165,0,0,8,16,24
3166,0,2,6,7,15
3167,0,0,3,19,22
3168,0,0,10,8,18
3169,0,4,9,18,31
3170,0,0,5,9,14
3171,0,0,3,13,16
3172,0,0,1,6,7
3173,0,0,7,7,14
3174,0,1,7,26,34
3175,2,0,10,24,36
3176,0,1,5,11,17
3177,0,2,3,15,20
3178,0,0,7,17,24
3179,1,0,4,23,28
3180,0,0,11,12,23
3181,0,0,3,7,10
3182,0,0,5,7,12
3183,0,1,0,14,15
3184,0,0,7,8,15
3185,0,0,6,8,14
3186,0,0,9,19,28
3187,0,0,11,16,27
3188,0,0,4,2,6
3189,0,0,9,17,26
3190,0,0,3,1,4
3191,0,0,13,25,38
3192,0,1,4,19,24
3193,0,0,8,26,34
3194,0,1,3,11,15
3195,0,0,5,8,13
3196,0,0,6,16,22
3197,0,0,13,15,28
3198,0,0,1,5,6
3199,0,0,1,4,5
3200,0,0,6,16,22
3201,0,0,5,20,25
3202,0,0,7,7,14
3203,0,7,5,38,50
3204,0,0,2,3,5
3205,0,1,8,17,26
3206,0,0,6,44,50
3207,0,0,7,8,15
3208,0,0,6,11,17
3209,1,0,6,25,32
3210,0,0,13,13,26
3211,0,0,15,7,22
3212,0,1,6,4,11
3213,0,0,4,11,15
3214,0,0,6,11,17
3215,0,0,4,3,7
3216,0,0,12,35,47
3217,0,2,5,12,19
3218,0,0,11,22,33
3219,0,0,2,2,4
3220,0,0,9,22,31
3221,0,0,4,15,19
3222,0,4,7,9,20
3223,0,0,2,9,11
3224,0,0,4,2,6
3225,0,0,8,18,26
3226,0,0,5,22,27
3227,0,0,0,11,11
3228,0,1,5,6,12
3229,0,0,2,13,15
3230,0,0,10,21,31
3231,0,0,5,9,14
3232,0,0,18,14,32
3233,0,0,8,19,27
3234,0,0,2,10,12
3235,0,2,10,8,20
3236,0,4,5,18,27
3237,0,1,12,19,32
3238,0,0,14,24,38
3239,0,0,6,14,20
3240,0,0,4,8,12
3241,0,0,3,2,5
3242,0,1,8,19,28
3243,0,1,6,24,31
3244,0,0,5,7,12
3245,0,0,8,11,19
3246,0,1,5,18,24
3247,0,2,12,32,46
3248,1,1,6,14,22
3249,0,0,4,7,11
3250,0,1,6,13,20
3251,0,0,3,6,9
3252,0,0,5,12,17
3253,0,0,1,4,5
3254,0,0,2,9,11
3255,1,1,13,13,28
3256,0,0,9,15,24
3257,0,0,5,7,12
3258,0,0,9,13,22
3259,0,1,1,4,6
3260,0,1,6,6,13
3261,0,0,8,16,24
3262,0,0,5,13,18
3264,0,0,8,27,35
3265,0,0,5,8,13
3266,0,0,4,11,15
3267,0,1,4,11,16
3268,0,0,5,5,10
3269,0,1,9,18,28
3270,0,0,0,7,7
3271,1,1,1,9,12
3272,2,0,0,3,5
3273,0,1,2,9,12
3274,0,1,5,1,7
3275,0,0,4,8,12
3276,0,0,4,11,15
3277,1,1,11,37,50
3278,0,0,9,7,16
3279,0,0,8,4,12
3280,0,0,5,9,14
3281,0,0,5,8,13
3282,0,0,7,14,21
3284,0,2,14,33,49
3285,0,0,0,6,6
3286,0,0,10,16,26
3287,0,0,1,4,5
3288,0,0,14,16,30
3289,0,0,4,7,11
3290,0,0,6,16,22
3291,0,2,9,18,29
3293,0,0,2,6,8
3294,0,0,3,8,11
3295,0,0,7,16,23
3296,0,1,8,6,15
3297,0,0,7,1,8
3298,0,0,2,5,7
3299,0,0,3,3,6
3300,0,0,4,3,7
3301,0,0,1,4,5
3302,0,0,5,10,15
3303,0,0,3,1,4
3305,0,0,4,11,15
3306,0,0,6,2,8
3307,0,0,0,5,5
3308,0,0,9,21,30
3309,1,1,1,36,39
3310,0,0,5,6,11
3311,0,0,7,22,29
3312,0,0,8,38,46
3313,0,0,4,3,7
3314,0,0,5,4,9
3315,0,0,4,15,19
3316,0,0,10,34,44
3317,0,0,7,12,19
3318,0,0,5,5,10
3319,0,0,1,15,16
3320,1,5,8,13,27
3321,0,0,9,8,17
3322,0,0,7,28,35
3324,0,0,11,12,23
3325,0,0,12,24,36
3326,0,0,9,17,26
3327,0,0,3,3,6
3328,0,0,3,6,9
3329,0,0,8,16,24
3330,0,0,8,15,23
3331,0,0,1,11,12
3332,0,0,3,4,7
3334,0,0,0,5,5
3336,0,0,4,5,9
3337,0,0,2,9,11
3338,0,0,1,4,5
3339,0,0,10,16,26
3340,0,0,8,8,16
3341,0,0,2,7,9
3342,0,0,6,5,11
3343,0,1,2,5,8
3344,0,0,9,3,12
3345,0,0,16,24,40
3346,1,1,8,37,47
3347,0,0,3,10,13
3348,0,0,14,29,43
3349,0,1,5,5,11
3350,0,0,0,5,5
3351,0,0,2,4,6
3352,0,0,6,12,18
3353,0,0,0,7,7
3354,0,0,8,22,30
3355,0,7,0,4,11
3356,0,0,4,10,14
3357,0,2,2,9,13
3358,0,0,14,14,28
3360,1,0,3,16,20
3361,0,0,8,9,17
3362,0,0,11,17,28
3363,0,1,7,10,18
3364,0,1,0,24,25
3365,0,1,2,12,15
3366,0,0,14,29,43
3367,0,1,12,13,26
3368,0,0,2,4,6
3369,0,0,8,10,18
3370,0,0,10,23,33
3373,0,1,21,27,49
3374,0,2,18,11,31
3375,0,0,14,26,40
3376,0,0,5,10,15
3377,0,0,6,20,26
3378,0,0,3,3,6
3379,0,0,12,28,40
3380,0,1,1,21,23
3381,0,0,4,14,18
3382,1,1,4,20,26
3383,0,0,12,25,37
3384,1,0,3,9,13
3385,0,2,14,32,48
3386,0,0,12,27,39
3387,0,0,16,28,44
3388,0,0,11,13,24
3389,0,0,8,7,15
3390,0,0,2,4,6
3391,0,1,15,33,49
3392,0,0,13,16,29
3393,0,0,6,7,13
3394,0,0,8,21,29
3395,0,0,3,10,13
3396,0,4,9,19,32
3397,0,0,7,5,12
3398,1,0,12,30,43
3399,0,0,9,41,50
3400,0,0,5,24,29
3401,0,0,15,25,40
3402,0,0,11,25,36
3403,0,0,5,10,15
3404,0,0,3,6,9
3405,0,3,8,29,40
3406,0,1,8,15,24
3407,0,0,13,19,32
3408,0,0,11,7,18
3411,0,0,2,7,9
3412,0,0,3,14,17
3413,0,0,16,24,40
3414,0,1,12,19,32
3415,0,0,14,36,50
3416,0,0,9,3,12
3417,0,2,6,7,15
3418,0,0,11,16,27
3419,0,7,0,4,11
3420,0,0,2,6,8
3421,0,0,10,16,26
3422,0,2,2,9,13
3423,0,0,8,22,30
3424,0,0,14,14,28
3425,0,0,16,34,50
3426,0,0,0,22,22
3427,0,0,2,8,10
3428,0,0,7,15,22
3429,0,1,0,24,25
3430,0,0,1,4,5
3431,0,0,0,26,26
3432,0,0,14,29,43
3433,0,0,2,4,6
3434,0,0,2,7,9
3435,1,1,8,37,47
3436,0,0,6,12,18
3437,0,0,1,4,5
3438,0,0,6,20,26
3439,0,0,1,4,5
3440,0,7,5,38,50
3441,0,0,6,12,18
3442,0,0,14,36,50
3443,0,0,14,14,28
3444,1,1,8,37,47
3445,0,7,5,38,50
3446,0,0,6,20,26
3447,0,0,10,16,26
3448,0,0,1,4,5
3449,0,0,2,6,8
3450,0,0,5,9,14
3451,0,0,8,8,16
3452,0,0,5,4,9
3453,0,0,10,12,22
3454,0,1,10,20,31
3455,0,0,5,14,19
3456,0,0,5,14,19
3457,0,2,6,41,49
3458,0,0,7,5,12
3459,0,1,0,13,14
3460,0,0,1,1,2
3461,0,0,3,2,5
3462,0,0,6,9,15
3463,1,1,7,16,25
3464,0,0,10,14,24
3465,0,0,6,12,18
3466,0,1,12,13,26
3467,0,0,6,26,32
3468,0,1,14,33,48
3469,0,2,5,11,18
3470,0,0,6,10,16
3471,0,2,8,20,30
3472,0,0,2,6,8
3473,0,0,0,3,3
3474,0,0,7,28,35
3475,0,0,9,33,42
3476,0,0,2,8,10
3477,0,0,4,11,15
3478,1,3,5,24,33
3479,0,0,11,15,26
3480,0,0,6,12,18
3481,0,0,1,2,3
3482,0,0,3,8,11
3483,0,0,2,7,9
3484,0,0,8,22,30
3485,0,0,5,5,10
3486,0,1,7,16,24
3487,0,2,2,11,15
3488,0,0,13,24,37
3489,0,0,5,4,9
3490,0,0,6,14,20
3491,0,0,6,12,18
3492,0,0,2,10,12
3493,0,0,11,20,31
3494,0,1,8,28,37
3495,1,1,5,24,31
3496,0,0,6,21,27
3497,0,1,7,10,18
3498,0,0,5,3,8
3499,0,0,3,6,9
3500,0,0,2,8,10
3503,0,0,7,29,36
3504,0,0,6,7,13
3505,0,0,4,13,17
3506,0,0,7,15,22
3507,1,1,7,30,39
3508,0,1,10,18,29
3509,0,0,2,13,15
3510,0,0,1,5,6
3511,0,0,2,2,4
3512,0,0,3,3,6
3513,0,1,5,13,19
3514,1,0,10,21,32
3515,0,1,8,13,22
3516,0,0,3,4,7
3517,0,1,7,14,22
3518,0,1,7,9,17
3519,0,0,5,5,10
3520,0,3,7,27,37
3521,0,0,5,14,19
3522,0,0,5,15,20
3523,0,1,3,3,7
3524,0,0,5,1,6
3526,0,0,4,12,16
3527,0,0,7,15,22
3528,0,1,16,33,50
3529,0,1,5,9,15
3530,0,0,7,13,20
3531,0,0,9,24,33
3532,0,0,5,13,18
3533,0,0,8,22,30
3534,0,0,8,21,29
3535,0,0,3,11,14
3537,0,0,5,22,27
3538,0,0,5,26,31
3539,0,0,9,12,21
3540,0,0,9,3,12
3541,0,0,10,7,17
3542,0,0,4,5,9
3543,0,0,5,16,21
3544,0,0,2,6,8
3545,0,0,10,15,25
3546,0,0,3,7,10
3547,0,0,0,12,12
3548,0,0,8,16,24
3549,0,0,4,5,9
3550,0,0,6,16,22
3552,0,0,1,11,12
3553,0,0,0,1,1
3554,0,1,6,36,43
3555,2,0,13,30,45
3556,0,0,4,7,11
3557,0,0,7,13,20
3558,0,0,0,11,11
3559,0,0,7,8,15
3560,0,0,5,3,8
3561,0,0,4,27,31
3562,0,0,4,27,31
3563,0,0,5,17,22
3564,0,0,9,23,32
3565,0,0,1,8,9
3566,0,1,17,27,45
3567,0,0,6,15,21
3568,0,0,3,8,11
3569,0,0,3,10,13
3570,0,0,8,8,16
3571,0,0,14,35,49
3572,0,1,4,14,19
3573,0,0,3,6,9
3574,0,0,11,21,32
3575,1,0,9,16,26
3576,0,1,7,27,35
3577,0,0,9,10,19
3578,0,0,7,9,16
3579,0,0,4,4,8
3581,0,2,8,10,20
3583,0,0,3,8,11
3584,0,0,1,1,2
3585,0,0,3,14,17
3586,0,0,6,6,12
3587,0,0,2,7,9
3588,0,0,5,13,18
3589,0,0,3,4,7
3590,0,0,3,2,5
3591,0,1,8,14,23
3592,0,0,4,18,22
3593,0,0,7,40,47
3594,0,1,5,22,28
3595,0,0,3,13,16
3596,0,0,2,6,8
3597,0,0,9,25,34
3598,0,0,0,8,8
3599,0,0,4,3,7
3600,0,0,11,10,21
3601,0,0,15,35,50
3602,0,2,14,34,50
3603,0,1,4,1,6
3604,0,0,2,31,33
3605,0,0,8,18,26
3606,0,0,5,10,15
3607,0,0,6,18,24
3608,0,1,4,14,19
3609,0,0,10,12,22
3610,0,0,12,11,23
3611,0,1,7,15,23
3612,0,0,13,30,43
3613,0,1,5,22,28
3614,0,0,10,11,21
3615,0,0,10,18,28
3616,0,0,4,9,13
3617,0,0,4,8,12
3618,0,0,6,26,32
3619,1,1,14,25,41
3620,0,0,9,11,20
3621,0,0,4,18,22
3622,0,0,15,27,42
3623,0,0,10,27,37
3624,0,0,9,11,20
3626,0,0,12,21,33
3627,0,3,10,25,38
3628,0,0,11,30,41
3629,0,0,2,5,7
3630,0,0,8,42,50
3631,0,0,10,8,18
3632,0,0,1,15,16
3633,0,1,13,19,33
3634,0,0,25,24,49
3635,0,0,14,26,40
3636,0,1,2,5,8
3637,0,0,10,18,28
3638,0,0,4,15,19
3639,0,0,7,18,25
3640,2,0,4,14,20
3641,0,0,0,3,3
3642,0,1,15,14,30
3643,1,0,9,16,26
3644,0,0,10,36,46
3645,0,1,12,19,32
3646,0,2,8,13,23
3647,0,0,18,11,29
3648,0,1,4,28,33
3649,0,1,10,33,44
3650,0,1,4,19,24
3651,0,0,13,10,23
3652,0,1,18,31,50
3653,0,0,5,21,26
3654,0,0,7,40,47
3655,0,0,9,25,34
3656,0,0,7,15,22
3657,0,0,4,27,31
3658,0,1,8,28,37
3659,0,0,9,3,12
3660,0,0,3,13,16
3661,0,0,12,18,30
3662,0,1,8,28,37
3664,0,0,13,24,37
3665,0,1,2,15,18
3666,1,1,14,25,41
3667,0,0,10,13,23
3668,0,0,15,27,42
3669,0,0,6,12,18
3670,0,0,6,12,18
3671,1,1,7,16,25
3672,0,0,3,13,16
3673,0,0,2,17,19
3674,0,0,4,9,13
3675,0,0,4,6,10
3677,0,0,6,7,13
3678,1,2,8,37,48
3679,0,2,4,18,24
3680,0,0,14,29,43
3681,0,0,8,15,23
3682,0,0,16,18,34
3683,0,0,1,19,20
3684,0,0,0,5,5
3685,0,0,2,8,10
3686,0,1,9,17,27
3687,0,0,10,9,19
3688,0,0,5,20,25
3689,0,0,10,12,22
3690,0,1,1,7,9
3691,0,0,9,26,35
3692,1,0,0,7,8
3693,0,1,15,34,50
3694,0,0,0,4,4
3695,0,1,6,12,19
3696,0,0,3,1,4
3697,0,0,4,9,13
3698,0,0,1,12,13
3699,1,0,2,7,10
3700,0,2,10,31,43
3702,0,0,5,8,13
3703,0,0,9,22,31
3705,0,0,6,12,18
3706,0,0,6,12,18
3707,0,0,10,17,27
3708,0,0,2,7,9
3709,0,0,11,22,33
3710,0,0,9,19,28
3711,0,0,12,29,41
3712,0,1,1,14,16
3713,0,0,3,8,11
3714,0,0,4,9,13
3715,0,0,1,4,5
3716,0,0,6,11,17
3717,0,0,9,7,16
3718,0,0,1,15,16
3719,0,0,4,6,10
3720,0,0,9,15,24
3721,0,0,6,14,20
3722,0,0,6,5,11
3723,0,1,8,10,19
3724,0,0,7,7,14
3725,0,0,4,24,28
3726,0,0,3,5,8
3727,0,1,7,22,30
3728,0,0,5,3,8
3730,0,0,3,11,14
3731,0,0,8,7,15
3732,0,0,2,6,8
3733,0,0,6,2,8
3734,0,0,2,17,19
3735,0,2,2,5,9
3736,0,0,4,1,5
3737,0,0,1,15,16
3738,0,0,9,24,33
3739,0,0,6,10,16
3740,0,0,7,10,17
3741,0,0,8,12,20
3742,0,2,6,19,27
3743,0,0,8,13,21
3744,0,0,8,13,21
3745,0,0,10,28,38
3746,0,1,7,4,12
3747,0,0,5,10,15
3748,0,1,6,10,17
3749,0,1,8,11,20
3750,0,0,10,17,27
3751,0,0,8,21,29
3752,0,0,8,14,22
3753,0,0,0,9,9
3754,0,0,3,14,17
3755,0,0,11,6,17
3756,0,0,8,7,15
3757,0,0,6,10,16
3758,0,0,2,14,16
3759,0,0,6,7,13
3760,0,0,6,9,15
3761,1,0,8,15,24
3762,0,0,6,7,13
3763,0,0,7,4,11
3764,2,0,14,18,34
3765,0,0,7,16,23
3766,0,1,6,10,17
3767,0,0,3,5,8
3768,0,0,1,14,15
3769,0,0,5,3,8
3770,0,0,10,12,22
3771,0,1,5,11,17
3772,0,0,4,10,14
3773,0,0,9,9,18
3774,0,0,2,14,16
3777,0,0,11,11,22
3778,0,0,8,4,12
3779,0,0,2,0,2
3780,0,1,5,6,12
3782,0,0,3,2,5
3783,0,0,1,5,6
3784,0,0,6,10,16
3785,0,0,2,9,11
3786,1,0,1,7,9
3787,0,0,2,4,6
3788,0,0,0,11,11
3789,0,0,3,13,16
3791,0,1,5,22,28
3792,0,2,2,9,13
3793,0,1,5,6,12
3794,0,0,11,16,27
3795,0,0,8,12,20
3796,0,0,3,9,12
3797,0,0,12,10,22
3798,0,0,10,15,25
3799,0,0,8,15,23
3800,1,0,7,21,29
3801,0,0,10,39,49
3802,0,0,11,16,27
3803,0,0,6,8,14
3804,0,0,0,14,14
3805,0,1,4,19,24
3806,0,3,2,33,38
3807,0,0,13,19,32
3808,0,0,6,15,21
3809,0,0,1,4,5
3810,0,2,14,29,45
3811,0,1,3,18,22
3812,1,0,3,3,7
3813,0,0,6,2,8
3814,0,0,3,23,26
3815,0,0,12,25,37
3816,0,0,7,16,23
3817,0,1,12,37,50
3818,0,0,3,6,9
3819,0,1,7,18,26
3820,0,0,12,11,23
3821,0,0,14,36,50
3822,0,0,10,28,38
3823,0,1,7,8,16
3824,0,0,8,16,24
3825,1,0,16,32,49
3826,0,0,3,39,42
3827,0,0,3,35,38
3828,0,0,1,3,4
3829,0,0,17,32,49
3830,0,1,0,12,13
3831,0,0,11,12,23
3832,0,3,18,26,47
3833,0,0,6,44,50
3834,0,0,12,23,35
3835,0,0,2,3,5
3836,0,0,3,15,18
3837,0,0,0,6,6
3838,0,0,1,3,4
3839,0,2,2,9,13
3840,0,2,10,31,43
3841,0,1,2,17,20
3842,0,0,3,13,16
3843,0,0,2,6,8
3844,0,0,14,29,43
3845,0,1,5,22,28
3847,0,0,10,23,33
3848,0,0,8,25,33
3849,0,0,14,29,43
3850,0,0,8,12,20
3851,0,1,11,13,25
3852,0,1,0,6,7
3853,0,0,1,11,12
3854,0,0,6,7,13
3855,0,0,0,22,22
3857,0,0,0,11,11
3858,0,0,0,4,4
3859,0,0,0,14,14
3860,0,0,0,10,10
3861,0,0,14,36,50
3862,0,0,2,3,5
3863,0,0,2,31,33
3864,0,0,10,22,32
3865,0,0,2,13,15
3866,0,0,4,6,10
3867,0,1,10,20,31
3868,0,0,1,4,5
3869,1,0,12,29,42
3870,0,0,3,14,17
3871,0,1,20,29,50
3872,0,0,0,11,11
3873,0,0,6,10,16
3874,0,0,15,23,38
3875,0,0,3,20,23
3876,0,0,14,31,45
3877,0,0,12,16,28
3878,0,0,6,4,10
3879,0,0,4,5,9
3880,0,0,3,8,11
3881,0,0,8,5,13
3882,0,0,2,10,12
3883,0,0,4,30,34
3884,0,0,8,14,22
3885,0,0,0,3,3
3886,0,1,3,8,12
3887,0,0,8,13,21
3888,0,2,13,29,44
3889,0,1,3,7,11
3890,0,1,6,4,11
3891,0,0,14,31,45
3892,0,0,8,16,24
3893,0,0,4,4,8
3894,0,0,6,8,14
3895,0,0,6,7,13
3896,0,0,3,8,11
3897,0,0,7,15,22
3898,0,0,6,15,21
3899,0,0,2,9,11
3900,0,0,3,8,11
3901,0,0,3,3,6
3903,0,0,8,17,25
3904,1,0,10,21,32
3905,0,0,4,5,9
3906,0,0,6,15,21
3907,0,1,11,24,36
3908,0,3,11,30,44
3909,0,1,3,21,25
3910,0,0,5,11,16
3911,0,0,8,12,20
3913,0,0,7,16,23
3914,0,0,11,17,28
3915,0,0,4,5,9
3916,0,2,2,9,13
3917,0,0,1,4,5
3918,0,3,8,13,24
3919,0,0,3,3,6
3920,0,1,5,10,16
3921,0,0,0,3,3
3922,0,0,2,3,5
3923,0,0,12,10,22
3924,0,0,7,40,47
3925,0,0,16,24,40
3926,0,0,1,4,5
3927,0,0,9,3,12
3928,1,1,10,20,32
3929,0,0,10,5,15
3930,0,0,12,11,23
3931,0,0,19,31,50
3932,3,0,1,10,14
3933,0,1,8,41,50
3934,0,0,16,34,50
3935,0,1,11,22,34
3936,0,0,10,22,32
3937,0,0,10,18,28
3938,0,0,9,14,23
3939,0,0,4,7,11
3940,0,0,8,26,34
3941,0,0,10,36,46
3942,0,0,15,22,37
3943,0,0,8,14,22
3944,0,0,12,11,23
3945,0,0,8,11,19
3946,0,0,19,29,48
3947,0,0,0,5,5
3948,0,0,7,14,21
3949,0,0,2,20,22
3950,0,0,10,10,20
3951,0,0,11,13,24
3952,0,0,7,10,17
3953,0,0,12,10,22
3954,0,0,4,6,10
3955,0,0,8,18,26
3957,0,0,5,24,29
3958,0,2,2,9,13
3959,0,0,8,17,25
3960,1,0,5,6,12
3961,0,0,9,3,12
3962,0,0,7,40,47
3963,0,0,14,31,45
3964,0,0,16,24,40
3965,0,0,14,31,45
3966,0,0,1,21,22
3967,0,1,10,37,48
3970,0,1,12,26,39
3971,0,0,3,16,19
3972,0,0,0,6,6
3973,0,0,5,24,29
3974,1,1,15,30,47
3975,0,0,5,24,29
3976,0,0,8,17,25
3977,0,0,8,17,25
3978,0,0,10,10,20
3979,1,0,3,16,20
3980,0,0,6,18,24
3981,0,0,4,12,16
3982,0,0,6,2,8
3983,0,0,8,23,31
3984,0,0,7,26,33
3985,0,0,11,29,40
3986,0,0,9,24,33
3987,0,0,11,36,47
3988,0,0,5,14,19
3989,0,0,9,10,19
3990,0,0,6,11,17
3991,0,0,5,16,21
3992,0,0,12,26,38
3993,1,3,14,30,48
3994,0,0,10,24,34
3995,1,6,3,28,38
3996,0,1,15,20,36
3997,0,0,2,23,25
3998,0,0,7,21,28
3999,1,0,5,32,38
4000,0,1,14,28,43
4001,0,0,1,6,7
4002,0,0,3,19,22
4003,0,0,8,18,26
4004,0,0,11,16,27
4005,0,1,11,34,46
4006,1,1,8,37,47
4007,0,0,3,3,6
4008,0,1,6,7,14
4009,0,0,7,18,25
4010,0,0,4,23,27
4011,0,1,7,12,20
4012,0,3,2,41,46
4013,0,0,8,11,19
4014,0,1,5,24,30
4015,0,1,16,28,45
4016,0,0,3,4,7
4017,0,0,0,4,4
4018,1,2,6,16,25
4019,0,0,5,11,16
4020,0,0,7,17,24
4021,0,0,7,5,12
4022,0,0,0,6,6
4023,0,3,12,25,40
4024,0,3,2,23,28
4026,0,0,3,3,6
4027,0,0,13,15,28
4028,0,0,7,16,23
4029,0,0,8,6,14
4030,2,1,6,13,22
4031,0,0,10,27,37
4032,0,1,4,20,25
4033,0,0,7,22,29
4034,0,0,7,11,18
4035,0,1,11,32,44
4036,0,0,15,23,38
4037,0,0,5,19,24
4038,0,0,0,1,1
4039,0,0,3,4,7
4040,1,0,11,38,50
4041,0,0,4,9,13
4042,0,1,10,15,26
4043,0,1,9,10,20
4044,1,0,5,17,23
4045,0,1,6,1,8
4046,0,0,3,5,8
4047,1,2,6,16,25
4048,0,0,6,6,12
4049,0,0,3,1,4
4050,0,0,7,21,28
4051,0,0,3,19,22
4052,1,0,17,32,50
4053,0,0,1,4,5
4054,0,0,4,4,8
4055,0,1,15,34,50
4056,0,0,13,32,45
4057,0,1,10,39,50
4058,0,0,2,7,9
4059,0,0,5,5,10
4060,0,0,2,6,8
4061,0,1,6,29,36
4062,0,0,8,14,22
4063,0,0,14,27,41
4064,0,0,0,3,3
4065,0,0,2,2,4
4066,0,0,6,9,15
4067,0,0,2,2,4
4068,0,0,5,11,16
4069,0,0,6,17,23
4070,0,0,7,12,19
4071,0,0,6,5,11
4072,3,3,7,18,31
4073,0,0,15,21,36
4074,1,0,7,22,30
4075,0,0,9,25,34
4076,0,1,2,7,10
4077,0,1,8,12,21
4078,0,0,0,7,7
4079,0,1,21,21,43
4080,0,0,18,23,41
4081,0,0,16,19,35
4082,0,0,7,14,21
4083,0,0,5,10,15
4084,0,0,1,8,9
4085,0,0,6,18,24
4086,0,1,9,30,40
4087,0,0,7,8,15
4088,0,1,4,9,14
4090,0,0,17,26,43
4091,0,0,14,33,47
4092,0,0,10,24,34
4093,0,0,0,5,5
4094,0,2,10,38,50
4095,0,0,6,8,14
4096,0,0,9,15,24
4097,0,0,6,11,17
4098,0,0,3,5,8
4099,0,0,3,11,14
4100,0,0,4,1,5
4101,0,0,1,7,8
4102,0,0,8,16,24
4103,0,0,1,12,13
4104,0,1,16,31,48
4105,0,0,8,7,15
4106,0,0,2,2,4
4107,0,0,2,8,10
4108,0,1,2,13,16
4109,0,0,0,1,1
4110,0,0,1,6,7
4111,0,0,0,6,6
4112,0,0,10,23,33
4113,0,0,7,40,47
4114,0,0,10,9,19
4115,0,0,5,14,19
4116,0,0,4,3,7
4117,0,0,4,4,8
4118,1,1,8,33,43
4119,0,0,4,6,10
4120,0,0,3,9,12
4121,0,0,9,12,21
4122,0,0,2,4,6
4123,0,0,5,3,8
4124,0,0,1,3,4
4126,0,0,1,7,8
4127,0,0,5,9,14
4128,0,0,1,6,7
4129,0,0,4,3,7
4130,0,0,7,20,27
4131,1,1,6,11,19
4133,0,0,2,4,6
4134,0,0,8,22,30
4135,0,0,7,9,16
4136,0,1,15,23,39
4137,1,0,3,16,20
4139,0,0,6,7,13
4140,0,0,1,9,10
4141,0,0,10,16,26
4142,1,0,2,12,15
4143,0,0,15,14,29
4144,0,0,8,19,27
4145,0,0,8,20,28
4146,0,0,0,5,5
4147,0,0,2,9,11
4150,0,0,3,4,7
4152,0,0,4,5,9
4155,0,0,3,3,6
4156,0,0,10,14,24
4157,0,0,5,15,20
4158,0,0,2,2,4
4159,0,1,5,12,18
4160,0,0,18,30,48
4161,0,0,1,2,3
4162,0,0,1,4,5
4163,0,0,5,7,12
4164,0,0,2,6,8
4165,0,0,3,13,16
4166,0,2,10,31,43
4167,0,1,8,28,37
4168,0,0,8,17,25
4169,0,0,1,5,6
4170,0,0,6,24,30
4171,0,0,1,8,9
4172,0,0,6,18,24
4173,0,0,3,7,10
4174,1,0,7,9,17
4175,0,0,17,33,50
4176,0,0,7,16,23
4177,2,1,7,14,24
4178,0,0,2,5,7
4179,0,0,2,23,25
4180,0,0,6,9,15
4181,0,1,10,30,41
4182,0,0,11,39,50
4183,0,0,13,30,43
4184,0,0,11,28,39
4185,0,1,4,16,21
4186,0,0,8,18,26
4187,0,2,21,27,50
4188,0,0,10,16,26
4189,0,0,8,18,26
4190,0,0,6,9,15
4191,0,0,2,8,10
4192,1,1,27,21,50
4193,0,0,10,28,38
4194,0,0,8,11,19
4195,0,0,5,12,17
4196,0,0,9,19,28
4197,0,1,12,37,50
4198,0,0,9,29,38
4199,1,0,9,18,28
4200,0,0,5,22,27
4201,0,0,6,5,11
4202,1,1,10,38,50
4203,0,0,7,13,20
4204,0,1,8,28,37
4205,0,2,11,12,25
4206,0,0,3,17,20
4207,0,0,6,15,21
4208,1,1,11,20,33
4209,0,1,6,16,23
4210,0,0,0,8,8
4211,0,0,12,19,31
4212,0,0,13,35,48
4213,0,0,9,7,16
4214,0,1,4,11,16
4215,1,1,20,27,49
4216,0,0,5,20,25
4217,0,0,1,11,12
4218,0,0,2,16,18
4220,0,1,6,29,36
4221,0,0,5,18,23
4222,0,0,19,31,50
4223,0,0,16,19,35
4224,0,1,13,27,41
4225,0,0,9,11,20
4226,0,0,0,8,8
4227,0,0,7,14,21
4228,2,0,12,11,25
4229,1,0,3,46,50
4231,0,0,4,7,11
4232,0,0,7,18,25
4233,0,0,4,12,16
4234,1,1,7,33,42
4235,0,0,11,23,34
4236,0,0,4,14,18
4237,0,1,8,11,20
4238,0,1,5,4,10
4239,0,2,2,16,20
4240,0,0,8,20,28
4241,0,0,5,10,15
4242,0,0,0,14,14
4243,0,0,3,13,16
4244,0,0,8,17,25
4245,3,3,7,18,31
4246,0,2,10,31,43
4247,0,0,2,6,8
4248,0,0,11,16,27
4249,0,0,9,25,34
4250,0,0,18,30,48
4251,0,0,7,40,47
4252,1,0,9,19,29
4253,0,2,8,25,35
4254,0,0,13,37,50
4255,0,0,9,26,35
4256,0,0,18,32,50
4257,0,1,4,30,35
4258,0,0,4,14,18
4259,0,1,8,28,37
4260,0,0,1,4,5
4262,0,0,3,11,14
4263,4,1,3,15,23
4264,0,3,2,41,46
4265,1,1,8,37,47
4266,0,0,0,14,14
4267,3,3,7,18,31
4268,0,0,1,4,5
4269,0,0,3,11,14
4270,0,1,6,29,36
4271,1,1,8,37,47
4272,0,0,10,16,26
4273,0,0,4,12,16
4274,0,0,2,7,9
4275,0,0,7,16,23
4276,0,1,5,14,20
4277,0,0,1,8,9
4278,0,0,8,17,25
4279,0,0,7,22,29
4280,0,0,1,4,5
4281,0,0,3,6,9
4282,0,0,6,4,10
4283,0,1,4,13,18
4284,0,0,1,12,13
4286,0,0,8,9,17
4287,0,1,7,17,25
4288,0,1,6,16,23
4289,0,0,3,13,16
4290,0,3,4,43,50
4292,0,0,3,9,12
4293,0,0,11,18,29
4294,0,0,4,7,11
4295,0,0,15,24,39
4296,0,2,8,13,23
4297,0,0,5,13,18
4298,0,0,9,12,21
4299,0,0,7,23,30
4300,0,0,1,20,21
4301,0,0,6,12,18
4302,0,0,8,9,17
4303,0,1,3,16,20
4304,0,1,10,9,20
4305,0,0,10,27,37
4306,0,0,4,16,20
4307,0,2,7,21,30
4308,0,0,3,10,13
4309,0,1,7,32,40
4310,0,0,5,9,14
4311,0,0,3,10,13
4312,0,0,1,5,6
4313,0,0,6,20,26
4314,0,0,7,21,28
4315,0,1,4,12,17
4316,0,0,10,10,20
4317,0,0,10,11,21
4318,0,1,12,17,30
4319,1,0,8,18,27
4320,0,0,7,3,10
4321,0,0,2,9,11
4323,0,0,14,14,28
4324,0,0,1,20,21
4325,0,0,8,8,16
4326,0,0,10,16,26
4327,0,1,7,14,22
4328,0,0,5,11,16
4329,0,2,4,17,23
4330,0,0,0,17,17
4331,0,0,8,13,21
4332,0,0,5,8,13
4333,0,1,6,21,28
4334,0,0,12,17,29
4335,0,1,1,23,25
4336,0,1,7,18,26
4338,1,0,4,12,17
4339,2,0,1,12,15
4340,0,1,2,19,22
4341,1,1,10,32,44
4342,0,1,11,20,32
4343,0,1,6,21,28
4344,0,0,17,33,50
4345,0,0,2,6,8
4347,0,2,4,17,23
4348,0,1,1,10,12
4349,0,0,11,13,24
4350,1,0,3,10,14
4351,0,0,8,24,32
4352,0,0,9,6,15
4353,0,0,7,14,21
4354,0,0,8,13,21
4355,0,1,1,23,25
4356,0,0,1,3,4
4357,0,0,5,8,13
4359,0,0,8,8,16
4360,0,0,3,8,11
4361,0,0,14,14,28
4362,0,0,2,9,11
4363,0,0,0,1,1
4364,0,0,10,16,26
4366,0,0,9,22,31
4367,0,0,8,17,25
4368,0,1,6,36,43
4369,0,0,10,16,26
4370,0,0,14,14,28
4371,0,0,2,6,8
4372,0,0,1,4,5
4373,0,0,7,20,27
4374,0,0,1,10,11
4375,0,0,2,10,12
4376,0,0,11,36,47
4377,0,0,6,10,16
4378,0,0,7,23,30
4379,1,0,1,16,18
4380,1,0,2,19,22
4381,0,0,9,7,16
4382,0,0,3,2,5
4383,0,0,12,16,28
4384,0,0,8,8,16
4385,0,1,4,26,31
4386,0,0,2,4,6
4387,0,0,2,14,16
4388,0,0,5,9,14
4389,0,0,6,3,9
4390,0,0,4,14,18
4391,0,1,14,33,48
4392,0,0,5,24,29
4393,2,0,6,12,20
4394,0,0,3,11,14
4395,0,0,2,1,3
4396,0,0,0,8,8
4397,0,0,12,22,34
4398,0,0,12,10,22
4399,0,1,18,19,38
4400,0,0,10,17,27
4401,0,0,5,18,23
4402,0,0,4,20,24
4403,0,0,6,9,15
4404,0,0,9,14,23
4405,0,0,10,12,22
4406,0,1,3,22,26
4407,0,0,3,12,15
4408,0,0,15,19,34
4409,0,0,12,29,41
4410,0,0,5,23,28
4411,0,0,5,12,17
4412,0,2,21,23,46
4413,0,0,1,9,10
4414,0,0,7,8,15
4415,0,0,3,15,18
4416,0,0,1,19,20
4417,0,0,9,10,19
4418,0,0,11,27,38
4419,0,0,7,10,17
4420,0,0,10,26,36
4422,0,0,6,18,24
4423,0,1,9,27,37
4424,1,0,3,4,8
4425,0,0,0,5,5
4426,0,0,2,6,8
4427,0,0,9,8,17
4428,0,0,9,28,37
4429,0,0,7,11,18
4430,0,0,5,8,13
4431,0,1,5,9,15
4432,0,0,6,19,25
4433,0,0,6,9,15
4434,0,0,5,10,15
4435,0,0,4,4,8
4436,0,0,3,10,13
4437,0,1,9,30,40
4438,1,1,3,38,43
4439,0,0,16,30,46
4440,0,1,2,12,15
4441,1,0,7,18,26
4442,0,0,9,19,28
4443,0,0,8,20,28
4444,0,0,12,37,49
4445,0,0,14,16,30
4446,0,0,0,2,2
4447,0,0,0,6,6
4448,0,0,10,13,23
4449,0,0,7,17,24
4450,0,0,0,8,8
4451,0,1,5,10,16
4452,0,0,16,24,40
4453,0,0,2,10,12
4454,0,0,9,21,30
4455,0,0,9,16,25
4456,1,0,7,7,15
4457,0,0,10,25,35
4458,0,1,2,16,19
4459,0,0,5,16,21
4460,0,1,15,23,39
4461,0,0,5,7,12
4463,0,0,1,8,9
4465,0,1,3,16,20
4466,0,0,2,6,8
4467,0,0,11,17,28
4468,0,0,6,13,19
4469,0,0,10,12,22
4470,0,1,7,10,18
4471,0,0,4,1,5
4472,0,0,14,12,26
4473,0,1,12,17,30
4474,1,0,2,4,7
4475,0,0,6,10,16
4476,0,0,12,14,26
4477,0,0,5,18,23
4478,0,0,0,8,8
4480,0,0,4,6,10
4481,0,0,6,12,18
4482,1,1,1,10,13
4483,0,0,10,10,20
4485,0,0,3,7,10
4486,0,0,3,7,10
4487,0,0,5,5,10
4488,0,0,1,10,11
4489,0,0,1,4,5
4490,0,0,6,12,18
4491,0,0,7,8,15
4492,0,0,9,17,26
4493,0,0,1,17,18
4494,0,0,12,31,43
4496,0,1,0,4,5
4498,0,0,5,16,21
4499,0,0,2,7,9
4500,0,0,3,5,8
4501,0,2,10,31,43
4502,0,0,1,5,6
4504,0,0,2,14,16
4505,1,1,7,16,25
4506,0,0,14,31,45
4507,0,0,0,11,11
4508,1,0,5,6,12
4509,0,2,13,10,25
4511,0,0,9,17,26
4512,0,0,7,6,13
4513,1,1,11,25,38
4514,0,1,3,14,18
4515,0,0,3,12,15
4516,0,0,10,22,32
4517,1,0,14,24,39
4518,0,0,6,14,20
4520,1,1,8,27,37
4521,0,0,4,10,14
4522,0,0,1,19,20
4523,2,0,6,12,20
4524,0,0,13,25,38
4525,0,1,17,32,50
4526,0,0,4,14,18
4528,0,0,12,31,43
4529,0,0,3,8,11
4530,0,0,10,10,20
4531,0,1,6,24,31
4532,0,0,5,13,18
4533,0,0,5,18,23
4534,0,0,5,20,25
4535,1,0,12,37,50
4536,0,0,5,34,39
4537,0,0,9,31,40
4538,0,0,5,13,18
4539,0,0,0,1,1
4540,0,2,16,29,47
4541,0,0,9,12,21
4542,0,0,3,9,12
4543,0,0,10,40,50
4544,0,0,5,17,22
4545,0,0,4,13,17
4546,0,0,1,30,31
4547,0,0,6,21,27
4548,0,0,4,10,14
4549,0,0,11,24,35
4550,0,2,10,27,39
4551,1,0,6,12,19
4552,0,0,3,20,23
4553,0,1,13,31,45
4554,0,1,3,14,18
4555,0,1,10,34,45
4556,1,0,2,7,10
4557,0,0,11,14,25
4558,0,0,12,30,42
4559,0,0,5,7,12
4560,0,0,6,16,22
4561,0,0,13,14,27
4562,0,0,1,11,12
4563,0,0,4,21,25
4564,0,0,12,28,40
4565,0,0,13,27,40
4566,1,2,8,6,17
4567,0,0,5,9,14
4568,0,0,19,31,50
4569,0,0,6,15,21
4570,0,0,2,4,6
4571,0,0,12,19,31
4574,0,0,0,19,19
4575,0,2,14,34,50
4576,0,0,4,15,19
4577,0,0,4,13,17
4578,0,0,9,10,19
4579,0,0,16,30,46
4581,0,0,0,3,3
4583,0,0,12,10,22
4584,0,2,10,31,43
4585,0,1,4,26,31
4586,0,0,0,2,2
4587,0,0,0,6,6
4588,0,0,14,31,45
4589,0,0,3,12,15
4591,0,0,12,14,26
4592,0,0,12,28,40
4593,0,1,3,16,20
4594,0,0,16,24,40
4595,0,1,4,30,35
4596,1,0,4,15,20
4597,0,0,5,19,24
4598,0,0,0,11,11
4599,0,1,1,10,12
4600,0,0,4,20,24
4601,0,0,5,13,18
4602,0,0,0,19,19
4603,0,0,12,28,40
4604,0,0,2,14,16
4605,1,0,4,8,13
4606,0,0,3,20,23
4607,0,0,0,6,6
4608,0,0,5,14,19
4609,0,0,3,9,12
4611,0,0,12,31,43
4612,1,1,7,16,25
4613,0,0,8,17,25
4614,0,0,6,15,21
4615,1,0,5,34,40
4616,0,4,18,28,50
4617,0,3,2,14,19
4618,0,3,11,36,50
4619,0,0,11,14,25
4620,1,0,2,27,30
4621,0,0,12,38,50
4622,0,0,3,18,21
4623,0,0,0,8,8
4624,0,1,2,11,14
4625,0,0,15,24,39
4626,0,0,5,12,17
4627,0,2,12,23,37
4628,0,0,6,16,22
4629,0,0,4,9,13
4630,0,0,2,12,14
4632,0,0,1,3,4
4633,0,0,0,2,2
4634,0,3,4,10,17
4635,0,0,1,4,5
4636,0,0,2,9,11
4637,0,5,8,30,43
4638,1,1,15,30,47
4639,0,1,0,4,5
4640,0,4,18,28,50
4641,1,1,9,24,35
4642,2,14,4,30,50
4643,0,0,0,2,2
4644,0,1,6,7,14
4645,0,0,13,18,31
4646,1,0,2,27,30
4647,0,0,3,18,21
4648,0,0,1,4,5
4649,0,5,8,30,43
4650,0,3,4,19,26
4651,0,0,8,17,25
4652,0,1,2,11,14
4653,0,0,1,4,5
4654,0,3,4,19,26
4655,0,0,9,15,24
4656,0,0,15,24,39
4657,0,0,8,17,25
4658,1,1,15,30,47
4659,0,0,4,10,14
4660,0,1,11,18,30
4661,0,0,8,13,21
4662,0,0,4,10,14
4663,0,0,1,6,7
4664,0,0,5,6,11
4665,0,0,6,4,10
4666,0,0,4,8,12
4667,0,0,3,5,8
4668,0,0,1,2,3
4669,0,0,10,19,29
4670,0,0,1,8,9
4671,0,0,10,12,22
4672,0,0,3,5,8
4673,0,0,6,25,31
4674,0,0,2,9,11
4675,2,1,8,28,39
4676,0,0,5,14,19
4677,0,0,1,4,5
4678,0,0,7,5,12
4679,0,0,6,0,6
4680,0,0,8,22,30
4681,0,0,7,14,21
4682,1,1,9,21,32
4683,0,0,8,20,28
4684,0,0,5,8,13
4685,0,0,1,0,1
4686,0,1,3,5,9
4687,0,1,3,18,22
4688,0,0,5,9,14
4689,0,0,2,12,14
4690,0,1,9,10,20
4691,0,0,2,17,19
4692,0,0,7,23,30
4693,0,0,5,12,17
4694,0,0,2,13,15
4695,0,0,5,6,11
4696,0,0,5,5,10
4697,0,2,4,15,21
4698,0,0,5,3,8
4699,0,1,3,16,20
4700,0,0,7,9,16
4701,0,0,3,8,11
4702,0,1,5,13,19
4703,0,0,2,6,8
4704,0,0,8,15,23
4705,0,0,8,14,22
4706,0,4,2,19,25
4707,0,0,3,12,15
4708,0,4,4,14,22
4709,0,0,15,24,39
4710,0,0,2,5,7
4711,0,1,3,8,12
4712,0,0,0,8,8
4713,0,1,5,12,18
4714,0,1,11,30,42
4715,0,0,5,7,12
4716,0,0,4,7,11
4717,0,0,9,39,48
4718,0,0,16,29,45
4719,0,0,6,15,21
4720,0,1,8,15,24
4721,0,0,1,10,11
4722,0,2,5,10,17
4723,0,1,7,28,36
4724,0,0,3,6,9
4725,0,1,11,25,37
4726,0,1,10,18,29
4727,0,0,5,10,15
4728,0,0,6,15,21
4729,0,0,7,3,10
4730,0,1,0,6,7
4731,0,1,4,8,13
4732,0,0,7,4,11
4733,0,0,4,18,22
4734,2,1,9,16,28
4735,0,0,6,12,18
4736,0,0,1,2,3
4737,0,0,7,16,23
4738,0,0,1,4,5
4739,0,0,8,21,29
4740,0,0,2,6,8
4741,0,4,6,19,29
4742,2,6,7,35,50
4743,2,0,2,20,24
4744,0,1,14,21,36
4745,0,0,6,11,17
4746,0,0,5,16,21
4747,0,0,1,7,8
4748,0,0,5,9,14
4749,2,0,5,33,40
4750,0,1,2,6,9
4751,0,1,8,22,31
4752,0,0,5,6,11
4753,0,0,13,29,42
4754,1,1,3,11,16
4755,2,0,3,27,32
4756,0,0,1,5,6
4757,0,0,8,6,14
4758,0,0,4,4,8
4759,0,0,6,11,17
4760,0,1,8,16,25
4761,0,0,3,11,14
4762,0,0,10,18,28
4763,0,0,1,4,5
4764,0,0,1,4,5
4765,0,0,1,2,3
4766,0,0,3,8,11
4767,0,0,5,1,6
4768,0,0,5,10,15
4769,1,0,1,3,5
4770,0,2,10,10,22
4772,0,7,6,37,50
4773,0,0,3,0,3
4774,0,0,0,5,5
4775,0,0,7,11,18
4776,0,0,8,18,26
4777,0,1,4,13,18
4778,0,0,7,5,12
4779,0,0,2,3,5
4781,0,0,0,6,6
4782,0,0,3,0,3
4783,0,0,4,4,8
4786,0,0,3,9,12
4787,0,0,0,11,11
4790,0,0,3,12,15
4792,1,0,13,28,42
4793,0,5,5,17,27
4794,0,0,4,4,8
4795,0,0,0,5,5
4796,0,0,4,28,32
4797,0,0,7,9,16
4798,0,0,9,12,21
4799,0,0,2,10,12
4800,0,0,1,4,5
4802,0,0,5,6,11
4803,0,0,2,5,7
4804,0,0,0,2,2
4805,0,0,0,5,5
4806,0,0,3,14,17
4807,0,1,5,8,14
4810,0,2,5,19,26
4811,0,0,1,15,16
4812,0,0,2,7,9
4813,0,2,2,11,15
4814,1,0,0,4,5
4815,2,2,5,30,39
4816,1,2,17,23,43
4817,0,0,4,8,12
4819,1,0,7,22,30
4820,1,2,6,29,38
4821,0,3,8,6,17
4822,0,0,3,1,4
4823,0,0,16,32,48
4824,0,1,11,18,30
4825,0,0,16,34,50
4826,0,0,11,21,32
4827,0,0,11,16,27
4828,2,0,1,26,29
4829,4,2,4,34,44
4830,2,1,5,13,21
4831,1,0,1,8,10
4832,0,0,1,4,5
4833,0,1,7,9,17
4834,0,0,10,26,36
4835,0,0,3,24,27
4836,4,0,2,25,31
4837,0,0,2,4,6
4838,0,1,5,7,13
4839,0,1,4,3,8
4840,0,1,8,19,28
4841,0,0,2,9,11
4842,0,1,11,22,34
4844,3,2,1,9,15
4845,0,0,4,10,14
4846,0,0,7,13,20
4847,0,0,3,17,20
4848,0,0,13,36,49
4849,0,0,8,16,24
4850,0,0,5,3,8
4851,0,0,6,38,44
4852,2,2,5,30,39
4853,0,0,5,5,10
4854,0,0,1,5,6
4855,1,2,8,38,49
4856,0,0,7,8,15
4857,1,1,2,6,10
4858,0,0,20,27,47
4859,0,1,9,21,31
4860,0,0,1,7,8
4861,0,1,7,28,36
4862,0,0,8,20,28
4863,0,0,10,5,15
4864,0,0,4,5,9
4865,0,0,2,5,7
4867,1,0,11,24,36
4868,0,0,11,22,33
4869,3,4,4,29,40
4870,0,1,4,23,28
4871,0,1,13,18,32
4872,1,1,1,22,25
4873,2,0,6,12,20
4874,2,0,13,28,43
4875,1,6,2,27,36
4876,0,0,2,6,8
4877,1,0,15,31,47
4878,2,14,4,30,50
4879,0,2,5,19,26
4880,0,2,4,15,21
4881,0,1,14,35,50
4882,0,0,2,5,7
4883,0,0,2,13,15
4884,0,1,9,10,20
4885,1,0,7,22,30
4886,0,0,7,6,13
4887,0,0,16,34,50
4888,0,1,4,3,8
4889,2,0,2,20,24
4890,0,0,2,4,6
4891,0,0,4,18,22
4892,0,0,4,46,50
4893,0,0,2,4,6
4894,1,1,5,34,41
4895,0,0,2,23,25
4896,0,0,1,4,5
4897,0,0,3,24,27
4898,0,7,6,37,50
4899,0,0,11,39,50
4900,0,0,8,6,14
4902,1,1,1,7,10
4903,0,0,4,17,21
4904,0,0,5,21,26
4905,1,2,8,38,49
4906,0,0,4,46,50
4907,3,2,1,9,15
4908,0,7,6,37,50
4909,2,1,9,16,28
4910,2,1,3,16,22
4911,0,0,5,5,10
4912,0,0,2,4,6
4913,0,0,2,6,8
4914,0,0,20,27,47
4915,0,0,3,24,27
4916,2,0,0,8,10
4917,0,0,4,46,50
4918,2,0,6,12,20
4919,1,0,15,31,47
4920,0,0,16,32,48
4921,1,0,1,3,5
4922,0,3,8,6,17
4923,0,2,12,32,46
4924,0,0,16,34,50
4925,0,0,10,26,36
4926,1,1,1,7,10
4927,0,0,10,26,36
4928,0,1,1,9,11
4929,1,1,1,7,10
4930,1,1,8,40,50
4931,0,1,7,9,17
4932,0,0,6,13,19
4933,0,3,3,4,10
4935,0,2,12,32,46
4936,0,0,20,27,47
4937,0,0,13,36,49
4938,0,0,1,15,16
4939,0,0,3,1,4
4940,4,0,2,25,31
4941,0,0,2,6,8
4942,0,0,6,6,12
4943,2,0,5,8,15
4944,1,0,4,31,36
4945,0,0,11,16,27
4946,0,2,5,19,26
4947,2,0,1,15,18
4948,1,0,7,22,30
4949,2,1,5,13,21
4950,0,0,4,8,12
4951,4,2,4,34,44
4952,0,0,2,4,6
4953,0,0,2,23,25
4954,0,0,15,24,39
4955,2,0,1,26,29
4956,1,2,6,29,38
4957,0,0,11,21,32
4958,0,0,16,32,48
4959,1,1,5,34,41
4960,0,0,2,4,6
4961,0,0,16,34,50
4962,0,1,19,27,47
4963,0,0,11,39,50
4964,0,0,16,34,50
4965,1,0,1,8,10
4966,0,1,5,7,13
4967,0,0,7,6,13
4968,0,1,11,22,34
4969,0,0,5,5,10
4970,0,0,10,26,36
4971,1,0,1,3,5
4972,0,0,6,16,22
4973,0,1,8,14,23
4974,1,0,1,3,5
4975,0,0,2,4,6
4976,0,0,4,10,14
4977,0,1,11,18,30
4978,2,0,0,15,17
4979,0,0,3,6,9
4980,0,0,8,25,33
4981,0,0,1,4,5
4982,0,1,4,7,12
4983,0,0,10,19,29
4984,0,0,8,22,30
4985,0,1,8,14,23
4986,0,0,12,38,50
4987,0,0,8,20,28
4988,0,0,2,9,11
4989,0,0,11,37,48
4990,0,3,8,38,49
4991,0,0,11,22,33
4992,0,1,6,8,15
4994,0,1,10,10,21
4995,0,0,10,6,16
4996,0,0,7,8,15
4997,2,2,5,30,39
4998,0,1,8,14,23
4999,0,0,8,17,25
5000,0,0,4,7,11
5001,0,0,4,20,24
5002,0,0,8,12,20
5003,0,0,0,7,7
5004,3,0,13,34,50
5005,0,0,7,16,23
5006,0,2,2,1,5
5007,0,0,3,16,19
5008,0,0,1,11,12
5009,0,0,2,8,10
5010,0,0,7,15,22
5011,0,0,1,4,5
5012,0,0,7,13,20
5013,0,0,5,11,16
5014,0,5,0,11,16
5015,0,0,8,17,25
5016,1,0,7,22,30
5017,0,1,9,14,24
5018,0,0,8,22,30
5019,0,3,5,34,42
5020,0,0,6,16,22
5021,0,0,8,18,26
5022,0,2,4,19,25
5023,0,0,4,19,23
5024,0,0,8,16,24
5025,0,1,3,8,12
5026,0,4,18,28,50
5027,1,1,9,17,28
5028,0,1,4,9,14
5029,0,0,5,6,11
5030,0,0,15,35,50
5031,0,0,10,7,17
5032,0,1,4,19,24
5033,0,1,7,23,31
5034,0,0,2,3,5
5035,0,0,5,15,20
5036,0,0,8,12,20
5037,0,0,5,15,20
5038,1,0,1,7,9
5039,0,0,4,13,17
5040,0,0,4,8,12
5041,0,0,11,16,27
5042,0,1,0,22,23
5043,0,0,5,5,10
5044,0,0,2,6,8
5045,0,0,0,22,22
5046,1,0,5,34,40
5047,0,0,3,3,6
5048,0,0,8,15,23
5049,0,0,4,16,20
5050,0,0,1,6,7
5051,0,0,4,9,13
5052,2,0,1,26,29
5053,0,0,0,5,5
5054,0,0,6,18,24
5055,1,0,2,19,22
5056,0,1,14,24,39
5057,0,0,8,14,22
5058,0,3,8,6,17
5059,0,0,4,11,15
5060,0,0,5,6,11
5061,0,1,8,14,23
5062,0,1,3,3,7
5063,0,1,7,14,22
5064,0,0,10,19,29
5065,0,0,5,7,12
5066,0,0,2,7,9
5067,0,0,4,1,5
5068,0,0,2,10,12
5069,0,0,11,14,25
5070,1,2,6,29,38
5071,0,0,11,33,44
5072,0,0,0,9,9
5073,0,0,4,4,8
5074,0,1,5,14,20
5075,2,1,9,38,50
5076,1,1,8,36,46
5077,0,0,6,8,14
5078,0,0,7,24,31
5079,0,0,10,26,36
5080,0,1,20,29,50
5081,0,0,4,13,17
5082,0,0,11,18,29
5083,0,1,5,13,19
5084,1,0,3,21,25
5085,0,0,7,12,19
5086,0,3,2,11,16
5087,0,1,7,13,21
5088,0,0,4,1,5
5089,0,0,1,6,7
5090,0,0,5,9,14
5091,1,0,5,23,29
5092,0,1,11,37,49
5093,0,1,2,25,28
5094,0,0,6,16,22
5095,0,0,1,4,5
5096,0,0,6,7,13
5097,0,0,5,13,18
5098,0,0,5,11,16
5099,0,0,11,34,45
5100,0,1,6,10,17
5101,0,2,10,20,32
5102,0,0,9,11,20
5103,0,1,9,13,23
5104,0,0,6,10,16
5105,0,0,3,10,13
5106,0,0,11,17,28
5107,0,1,11,18,30
5108,0,1,6,13,20
5109,0,0,10,26,36
5110,1,1,3,11,16
5111,0,0,7,5,12
5112,0,0,1,6,7
5114,0,0,8,19,27
5115,0,0,3,13,16
5116,0,4,0,34,38
5117,0,0,8,20,28
5118,0,0,4,13,17
5119,0,0,6,9,15
5120,0,0,8,20,28
5121,0,0,2,19,21
5122,0,0,4,9,13
5123,0,0,1,19,20
5124,0,1,9,25,35
5125,0,0,2,14,16
5126,0,1,1,8,10
5127,0,0,5,4,9
5128,0,0,7,8,15
5129,1,0,7,12,20
5130,0,0,4,4,8
5131,0,1,11,14,26
5132,0,0,3,17,20
5133,0,0,9,18,27
5134,0,0,6,39,45
5135,0,0,3,9,12
5136,0,0,2,4,6
5137,0,0,6,13,19
5138,0,0,7,22,29
5139,0,0,4,20,24
5140,0,0,0,5,5
5141,0,0,3,2,5
5142,0,0,4,8,12
5143,0,0,11,9,20
5144,0,1,4,20,25
5145,0,1,6,14,21
5146,0,1,3,14,18
5147,0,0,2,6,8
5148,0,1,7,8,16
5149,0,0,7,14,21
5150,0,0,3,4,7
5151,0,0,4,18,22
5152,0,0,6,9,15
5153,0,0,2,10,12
5154,0,0,4,13,17
5155,0,1,0,4,5
5156,0,1,5,7,13
5157,0,3,0,10,13
5158,0,0,4,3,7
5159,0,0,16,21,37
5161,0,0,9,18,27
5162,0,1,9,12,22
5163,0,0,1,4,5
5164,0,1,8,12,21
5165,0,0,4,12,16
5166,0,0,2,3,5
5167,0,0,4,3,7
5168,1,1,1,28,31
5169,0,1,12,32,45
5170,1,0,9,30,40
5171,0,0,3,3,6
5173,0,3,4,10,17
5174,0,0,9,12,21
5175,0,0,6,11,17
5176,0,0,6,14,20
5177,0,1,3,8,12
5178,0,1,4,3,8
5179,0,0,8,25,33
5180,0,0,5,20,25
5181,0,0,1,9,10
5184,0,0,5,10,15
5185,1,0,2,12,15
5186,0,2,8,19,29
5187,2,6,7,35,50
5188,0,0,3,12,15
5189,1,0,5,23,29
5190,0,0,8,21,29
5191,0,0,5,12,17
5192,0,0,8,11,19
5193,0,0,2,9,11
5194,0,0,5,7,12
5195,0,0,1,5,6
5196,2,0,2,20,24
5197,0,0,9,11,20
5198,0,0,5,7,12
5199,0,1,9,20,30
5200,0,0,2,3,5
5201,0,1,6,16,23
5202,0,1,6,4,11
5203,0,0,5,14,19
5204,0,1,5,6,12
5205,0,1,2,11,14
5206,0,0,1,3,4
5207,0,0,5,12,17
5208,0,0,7,20,27
5209,0,0,2,12,14
5210,0,0,9,26,35
5211,0,0,9,15,24
5212,0,0,8,9,17
5213,0,0,3,19,22
5214,0,0,2,3,5
5215,0,0,9,5,14
5216,0,0,2,6,8
5217,0,0,7,10,17
5218,0,0,6,2,8
5219,0,0,5,12,17
5220,0,0,3,9,12
5221,0,0,12,31,43
5222,0,0,4,15,19
5223,0,0,10,29,39
5224,0,1,16,27,44
5225,0,1,4,13,18
5226,0,0,0,6,6
5227,0,0,6,7,13
5228,0,0,3,3,6
5229,0,1,3,35,39
5230,0,1,6,14,21
5231,0,0,4,4,8
5232,0,4,2,14,20
5233,0,0,3,6,9
5234,1,2,0,8,11
5235,0,0,3,3,6
5236,0,0,3,13,16
5237,0,1,5,16,22
5238,0,2,2,17,21
5239,0,0,3,2,5
5240,1,1,3,12,17
5241,0,0,1,5,6
5243,0,0,1,5,6
5244,0,0,9,14,23
5245,0,1,6,15,22
5246,0,0,5,2,7
5247,0,0,8,17,25
5248,0,0,4,3,7
5249,0,0,4,11,15
5250,1,0,1,3,5
5251,0,0,3,3,6
5252,0,0,1,19,20
5253,0,0,3,1,4
5254,0,1,2,10,13
5255,0,0,5,9,14
5256,0,0,4,11,15
5257,0,0,8,14,22
5258,0,0,2,8,10
5259,0,0,12,30,42
5260,0,0,5,2,7
5261,0,1,0,8,9
5262,0,0,2,11,13
5263,0,1,7,16,24
5264,0,3,5,28,36
5266,0,2,12,23,37
5267,0,0,15,18,33
5268,0,0,3,2,5
5269,0,0,4,10,14
5270,0,2,7,10,19
5271,0,0,1,6,7
5272,0,1,3,10,14
5273,0,0,13,24,37
5274,0,0,3,7,10
5275,0,0,5,8,13
5276,0,0,2,5,7
5277,0,2,10,25,37
5278,0,0,4,4,8
5279,0,0,4,6,10
5280,1,2,1,13,17
5282,0,0,1,11,12
5283,0,1,9,15,25
5284,1,0,2,20,23
5285,0,0,4,6,10
5286,0,0,6,17,23
5287,0,0,1,13,14
5288,0,0,3,9,12
5289,0,2,6,9,17
5291,0,0,3,3,6
5292,0,0,7,7,14
5293,0,0,3,4,7
5295,0,0,2,4,6
5296,0,1,4,17,22
5297,0,0,1,2,3
5298,0,2,3,21,26
5299,1,0,1,5,7
5300,0,0,3,12,15
5301,0,0,2,8,10
5302,0,0,2,3,5
5303,0,1,7,21,29
5304,0,0,14,21,35
5306,0,2,2,13,17
5308,1,0,0,18,19
5309,0,0,0,11,11
5310,0,0,6,13,19
5311,0,0,7,3,10
5312,0,1,1,5,7
5314,0,1,5,13,19
5315,0,0,0,1,1
5317,0,0,11,38,49
5318,0,0,1,6,7
5320,0,0,0,8,8
5321,0,0,3,0,3
5322,0,0,0,10,10
5323,0,1,0,4,5
5324,0,2,0,8,10
5325,0,1,8,25,34
5326,0,1,9,10,20
5327,0,0,3,8,11
5328,0,0,8,25,33
5329,0,0,12,28,40
5330,0,0,3,6,9
5331,0,0,13,34,47
5332,4,0,2,25,31
5333,0,0,5,13,18
5334,0,2,3,4,9
5335,0,0,6,12,18
5336,1,1,10,18,30
5337,0,0,10,18,28
5338,0,0,2,3,5
5339,0,0,2,4,6
5340,1,0,4,32,37
5341,0,1,6,12,19
5342,0,0,10,26,36
5343,0,1,4,23,28
5344,0,0,5,11,16
5345,0,0,4,4,8
5346,0,0,9,22,31
5347,1,0,0,11,12
5348,0,0,3,5,8
5349,0,7,6,37,50
5350,2,0,4,19,25
5351,0,1,7,9,17
5352,1,0,7,12,20
5353,0,0,2,9,11
5354,0,0,1,9,10
5355,0,0,2,3,5
5356,0,0,11,35,46
5357,1,0,17,20,38
5358,0,1,16,28,45
5359,0,0,8,39,47
5360,1,0,8,35,44
5361,0,1,9,13,23
5362,3,0,10,37,50
5363,0,0,8,16,24
5364,0,0,7,18,25
5365,1,1,10,35,47
5366,0,0,7,23,30
5367,0,0,6,16,22
5368,0,0,14,25,39
5369,0,0,11,38,49
5370,1,1,3,23,28
5371,0,2,7,16,25
5372,0,0,9,24,33
5373,0,1,12,25,38
5374,0,0,3,6,9
5375,0,0,8,8,16
5376,0,0,4,9,13
5377,0,0,5,10,15
5378,0,0,10,22,32
5379,0,0,10,12,22
5380,0,0,16,34,50
5381,0,0,5,15,20
5382,0,0,7,19,26
5383,0,0,13,34,47
5384,0,0,3,2,5
5385,0,1,2,17,20
5386,0,1,13,36,50
5387,0,0,7,10,17
5388,1,0,7,16,24
5389,0,0,15,32,47
5390,0,1,9,18,28
5391,0,1,9,10,20
5392,0,0,10,21,31
5393,0,0,8,28,36
5394,0,2,11,12,25
5395,0,0,2,5,7
5396,0,3,5,13,21
5397,0,0,7,13,20
5398,0,0,5,14,19
5399,0,1,8,16,25
5400,0,1,6,31,38
5401,2,0,8,16,26
5402,1,0,3,9,13
5403,0,0,3,5,8
5404,0,0,2,6,8
5405,0,0,2,2,4
5406,0,0,6,18,24
5407,0,0,10,13,23
5408,0,0,12,27,39
5409,0,8,10,31,49
5410,1,0,0,7,8
5411,0,1,5,24,30
5412,0,2,7,15,24
5413,0,0,5,13,18
5414,0,0,3,2,5
5415,0,0,6,18,24
5416,0,0,1,6,7
5417,1,1,5,34,41
5418,0,2,8,34,44
5419,0,0,6,44,50
5420,0,1,0,17,18
5421,0,0,2,23,25
5422,0,0,9,20,29
5423,0,0,7,12,19
5425,0,0,11,18,29
5426,0,0,3,12,15
5428,0,2,1,13,16
5429,0,0,7,6,13
5430,0,1,8,18,27
5432,0,0,16,19,35
5433,0,0,15,27,42
5434,2,0,4,7,13
5435,2,0,0,6,8
5436,1,0,0,8,9
5437,0,0,4,13,17
5438,0,0,0,8,8
5439,0,1,3,14,18
5441,0,0,3,11,14
5442,0,0,3,10,13
5443,0,0,3,5,8
5444,0,0,5,12,17
5445,0,0,3,5,8
5446,0,0,6,6,12
5447,0,0,5,8,13
5448,0,0,8,31,39
5449,1,0,6,9,16
5450,0,0,1,4,5
5451,0,1,10,22,33
5452,2,0,4,19,25
5453,0,0,16,34,50
5454,1,0,9,22,32
5456,0,0,0,18,18
5457,0,1,2,7,10
5458,0,0,5,10,15
5459,0,0,11,11,22
5460,0,0,5,10,15
5461,0,1,15,32,48
5462,0,1,17,24,42
5463,0,1,2,6,9
5464,0,0,2,6,8
5465,0,2,1,16,19
5467,0,4,18,28,50
5468,0,1,8,14,23
5469,2,2,5,30,39
5470,0,0,8,17,25
5471,0,0,8,12,20
5472,0,0,8,22,30
5473,5,2,0,7,14
5474,0,0,0,5,5
5475,0,0,10,18,28
5476,5,2,6,35,48
5477,0,0,2,4,6
5478,0,1,5,14,20
5479,0,1,0,4,5
5480,1,0,7,12,20
5481,0,0,20,27,47
5482,0,1,8,25,34
5483,0,0,12,28,40
5484,1,0,1,7,9
5485,1,0,1,3,5
5486,0,0,9,34,43
5487,0,0,15,35,50
5488,2,0,2,20,24
5489,0,0,1,19,20
5490,0,1,4,23,28
5491,0,0,2,3,5
5492,1,0,0,11,12
5493,0,1,4,3,8
5494,0,0,6,12,18
5495,1,0,4,20,25
5496,0,0,1,9,10
5497,0,1,5,16,22
5498,1,0,1,3,5
5499,0,1,3,10,14
5501,0,0,4,4,8
5502,0,0,5,11,16
5504,0,7,6,37,50
5505,0,0,5,9,14
5506,1,0,0,2,3
5507,0,0,4,12,16
5508,0,0,14,33,47
5509,0,2,1,8,11
5510,0,0,6,22,28
5511,2,0,8,16,26
5512,0,0,0,9,9
5513,0,3,0,8,11
5514,5,2,6,35,48
5515,0,3,10,36,49
5516,0,0,1,9,10
5517,0,0,9,34,43
5518,1,2,4,37,44
5519,1,0,7,12,20
5520,0,7,6,37,50
5521,0,0,7,39,46
5523,0,0,22,28,50
5524,4,4,4,38,50
5525,1,1,9,30,41
5526,0,0,20,27,47
5527,0,0,4,12,16
5528,2,0,14,21,37
5529,0,0,12,38,50
5530,0,0,5,12,17
5531,0,0,2,6,8
5532,0,0,0,22,22
5533,1,2,4,37,44
5534,0,0,15,35,50
5535,1,1,10,18,30
5536,1,0,2,19,22
5537,0,0,1,19,20
5538,0,1,0,9,10
5539,0,1,12,32,45
5540,3,1,17,29,50
5541,0,0,2,3,5
5542,4,4,4,38,50
5543,0,0,22,28,50
5544,0,0,10,26,36
5545,0,1,6,12,19
5546,1,2,4,37,44
5547,0,3,8,6,17
5548,1,2,4,37,44
5549,0,0,9,22,31
5550,0,0,15,32,47
5551,0,1,7,9,17
5552,4,2,1,35,42
5553,1,1,8,40,50
5554,1,1,3,23,28
5555,0,0,2,3,5
5556,0,0,10,26,36
5557,0,1,2,25,28
5558,0,0,22,28,50
5559,0,0,5,12,17
5560,0,0,11,16,27
5561,0,1,19,27,47
5562,0,0,2,6,8
5563,0,0,20,27,47
5564,1,2,6,29,38
5565,4,0,2,25,31
5566,2,0,1,26,29
5567,1,0,0,2,3
5569,0,0,10,26,36
5570,4,2,1,35,42
5571,0,0,2,4,6
5572,1,1,5,34,41
5573,0,0,2,23,25
5574,0,0,7,6,13
5575,0,1,5,7,13
5576,0,2,3,4,9
5577,0,0,9,22,31
5578,1,0,7,12,20
5579,0,0,1,6,7
5580,0,0,5,6,11
5581,0,0,8,18,26
5582,0,0,2,5,7
5583,0,1,11,18,30
5584,0,0,1,5,6
5585,1,0,5,9,15
5586,0,0,7,8,15
5587,0,0,1,7,8
5588,0,0,7,10,17
5589,0,0,13,24,37
5590,0,0,6,12,18
5591,0,0,4,8,12
5592,0,2,11,31,44
5593,0,3,8,38,49
5594,0,0,2,12,14
5595,1,0,5,7,13
5596,0,0,3,14,17
5597,0,0,3,10,13
5598,0,0,1,15,16
5599,0,3,14,33,50
5600,0,0,5,11,16
5601,0,0,4,16,20
5602,0,0,2,15,17
5603,0,0,12,19,31
5604,0,3,10,18,31
5605,0,0,3,23,26
5606,0,2,6,12,20
5607,0,1,19,21,41
5608,0,0,2,16,18
5609,0,0,26,24,50
5610,0,0,2,11,13
5611,0,2,9,17,28
5612,0,1,4,8,13
5613,0,0,5,3,8
5614,0,1,13,36,50
5615,0,0,11,15,26
5616,0,0,0,13,13
5617,0,0,4,8,12
5618,0,1,7,13,21
5619,0,1,5,9,15
5620,0,0,3,8,11
5621,0,0,5,3,8
5622,0,0,6,14,20
5623,2,1,9,33,45
5624,0,1,7,20,28
5625,0,0,9,21,30
5626,0,1,5,15,21
5627,0,0,12,13,25
5628,0,0,3,10,13
5629,0,0,4,2,6
5630,0,0,6,10,16
5631,0,0,3,10,13
5632,0,0,9,21,30
5633,0,0,2,3,5
5634,0,0,4,10,14
5635,0,1,1,6,8
5636,0,0,4,13,17
5637,0,0,2,5,7
5638,0,0,4,4,8
5639,0,0,9,23,32
5640,0,1,1,20,22
5641,0,0,13,16,29
5642,1,0,4,12,17
5643,0,0,8,12,20
5644,0,0,10,40,50
5645,0,5,2,11,18
5646,0,0,3,3,6
5647,0,0,9,14,23
5648,0,1,4,0,5
5649,0,0,6,11,17
5650,0,1,8,6,15
5651,2,1,4,22,29
5652,0,2,0,6,8
5653,0,0,3,4,7
5654,0,0,4,15,19
5655,0,0,7,16,23
5656,0,0,0,3,3
5657,0,0,5,13,18
5658,1,0,6,13,20
5659,0,0,4,1,5
5660,0,0,0,4,4
5661,0,0,2,7,9
5662,0,0,5,14,19
5663,0,0,11,11,22
5664,0,0,11,21,32
5665,0,0,17,24,41
5666,0,0,2,11,13
5667,0,0,0,3,3
5668,0,0,3,15,18
5669,0,0,5,14,19
5670,0,0,5,8,13
5671,0,0,5,26,31
5672,0,0,4,21,25
5673,0,1,4,9,14
5674,0,0,7,19,26
5675,1,3,1,37,42
5676,1,0,9,26,36
5677,0,1,5,19,25
5678,0,0,5,3,8
5679,0,0,2,11,13
5680,0,0,1,14,15
5681,0,2,1,6,9
5682,0,0,11,21,32
5683,0,1,11,18,30
5684,0,0,3,8,11
5685,0,1,2,10,13
5686,0,0,4,10,14
5687,0,1,2,14,17
5689,0,1,4,10,15
5690,1,2,9,36,48
5691,0,0,8,15,23
5692,0,1,8,25,34
5693,0,1,11,30,42
5694,0,1,0,7,8
5695,0,1,6,5,12
5696,0,0,3,8,11
5697,0,0,5,0,5
5698,0,0,5,2,7
5699,0,0,4,3,7
5700,0,1,5,22,28
5701,0,0,1,17,18
5702,1,0,8,24,33
5703,0,1,5,18,24
5704,0,0,3,8,11
5705,0,0,8,32,40
5706,0,1,4,17,22
5707,0,0,4,6,10
5708,0,0,0,2,2
5709,0,0,5,12,17
5710,0,0,3,20,23
5711,0,1,8,20,29
5712,0,0,3,4,7
5713,0,0,2,5,7
5714,2,1,5,42,50
5715,0,0,8,19,27
5716,0,0,4,5,9
5717,0,0,7,13,20
5718,0,1,7,15,23
5719,0,0,7,23,30
5720,0,0,3,2,5
5721,0,0,14,23,37
5722,0,0,9,20,29
5723,0,1,13,36,50
5724,0,0,3,2,5
5725,0,0,1,1,2
5726,0,0,6,21,27
5727,0,1,6,10,17
5728,0,0,6,1,7
5729,0,0,0,6,6
5730,0,0,0,2,2
5731,0,0,9,4,13
5732,0,0,7,5,12
5733,0,0,5,9,14
5734,0,1,4,18,23
5736,0,0,1,4,5
5737,0,0,13,27,40
5738,0,2,14,34,50
5739,0,0,0,4,4
5740,0,0,3,7,10
5741,1,0,11,12,24
5742,0,0,5,14,19
5743,0,1,9,27,37
5744,0,0,19,31,50
5745,0,2,3,4,9
5746,0,0,16,21,37
5747,0,1,8,15,24
5748,0,0,7,12,19
5749,0,0,4,11,15
5750,0,0,2,12,14
5751,0,0,14,26,40
5752,0,2,0,3,5
5753,0,0,4,7,11
5754,1,0,10,22,33
5755,0,0,0,5,5
5756,1,0,3,18,22
5758,0,1,1,12,14
5759,0,0,6,10,16
5760,0,2,2,10,14
5761,1,0,5,43,49
5762,0,0,3,7,10
5763,1,0,20,29,50
5764,0,0,1,9,10
5765,0,0,10,19,29
5766,0,0,4,3,7
5767,0,0,0,8,8
5768,0,1,7,9,17
5769,0,0,6,12,18
5770,0,0,6,10,16
5771,1,0,1,8,10
5772,0,0,6,5,11
5773,1,0,0,34,35
5774,0,0,11,2,13
5775,0,0,0,3,3
5776,0,0,4,2,6
5777,0,0,8,12,20
5778,0,0,6,10,16
5779,0,1,3,9,13
5780,0,0,0,5,5
5781,0,0,0,5,5
5782,0,0,4,3,7
5784,1,1,4,5,11
5786,0,1,4,15,20
5787,0,0,8,24,32
5788,0,0,0,1,1
5789,0,0,0,5,5
5790,0,1,6,12,19
5791,0,1,10,12,23
5792,0,0,0,5,5
5793,0,0,4,17,21
5794,1,0,3,16,20
5795,0,0,4,3,7
5797,0,0,8,18,26
5798,0,0,0,2,2
5800,0,0,4,7,11
5801,0,0,1,4,5
5802,0,0,6,14,20
5803,0,0,7,38,45
5804,0,0,2,8,10
5805,0,0,4,25,29
5806,0,0,2,6,8
5807,0,1,10,24,35
5808,0,0,1,5,6
5809,0,0,14,11,25
5810,0,0,0,17,17
5811,0,0,8,5,13
5812,1,0,4,8,13
5813,0,1,7,27,35
5814,0,0,1,6,7
5815,0,0,5,6,11
5816,0,0,1,6,7
5817,0,0,2,4,6
5819,0,0,5,25,30
5820,0,0,6,6,12
5821,0,0,5,10,15
5822,1,1,6,20,28
5823,0,1,2,5,8
5824,0,0,2,4,6
5825,0,1,8,17,26
5826,0,0,4,11,15
5827,0,0,0,7,7
5828,0,0,6,11,17
5831,0,0,1,2,3
5833,0,0,7,7,14
5835,1,0,9,38,48
5836,0,0,1,3,4
5837,1,0,0,12,13
5838,1,0,2,3,6
5839,0,1,1,19,21
5840,0,0,2,7,9
5841,0,2,5,19,26
5842,0,0,2,14,16
5843,1,2,8,13,24
5844,1,0,1,7,9
5845,0,1,9,10,20
5846,0,0,11,34,45
5847,0,2,4,15,21
5848,0,0,0,2,2
5849,1,2,2,10,15
5850,0,1,11,20,32
5851,0,1,3,21,25
5852,2,0,3,27,32
5853,0,0,1,4,5
5854,1,1,10,18,30
5855,1,0,4,32,37
5856,0,0,4,18,22
5857,0,1,11,12,24
5858,0,0,1,15,16
5859,6,2,6,28,42
5860,0,1,7,12,20
5861,0,0,12,21,33
5862,1,3,0,2,6
5863,0,0,5,11,16
5864,0,0,3,14,17
5865,0,0,1,5,6
5866,0,1,3,1,5
5867,0,0,0,6,6
5868,0,0,3,18,21
5869,0,1,5,29,35
5870,1,0,12,32,45
5871,0,0,11,26,37
5872,0,4,11,34,49
5873,0,0,13,24,37
5874,0,1,14,33,48
5875,0,1,14,35,50
5876,0,0,1,4,5
5877,1,1,15,30,47
5878,0,2,15,24,41
5879,0,0,6,21,27
5880,0,1,10,26,37
5881,0,1,14,35,50
5882,3,1,7,13,24
5883,2,0,11,37,50
5884,0,0,12,32,44
5885,0,1,5,9,15
5886,1,0,13,23,37
5888,0,0,13,26,39
5889,0,0,14,35,49
5890,0,0,4,9,13
5891,0,0,8,26,34
5892,0,1,10,31,42
5893,0,0,12,33,45
5894,0,1,12,31,44
5895,0,2,5,21,28
5896,1,2,7,19,29
5897,0,0,6,22,28
5898,0,1,7,19,27
5899,0,0,14,30,44
5900,0,0,7,19,26
5902,0,0,7,28,35
5903,0,0,10,39,49
5904,0,1,6,9,16
5905,0,0,2,7,9
5906,0,1,7,20,28
5907,0,0,2,4,6
5908,0,3,4,2,9
5909,0,0,10,20,30
5910,0,0,11,39,50
5911,0,0,5,26,31
5912,0,0,1,8,9
5913,0,2,6,19,27
5914,0,0,9,21,30
5915,1,0,3,9,13
5916,1,0,1,13,15
5917,0,1,8,12,21
5918,0,0,7,9,16
5919,0,2,9,39,50
5920,0,0,3,3,6
5921,0,0,22,27,49
5922,0,0,15,35,50
5923,0,2,4,15,21
5924,0,2,5,19,26
5925,0,0,9,21,30
5926,0,0,7,13,20
5927,0,1,0,0,1
5928,0,0,7,23,30
5929,2,0,9,39,50
5930,0,0,3,14,17
5931,0,0,16,34,50
5932,1,0,1,7,9
5933,0,0,14,21,35
5934,0,0,8,19,27
5935,0,0,2,5,7
5936,0,1,1,19,21
5937,0,2,9,9,20
5938,0,1,7,30,38
5939,0,3,10,37,50
5940,0,0,8,17,25
5941,0,4,4,21,29
5942,0,0,16,34,50
5943,0,0,14,36,50
5944,0,3,7,39,49
5945,0,0,4,14,18
5946,1,0,4,14,19
5947,0,0,11,32,43
5948,0,1,5,22,28
5949,0,0,6,25,31
5950,0,2,3,21,26
5951,1,3,12,34,50
5952,1,0,10,13,24
5953,0,1,4,23,28
5954,0,0,9,22,31
5955,0,0,7,5,12
5956,1,0,7,8,16
5957,0,0,7,13,20
5958,0,3,3,22,28
5959,1,0,9,19,29
5960,0,0,10,33,43
5961,0,0,17,33,50
5962,0,1,6,23,30
5963,0,0,18,14,32
5964,0,0,7,8,15
5965,0,0,7,12,19
5966,0,0,0,2,2
5967,0,1,4,12,17
5968,0,2,6,42,50
5969,0,0,2,7,9
5970,0,1,3,21,25
5971,1,0,6,15,22
5972,0,0,4,4,8
5974,0,0,7,29,36
5975,0,0,14,23,37
5976,0,0,6,17,23
5977,0,1,2,21,24
5978,0,0,8,8,16
5979,0,0,10,29,39
5980,0,2,6,7,15
5981,0,0,14,30,44
5982,0,0,6,27,33
5983,0,4,17,28,49
5984,0,0,6,24,30
5985,0,1,16,29,46
5986,2,0,1,10,13
5987,0,0,3,5,8
5988,0,0,13,30,43
5989,0,0,12,15,27
5990,0,0,5,9,14
5991,0,0,14,15,29
5992,0,0,3,13,16
5993,0,0,10,37,47
5994,0,0,6,4,10
5995,0,0,1,7,8
5996,0,0,1,12,13
5998,0,2,15,27,44
5999,0,1,3,7,11
6000,0,0,14,26,40
6001,0,0,15,34,49
6002,0,0,1,4,5
6003,0,1,9,19,29
6004,0,1,11,32,44
6005,0,1,11,11,23
6006,0,0,7,14,21
6007,0,0,13,15,28
6008,0,0,4,6,10
6009,0,0,2,2,4
6010,0,0,12,33,45
6011,0,0,5,14,19
6012,0,0,3,8,11
6013,0,0,12,21,33
6014,1,0,13,31,45
6015,0,0,5,11,16
6016,0,1,9,10,20
6017,0,0,4,1,5
6018,0,1,3,22,26
6019,0,1,11,12,24
6020,0,0,11,11,22
6021,0,0,1,14,15
6022,0,0,0,5,5
6023,0,1,8,25,34
6024,0,0,4,18,22
6025,0,0,1,4,5
6026,1,0,0,34,35
6029,0,0,0,5,5
6030,0,0,1,7,8
6031,0,0,11,39,50
6032,0,0,14,16,30
6033,2,1,8,39,50
6034,1,0,9,27,37
6035,0,1,5,29,35
6036,1,3,5,30,39
6037,0,0,1,4,5
6038,0,0,6,22,28
6039,0,0,12,26,38
6040,0,0,10,35,45
6041,0,0,3,35,38
6042,0,1,12,30,43
6043,0,1,0,14,15
6044,0,0,1,13,14
6045,0,0,7,13,20
6046,0,1,4,23,28
6047,2,0,7,19,28
6048,1,0,4,14,19
6049,1,0,5,44,50
6050,1,2,11,32,46
6051,2,0,5,26,33
6053,0,0,11,25,36
6054,0,2,7,37,46
6055,0,0,8,29,37
6056,0,0,1,5,6
6057,0,0,0,4,4
6058,0,0,12,15,27
6059,0,0,4,16,20
6060,0,0,5,5,10
6061,0,1,2,5,8
6062,0,0,6,25,31
6063,0,1,3,22,26
6064,0,0,6,4,10
6065,1,3,11,33,48
6066,1,0,3,16,20
6067,0,1,1,18,20
6068,1,0,8,9,18
6069,1,1,10,18,30
6070,0,0,9,13,22
6071,0,0,7,15,22
6072,1,0,5,44,50
6073,1,0,9,27,37
6074,4,1,5,30,40
6075,0,0,3,10,13
6076,0,1,0,0,1
6077,1,0,0,34,35
6078,1,2,2,10,15
6079,0,0,1,14,15
6080,1,0,0,34,35
6081,0,0,12,25,37
6082,0,0,7,8,15
6083,1,0,6,15,22
6084,0,1,10,26,37
6085,0,0,1,7,8
6086,1,2,2,10,15
6087,4,2,1,35,42
6088,0,0,7,10,17
6089,0,1,7,9,17
6090,0,0,2,6,8
6091,0,0,7,8,15
6092,0,2,5,19,26
6093,4,2,1,35,42
6094,0,1,10,26,37
6095,0,0,1,4,5
6096,0,0,5,5,10
6097,0,0,4,8,12
6098,0,0,11,21,32
6099,1,1,15,30,47
6100,1,2,2,10,15
6101,1,0,1,8,10
6102,0,2,3,4,9
6103,0,0,6,16,22
6104,0,0,5,3,8
6105,0,0,13,24,37
6106,0,0,7,11,18
6107,0,0,5,14,19
6108,0,0,8,17,25
6109,1,6,10,11,28
6110,0,0,3,17,20
6111,0,0,3,9,12
6112,0,1,5,12,18
6113,0,0,15,29,44
6114,0,0,10,28,38
6115,0,1,9,18,28
6116,1,0,4,24,29
6117,0,1,14,14,29
6118,0,0,8,15,23
6119,0,0,2,18,20
6120,0,0,2,9,11
6121,0,0,15,28,43
6122,0,0,5,8,13
6123,0,1,11,23,35
6124,0,0,7,26,33
6125,0,1,13,25,39
6126,0,0,13,16,29
6127,0,0,14,25,39
6128,0,0,4,3,7
6129,0,0,5,9,14
6130,0,0,8,7,15
6131,0,0,5,16,21
6132,0,1,6,19,26
6133,0,0,13,34,47
6134,0,0,4,12,16
6135,0,0,6,25,31
6136,0,0,13,34,47
6137,0,0,4,14,18
6138,0,1,5,15,21
6139,0,0,11,13,24
6140,1,1,17,31,50
6141,0,0,11,17,28
6142,0,0,5,14,19
6143,0,0,16,34,50
6144,0,0,2,5,7
6145,0,0,13,24,37
6146,0,0,7,4,11
6147,0,0,13,37,50
6148,0,0,6,3,9
6149,0,0,4,14,18
6150,0,0,0,9,9
6151,0,0,13,16,29
6152,0,0,16,31,47
6153,0,1,13,15,29
6154,0,0,8,22,30
6155,0,0,6,20,26
6156,0,0,12,28,40
6157,0,0,14,29,43
6158,0,0,1,6,7
6159,0,0,1,7,8
6160,0,0,5,15,20
6161,0,0,6,18,24
6162,0,1,4,10,15
6163,0,0,11,28,39
6164,0,0,7,7,14
6165,0,0,9,29,38
6166,0,0,14,33,47
6167,0,0,4,35,39
6168,1,0,6,22,29
6169,0,0,5,11,16
6170,0,1,1,9,11
6171,0,0,3,17,20
6172,1,0,8,27,36
6173,0,0,7,9,16
6174,0,0,1,10,11
6175,0,3,7,31,41
6176,0,0,8,18,26
6177,0,0,6,5,11
6178,0,0,6,7,13
6179,0,0,5,23,28
6180,0,0,5,11,16
6181,0,0,10,21,31
6182,0,0,3,2,5
6183,0,0,5,9,14
6184,0,0,5,35,40
6185,0,0,7,18,25
6186,0,0,2,3,5
6187,0,0,1,4,5
6188,0,0,5,12,17
6189,0,0,4,10,14
6190,0,0,8,14,22
6191,0,0,5,11,16
6192,0,1,4,9,14
6193,0,0,2,8,10
6194,0,0,6,19,25
6195,0,1,7,40,48
6196,0,0,3,13,16
6197,0,0,0,1,1
6198,0,0,2,2,4
6199,0,0,3,18,21
6200,0,0,4,12,16
6201,0,0,3,20,23
6202,0,0,8,5,13
6203,0,0,4,13,17
6204,4,0,9,37,50
6205,0,0,8,10,18
6206,0,0,1,1,2
6207,1,0,4,9,14
6208,0,0,1,8,9
6209,0,1,1,6,8
6210,0,0,7,9,16
6211,0,0,3,4,7
6212,0,0,12,23,35
6213,0,0,0,5,5
6214,0,0,9,19,28
6215,0,0,4,24,28
6216,0,0,1,5,6
6217,0,0,2,8,10
6218,0,0,3,9,12
6219,0,0,5,7,12
6220,0,0,9,9,18
6221,1,0,1,3,5
6222,1,1,5,41,48
6223,1,0,0,4,5
6224,0,1,5,16,22
6225,0,0,7,5,12
6226,0,0,11,20,31
6228,0,1,12,18,31
6229,0,1,4,15,20
6230,0,0,3,4,7
6231,0,0,6,12,18
6232,0,0,0,2,2
6233,0,0,10,12,22
6234,0,0,11,14,25
6235,0,0,2,6,8
6236,0,0,4,11,15
6237,0,0,2,4,6
6238,0,0,13,37,50
6239,1,1,6,19,27
6240,0,1,6,2,9
6241,0,0,18,26,44
6242,0,0,9,32,41
6243,0,1,9,1,11
6244,0,0,10,6,16
6245,0,1,6,17,24
6246,0,0,2,18,20
6247,0,0,12,11,23
6248,0,1,7,14,22
6249,0,0,2,4,6
6250,0,0,1,0,1
6251,0,2,4,32,38
6252,0,0,2,9,11
6253,0,0,5,7,12
6254,0,0,16,25,41
6255,0,0,16,31,47
6256,1,0,6,10,17
6257,1,7,3,5,16
6258,0,0,4,11,15
6259,0,0,8,12,20
6260,0,0,5,7,12
6262,0,0,13,24,37
6264,0,0,4,12,16
6266,0,0,3,8,11
6267,0,0,4,16,20
6268,0,0,7,6,13
6269,0,0,1,4,5
6270,2,1,2,14,19
6271,0,0,2,3,5
6272,0,1,11,38,50
6273,0,0,5,11,16
6274,0,0,6,16,22
6275,2,1,2,12,17
6276,2,2,5,30,39
6277,0,0,5,9,14
6278,0,0,8,37,45
6279,0,0,13,24,37
6280,0,0,16,25,41
6281,1,0,16,32,49
6282,0,0,21,29,50
6283,0,0,5,3,8
6284,0,0,3,12,15
6285,0,0,15,29,44
6286,0,0,8,12,20
6287,0,1,7,16,24
6288,1,0,3,15,19
6289,0,1,10,31,42
6290,2,2,5,30,39
6291,0,0,2,24,26
6292,0,2,10,36,48
6293,0,3,4,20,27
6294,1,0,8,20,29
6295,0,0,9,24,33
6296,1,2,7,19,29
6297,0,1,15,23,39
6298,0,1,2,11,14
6299,0,0,5,25,30
6300,0,0,6,25,31
6302,3,0,14,32,49
6303,0,1,15,33,49
6304,0,0,13,20,33
6305,0,0,1,4,5
6306,0,0,11,39,50
6307,0,1,11,18,30
6308,1,0,4,2,7
6309,0,0,4,5,9
6310,0,0,6,6,12
6311,0,0,14,19,33
6312,0,2,5,19,26
6313,0,0,11,19,30
6314,0,0,4,6,10
6315,0,0,3,3,6
6316,0,0,2,4,6
6318,0,0,14,28,42
6319,0,0,1,14,15
6320,0,0,11,33,44
6321,3,0,12,32,47
6322,0,1,2,11,14
6323,0,1,8,24,33
6324,0,0,9,21,30
6325,0,0,1,5,6
6326,0,3,4,19,26
6327,0,1,0,8,9
6328,1,0,7,31,39
6329,1,0,8,14,23
6330,0,0,4,14,18
6331,1,0,2,17,20
6332,0,1,6,14,21
6333,0,0,1,2,3
6334,0,0,3,16,19
6335,0,1,5,27,33
6336,0,1,14,30,45
6337,0,0,4,10,14
6338,0,0,10,31,41
6339,0,0,5,14,19
6340,0,0,11,15,26
6341,0,0,2,4,6
6342,0,0,12,28,40
6343,0,0,4,3,7
6344,0,0,1,5,6
6345,0,1,10,14,25
6346,0,2,6,19,27
6347,0,0,22,26,48
6348,0,1,1,11,13
6349,2,0,3,19,24
6350,1,1,7,21,30
6351,0,1,10,23,34
6352,1,0,3,4,8
6353,0,1,7,14,22
6354,0,0,2,20,22
6355,0,0,2,23,25
6356,0,1,5,19,25
6357,0,0,4,13,17
6358,0,0,8,12,20
6359,3,1,2,15,21
6360,0,2,13,34,49
6361,0,0,12,23,35
6362,0,1,0,9,10
6363,0,0,7,8,15
6364,0,0,6,8,14
6365,0,0,0,13,13
6366,2,0,10,37,49
6367,0,2,2,21,25
6368,0,0,2,3,5
6369,0,0,1,4,5
6370,0,0,4,3,7
6371,0,0,3,3,6
6372,0,8,11,31,50
6373,0,0,0,9,9
6374,0,0,7,26,33
6375,1,6,10,11,28
6377,0,0,10,33,43
6378,0,0,3,2,5
6379,1,1,3,23,28
6380,0,0,6,16,22
6381,0,0,15,32,47
6382,0,0,12,28,40
6383,0,0,6,20,26
6384,0,0,4,14,18
6385,0,0,1,4,5
6386,0,0,13,34,47
6387,0,2,2,22,26
6388,0,3,3,20,26
6389,0,1,11,38,50
6390,0,0,3,18,21
6391,0,1,7,40,48
6392,2,0,13,28,43
6393,2,1,2,12,17
6394,0,1,5,16,22
6395,2,1,2,14,19
6396,0,0,8,17,25
6397,0,0,5,11,16
6398,0,1,13,36,50
6400,1,1,7,39,48
6401,0,0,1,14,15
6402,0,1,12,30,43
6403,0,2,3,25,30
6404,0,0,21,29,50
6405,7,0,6,14,27
6406,0,0,8,23,31
6407,0,0,2,24,26
6408,0,0,8,16,24
6409,0,0,2,1,3
6410,0,0,3,12,15
6411,3,1,2,15,21
6412,2,0,10,37,49
6413,0,2,1,15,18
6414,0,0,3,16,19
6415,0,0,4,16,20
6416,0,2,1,5,8
6417,0,0,1,5,6
6418,0,3,3,20,26
6419,0,2,2,21,25
6420,0,0,2,4,6
6421,0,0,4,35,39
6422,2,1,2,14,19
6423,0,0,2,3,5
6424,0,2,2,21,25
6425,1,0,1,3,5
6426,2,1,2,14,19
6427,0,0,2,3,5
6428,0,0,15,32,47
6429,1,1,3,23,28
6430,0,0,16,34,50
6431,0,3,4,19,26
6432,0,0,7,6,13
6433,0,0,2,4,6
6434,0,0,1,4,5
6435,0,0,8,17,25
6436,1,0,1,3,5
6437,0,1,2,24,27
6438,0,1,3,6,10
6439,0,0,8,17,25
6440,0,2,4,15,21
6441,0,1,5,3,9
6442,0,1,7,21,29
6443,0,1,13,36,50
6444,0,1,19,30,50
6445,1,0,9,31,41
6446,0,0,4,13,17
6447,0,1,5,11,17
6448,0,0,5,9,14
6449,1,0,1,14,16
6450,0,0,11,18,29
6451,0,0,15,17,32
6452,0,0,2,17,19
6453,0,0,4,16,20
6454,0,0,13,33,46
6455,0,0,9,33,42
6456,0,0,14,26,40
6457,0,0,4,11,15
6458,0,0,1,6,7
6459,0,0,2,20,22
6460,0,0,8,3,11
6461,0,0,12,37,49
6462,0,0,4,19,23
6463,0,0,5,12,17
6464,0,0,0,24,24
6466,0,0,5,11,16
6467,0,0,9,30,39
6468,1,0,1,3,5
6469,0,0,6,15,21
6470,0,1,2,24,27
6471,0,0,5,28,33
6472,0,0,0,5,5
6473,1,3,3,33,40
6474,0,0,11,28,39
6475,0,0,2,10,12
6476,0,0,6,19,25
6477,0,0,9,20,29
6478,0,0,0,17,17
6479,0,0,2,8,10
6480,1,2,15,23,41
6481,2,0,6,6,14
6482,0,1,8,15,24
6483,3,0,4,25,32
6484,0,0,20,28,48
6485,0,2,9,22,33
6486,0,1,17,32,50
6487,0,1,7,18,26
6488,0,2,8,20,30
6489,0,0,3,18,21
6490,0,0,4,10,14
6491,0,0,6,9,15
6492,0,1,13,13,27
6493,0,0,1,7,8
6494,0,1,9,13,23
6495,0,0,13,33,46
6496,0,0,2,8,10
6497,0,0,8,13,21
6498,0,0,2,8,10
6499,0,0,6,17,23
6500,0,0,10,37,47
6501,0,0,8,9,17
6502,0,0,2,17,19
6504,0,0,1,13,14
6506,0,2,4,15,21
6507,0,0,2,4,6
6508,0,1,10,12,23
6509,0,0,8,10,18
6510,0,0,0,19,19
6511,0,0,16,31,47
6512,0,0,11,14,25
6513,0,0,4,10,14
6514,1,0,4,32,37
6515,0,0,8,17,25
6516,0,0,6,24,30
6517,0,1,4,12,17
6518,0,0,12,36,48
6519,0,0,9,12,21
6520,0,0,6,3,9
6521,0,0,2,13,15
6522,0,0,7,12,19
6523,0,0,8,15,23
6524,0,0,7,19,26
6525,1,2,17,17,37
6526,0,0,8,10,18
6527,0,0,19,31,50
6528,0,0,8,10,18
6529,1,0,0,7,8
6530,0,0,5,2,7
6531,0,0,8,10,18
6532,0,0,5,8,13
6533,0,0,3,44,47
6534,0,0,4,14,18
6535,0,0,5,8,13
6536,0,0,6,24,30
6537,0,0,7,16,23
6538,2,0,7,7,16
6539,0,0,8,13,21
6540,0,0,6,9,15
6541,0,1,0,6,7
6542,0,1,9,40,50
6543,0,0,0,12,12
6544,0,0,0,1,1
6545,0,0,2,3,5
6546,0,0,5,4,9
6548,0,1,3,1,5
6549,0,0,13,27,40
6551,0,0,5,23,28
6552,1,0,4,39,44
6553,1,0,1,10,12
6554,0,0,1,1,2
6555,0,0,9,17,26
6557,0,0,8,7,15
6558,0,0,6,6,12
6559,0,0,12,26,38
6560,0,0,3,8,11
6561,0,0,5,5,10
6562,0,0,7,7,14
6563,0,2,0,13,15
6565,0,0,2,4,6
6566,0,1,5,14,20
6567,0,0,6,4,10
6568,0,1,7,20,28
6569,0,0,6,15,21
6570,0,0,2,13,15
6571,0,0,2,4,6
6572,0,0,1,4,5
6573,0,0,6,9,15
6574,1,1,6,37,45
6575,0,0,14,23,37
6576,0,0,3,11,14
6577,0,1,4,3,8
6578,0,1,7,40,48
6579,0,0,4,18,22
6580,0,1,3,6,10
6581,0,0,0,5,5
6582,0,0,8,40,48
6583,0,0,5,8,13
6584,0,0,3,14,17
6585,0,3,12,33,48
6586,1,0,14,23,38
6587,0,1,8,40,49
6588,0,0,3,13,16
6589,0,0,9,13,22
6590,0,0,13,33,46
6591,0,0,6,15,21
6592,2,1,9,37,49
6593,0,0,5,0,5
6594,0,2,10,37,49
6595,1,0,15,31,47
6596,0,0,17,27,44
6597,1,4,7,19,31
6598,1,0,8,20,29
6599,0,1,2,17,20
6600,0,1,7,20,28
6601,1,1,3,23,28
6602,0,0,1,30,31
6603,0,1,4,12,17
6604,0,0,10,29,39
6605,0,1,1,7,9
6606,0,2,0,13,15
6607,0,0,2,7,9
6608,0,0,0,24,24
6609,0,1,7,23,31
6610,0,0,7,7,14
6611,0,0,7,25,32
6612,0,3,0,4,7
6613,0,0,6,9,15
6614,0,1,12,33,46
6615,0,1,7,18,26
6616,0,1,3,12,16
6617,0,0,8,14,22
6618,0,1,3,13,17
6619,0,0,6,18,24
6620,1,3,3,33,40
6621,2,0,6,6,14
6622,0,2,8,26,36
6623,0,0,9,15,24
6624,0,1,3,12,16
6625,0,0,9,15,24
6626,0,2,8,26,36
6627,0,0,9,15,24
6628,0,0,9,11,20
6629,0,2,6,6,14
6630,0,0,8,11,19
6632,0,1,8,8,17
6633,0,2,4,5,11
6634,0,0,12,13,25
6635,2,0,10,18,30
6636,0,0,2,3,5
6637,0,0,5,7,12
6638,0,0,4,2,6
6639,0,0,3,2,5
6640,0,0,2,12,14
6641,0,0,7,15,22
6642,0,4,9,19,32
6643,1,0,13,18,32
6644,0,0,3,10,13
6645,0,0,4,5,9
6646,1,0,5,5,11
6647,0,0,10,4,14
6648,0,0,10,12,22
6649,0,0,5,4,9
6650,2,1,7,14,24
6651,0,1,8,24,33
6652,0,0,2,17,19
6653,0,0,4,3,7
6654,0,0,0,10,10
6655,0,0,2,5,7
6656,0,0,3,6,9
6657,0,0,5,12,17
6658,0,2,6,6,14
6659,0,2,8,26,36
6660,6,2,1,11,20
6661,0,0,9,11,20
6662,2,0,3,18,23
6663,0,0,4,18,22
6664,0,0,3,8,11
6666,0,0,3,18,21
6668,6,2,1,11,20
6669,1,0,5,11,17
6670,0,0,11,13,24
6671,0,4,16,29,49
6672,2,0,3,18,23
6673,0,1,9,19,29
6674,0,0,4,18,22
6675,0,0,12,23,35
6676,0,0,1,15,16
6677,0,0,2,5,7
6678,0,0,14,36,50
6679,0,0,10,15,25
6680,1,0,5,5,11
6681,2,1,7,14,24
6682,0,1,18,31,50
6683,2,10,3,18,33
6684,2,0,3,18,23
6685,0,1,0,16,17
6686,0,0,14,13,27
6687,0,0,10,15,25
6688,0,0,5,12,17
6689,2,0,3,18,23
6690,0,4,16,29,49
6691,0,1,9,19,29
6692,0,1,18,31,50
6693,0,0,11,13,24
6694,0,0,12,23,35
6695,0,0,2,17,19
6696,0,2,8,26,36
6697,0,0,14,36,50
6698,0,0,1,15,16
6699,2,10,3,18,33
6700,0,1,8,24,33
6701,0,0,3,8,11
6702,0,0,9,11,20
6703,0,0,9,11,20
6704,0,0,8,8,16
6705,0,0,5,9,14
6706,1,4,5,19,29
6707,0,0,2,1,3
6708,0,0,5,10,15
6709,0,1,13,30,44
6710,1,4,3,42,50
6711,0,1,9,18,28
6712,0,0,12,23,35
6713,0,0,5,5,10
6714,0,0,5,7,12
6715,0,0,11,8,19
6716,0,0,2,17,19
6717,0,0,3,7,10
6718,0,0,17,17,34
6719,0,1,8,24,33
6720,0,0,8,13,21
6721,0,0,12,15,27
6722,0,3,16,24,43
6723,0,1,9,22,32
6724,0,1,8,8,17
6725,0,0,5,7,12
6726,0,0,5,6,11
6727,0,3,13,30,46
6728,0,0,6,2,8
6729,2,1,14,29,46
6730,0,0,7,2,9
6731,0,1,5,12,18
6732,0,1,17,13,31
6734,0,2,5,13,20
6735,3,2,3,10,18
6736,0,0,8,18,26
6737,0,0,5,3,8
6738,0,1,15,17,33
6739,1,0,3,10,14
6740,0,0,12,22,34
6741,0,0,5,4,9
6742,0,0,10,11,21
6743,0,0,15,15,30
6745,2,0,10,26,38
6746,0,2,7,11,20
6748,0,0,4,2,6
6749,0,1,2,12,15
6750,0,0,4,3,7
6751,0,0,5,9,14
6752,0,0,7,15,22
6753,0,0,7,4,11
6754,0,2,12,28,42
6755,0,0,5,4,9
6756,0,0,12,13,25
6757,0,1,6,4,11
6758,2,0,3,18,23
6759,1,4,5,19,29
6760,0,0,4,18,22
6761,0,0,9,15,24
6762,0,3,9,27,39
6763,1,0,5,5,11
6764,0,0,9,11,20
6765,0,0,2,5,7
6766,0,0,17,33,50
6767,0,0,20,25,45
6768,1,0,19,30,50
6769,0,1,9,19,29
6770,0,2,8,27,37
6771,0,0,15,33,48
6772,0,0,11,22,33
6774,0,0,5,22,27
6775,0,0,6,14,20
6776,0,0,4,2,6
6777,0,0,5,7,12
6778,4,1,8,35,48
6779,1,0,2,9,12
6780,1,1,1,22,25
6781,0,0,3,22,25
6782,1,0,5,5,11
6783,0,0,9,15,24
6784,0,0,14,36,50
6786,0,0,12,25,37
6787,0,0,3,7,10
6788,1,0,3,10,14
6789,0,0,2,5,7
6790,0,0,4,18,22
6791,2,0,3,18,23
6792,0,4,16,29,49
6793,0,0,11,13,24
6794,0,0,10,15,25
6795,1,4,5,19,29
6796,2,0,3,18,23
6797,2,10,3,18,33
6798,1,1,10,37,49
6799,0,0,7,10,17
6800,4,1,0,21,26
6801,4,1,0,21,26
6802,0,1,6,4,11
6803,0,0,5,5,10
6804,2,0,3,18,23
6805,0,1,8,24,33
6806,0,0,10,15,25
6807,0,1,12,35,48
6808,0,1,9,19,29
6809,0,4,16,29,49
6810,0,0,2,17,19
6811,0,0,11,13,24
6812,0,3,9,27,39
6813,0,0,9,11,20
6814,0,0,14,36,50
6815,0,0,9,15,24
6816,2,10,3,18,33
6817,0,0,10,14,24
6818,0,0,5,9,14
6819,0,0,4,5,9
6820,0,1,4,5,10
6822,0,0,4,11,15
6823,0,2,7,30,39
6824,0,0,12,27,39
6825,0,1,14,19,34
6826,0,0,5,10,15
6827,0,0,5,4,9
6828,0,0,5,12,17
6829,1,1,5,15,22
6830,0,0,6,15,21
6831,0,0,3,11,14
6832,0,0,9,26,35
6833,0,2,5,21,28
6834,0,0,13,21,34
6835,0,0,7,23,30
6836,0,0,4,6,10
6837,0,0,6,11,17
6838,0,1,7,26,34
6839,0,0,17,33,50
6840,0,0,7,5,12
6841,2,1,3,8,14
6842,1,3,7,39,50
6843,0,1,8,34,43
6844,0,0,7,10,17
6845,0,0,6,13,19
6846,0,0,2,3,5
6847,0,0,10,4,14
6850,0,0,8,14,22
6851,0,0,0,3,3
6852,0,0,0,4,4
6853,0,0,10,18,28
6854,0,0,0,3,3
6855,1,0,16,28,45
6856,0,0,5,2,7
6857,0,2,9,9,20
6858,1,0,19,30,50
6859,0,0,18,32,50
6861,0,0,12,13,25
6862,0,0,9,13,22
6863,0,0,4,13,17
6864,0,0,11,22,33
6865,0,0,12,25,37
6866,0,0,11,14,25
6867,2,0,4,14,20
6868,0,0,3,10,13
6869,5,1,15,29,50
6870,0,0,7,2,9
6871,0,0,1,4,5
6872,0,0,3,7,10
6873,2,1,3,8,14
6874,0,0,7,2,9
6875,0,0,5,12,17
6876,0,0,6,4,10
6877,1,4,5,19,29
6878,0,0,6,10,16
6879,1,0,6,17,24
6880,0,0,4,9,13
6881,0,2,17,20,39
6882,0,0,3,2,5
6883,0,0,4,3,7
6884,0,0,4,11,15
6885,3,0,7,21,31
6886,0,0,4,5,9
6887,0,0,1,2,3
6888,0,0,6,8,14
6889,0,0,3,6,9
6890,0,0,7,19,26
6891,1,0,4,4,9
6892,0,0,11,11,22
6893,0,0,7,33,40
6894,0,1,8,7,16
6895,4,1,2,21,28
6896,0,0,4,2,6
6897,0,1,6,10,17
6898,0,0,12,29,41
6900,1,4,5,19,29
6901,0,1,4,4,9
6902,0,0,6,16,22
6903,0,0,6,11,17
6904,0,0,2,12,14
6905,0,1,19,28,48
6906,8,0,6,25,39
6907,1,0,7,19,27
6908,0,1,4,4,9
6909,0,0,7,11,18
6910,0,0,4,13,17
6912,0,0,16,27,43
6913,3,0,6,13,22
6914,0,0,12,9,21
6915,1,0,10,38,49
6916,0,0,11,17,28
6918,1,4,5,19,29
6919,0,0,1,7,8
6920,0,0,2,12,14
6923,0,0,4,4,8
6925,0,0,8,15,23
6926,0,0,10,14,24
6927,0,0,16,15,31
6928,0,0,7,11,18
6929,4,1,8,10,23
6930,0,0,8,22,30
6931,0,0,6,7,13
6932,0,0,5,21,26
6933,1,0,10,15,26
6934,0,0,12,24,36
6935,0,0,10,18,28
6936,0,0,7,17,24
6937,2,1,2,8,13
6938,0,1,7,16,24
6939,5,4,5,36,50
6940,0,0,9,26,35
6941,0,0,13,13,26
6942,0,0,9,11,20
6943,0,0,8,38,46
6944,0,0,17,32,49
6945,2,0,5,25,32
6946,2,2,4,19,27
6947,2,1,2,8,13
6948,4,1,0,21,26
6949,4,1,0,21,26
6950,0,0,17,32,49
6951,0,0,6,4,10
6952,0,0,3,6,9
6953,0,0,5,9,14
6954,0,1,3,20,24
6955,0,0,5,5,10
6956,0,0,9,11,20
6957,0,1,11,22,34
6958,0,0,10,10,20
6959,0,1,4,11,16
6960,1,0,14,19,34
6961,1,1,8,19,29
6962,0,0,4,8,12
6964,0,0,8,12,20
6965,0,0,7,11,18
6966,0,0,7,16,23
6967,0,2,6,38,46
6969,0,1,6,9,16
6970,0,0,11,27,38
6971,2,0,18,30,50
6972,0,0,12,12,24
6973,0,0,14,28,42
6974,0,3,9,27,39
6975,0,0,9,5,14
6976,2,1,7,14,24
6977,0,0,10,21,31
6978,2,0,9,16,27
6979,0,0,2,3,5
6980,0,0,3,10,13
6981,0,0,5,11,16
6982,0,0,10,21,31
6983,0,0,4,10,14
6984,0,1,9,22,32
6985,0,1,9,10,20
6986,0,1,4,4,9
6987,0,0,5,9,14
6989,1,1,4,16,22
6990,0,0,16,34,50
6991,0,1,8,34,43
6992,0,1,11,22,34
6993,0,1,3,6,10
6994,0,0,17,17,34
6995,0,0,9,11,20
6996,0,0,5,5,10
6997,0,0,4,18,22
6998,0,0,2,3,5
6999,0,1,12,37,50
7000,0,0,2,5,7
7001,0,0,8,14,22
7002,0,1,8,14,23
7003,0,0,7,9,16
7004,1,2,17,21,41
7005,1,0,15,27,43
7006,0,0,6,23,29
7007,0,0,2,8,10
7008,0,0,7,8,15
7009,2,1,4,29,36
7010,1,0,8,24,33
7011,0,1,4,4,9
7012,0,2,1,9,12
7013,0,0,6,1,7
7014,0,1,10,38,49
7015,0,0,13,9,22
7016,5,1,8,36,50
7017,0,0,4,18,22
7018,0,0,6,16,22
7019,0,0,7,26,33
7020,0,0,16,34,50
7021,3,2,0,7,12
7022,0,0,2,5,7
7023,0,1,3,20,24
7024,2,0,18,30,50
7025,4,0,2,22,28
7026,0,0,4,8,12
7027,0,0,10,10,20
7028,2,1,7,14,24
7029,0,0,2,3,5
7030,3,2,0,7,12
7031,0,0,7,15,22
7032,4,0,2,22,28
7033,0,0,7,15,22
7034,0,0,7,26,33
7035,0,3,9,27,39
7036,0,0,9,11,20
7037,0,1,11,22,34
7038,0,2,6,6,14
7039,0,1,3,20,24
7040,0,0,3,15,18
7041,0,3,12,21,36
7042,0,1,11,22,34
7043,0,0,7,11,18
7044,0,1,2,16,19
7045,0,0,7,13,20
7046,0,1,7,6,14
7049,0,0,1,4,5
7051,0,2,6,6,14
7052,1,0,1,4,6
7054,1,0,3,10,14
7055,0,0,7,6,13
7056,0,0,3,9,12
7057,0,0,1,15,16
7058,0,0,2,5,7
7059,0,0,3,3,6
7060,0,0,10,23,33
7061,0,0,13,13,26
7062,0,0,4,13,17
7063,0,1,13,32,46
7064,0,1,3,20,24
7065,0,0,2,6,8
7066,1,0,3,10,14
7067,1,2,1,10,14
7069,0,0,2,9,11
7070,1,0,13,35,49
7073,0,0,7,13,20
7075,0,0,14,36,50
7078,0,0,2,6,8
7079,0,0,1,15,16
7080,1,0,2,3,6
7081,0,1,1,7,9
7082,0,0,2,4,6
7083,0,0,6,1,7
7084,0,0,10,10,20
7085,0,0,8,3,11
7086,0,0,5,5,10
7087,0,0,1,6,7
7088,0,1,3,9,13
7089,0,0,5,23,28
7090,0,0,2,12,14
7091,0,0,7,11,18
7092,0,0,1,2,3
7093,0,1,3,7,11
7094,0,0,1,7,8
7095,0,1,15,18,34
7097,0,0,0,1,1
7098,0,0,7,7,14
7099,0,0,2,3,5
7100,0,0,9,3,12
7101,0,1,8,5,14
7102,0,0,15,31,46
7103,0,0,7,17,24
7104,0,0,16,25,41
7105,0,0,5,7,12
7106,0,0,9,13,22
7107,0,1,6,23,30
7108,0,0,3,2,5
7109,0,1,10,13,24
7110,0,0,9,7,16
7111,0,1,6,14,21
7112,1,0,13,36,50
7113,0,0,3,8,11
7114,0,0,6,9,15
7115,0,1,3,6,10
7116,0,0,2,3,5
7117,0,0,4,0,4
7118,0,0,6,20,26
7119,0,0,5,8,13
7120,0,0,6,4,10
7121,0,2,8,35,45
7122,0,0,2,13,15
7123,0,1,5,22,28
7124,0,0,8,21,29
7125,0,0,6,12,18
7126,0,0,5,5,10
7127,0,0,4,10,14
7128,1,1,4,16,22
7129,0,0,7,12,19
7131,0,1,1,10,12
7133,0,0,9,23,32
7134,0,0,8,3,11
7135,0,0,8,28,36
7136,0,1,9,6,16
7137,0,0,11,15,26
7138,0,1,12,37,50
7140,0,0,2,3,5
7142,0,0,10,8,18
7143,0,0,11,11,22
7144,2,4,3,13,22
7145,0,0,3,4,7
7146,0,0,2,5,7
7147,0,0,7,11,18
7148,1,0,1,10,12
7149,0,0,5,6,11
7150,0,1,3,18,22
7151,0,0,1,4,5
7152,5,0,0,22,27
7153,0,0,12,19,31
7154,1,3,10,29,43
7155,0,0,12,10,22
7156,0,1,3,44,48
7157,0,0,1,21,22
7158,2,1,13,17,33
7159,0,2,14,34,50
7160,1,0,11,36,48
7161,0,0,11,35,46
7162,0,0,2,3,5
7163,0,0,7,4,11
7164,1,0,12,28,41
7165,0,2,15,26,43
7166,1,0,9,14,24
7167,0,0,5,12,17
7168,0,0,1,11,12
7169,1,0,12,31,44
7170,1,1,2,15,19
7171,0,0,3,2,5
7172,0,1,1,20,22
7173,0,0,3,0,3
7174,0,1,11,38,50
7175,0,1,9,39,49
7176,0,0,0,4,4
7177,0,1,9,20,30
7178,0,0,0,5,5
7179,0,0,9,21,30
7181,0,4,6,23,33
7182,0,0,1,4,5
7183,0,0,14,36,50
7188,0,0,0,9,9
7189,4,0,2,22,28
7191,0,0,10,10,20
7192,1,0,3,29,33
7193,0,0,0,9,9
7194,0,0,1,4,5
7195,0,0,3,2,5
7196,0,1,4,25,30
7197,1,3,10,29,43
7198,0,1,3,18,22
7199,0,1,11,38,50
7200,0,0,1,21,22
7201,0,1,3,44,48
7202,0,0,0,4,4
7204,0,0,11,21,32
7205,0,0,1,4,5
7207,0,1,1,20,22
7208,5,1,0,22,28
7209,4,0,2,22,28
7210,1,3,10,29,43
7211,0,1,1,20,22
7212,1,0,2,13,16
7213,0,0,4,30,34
7216,4,1,0,21,26
7218,4,1,0,21,26
7219,0,0,3,8,11
7220,0,0,2,4,6
7221,0,0,0,1,1
7222,0,0,7,10,17
7223,0,0,7,9,16
7224,0,0,3,9,12
7225,0,0,0,1,1
7226,0,0,3,15,18
7227,0,0,7,10,17
7229,0,0,0,1,1
7230,0,0,0,1,1
7231,0,0,0,1,1
7233,0,0,0,1,1
7234,0,0,7,9,16
7235,0,0,7,10,17
7237,0,0,6,8,14
7238,0,0,25,21,46
7239,0,0,1,4,5
7240,1,0,8,9,18
7241,0,1,6,18,25
7242,1,1,4,31,37
7243,0,0,10,20,30
7244,0,0,6,21,27
7245,0,0,1,1,2
7246,0,1,19,21,41
7247,0,5,10,18,33
7248,0,0,12,27,39
7249,0,0,13,23,36
7250,0,1,13,17,31
7251,0,0,8,8,16
7253,0,0,1,3,4
7254,0,1,8,23,32
7255,0,0,4,3,7
7256,2,0,5,8,15
7257,1,0,11,38,50
7258,0,0,6,16,22
7259,0,0,4,5,9
7260,0,0,6,6,12
7261,0,3,19,28,50
7262,0,0,8,14,22
7263,0,2,8,21,31
7264,0,0,8,16,24
7265,0,1,10,33,44
7266,0,0,18,31,49
7267,0,0,6,31,37
7268,0,0,6,5,11
7269,0,0,5,7,12
7270,0,1,6,10,17
7271,0,0,7,17,24
7272,0,0,17,22,39
7273,0,0,6,21,27
7274,0,0,12,18,30
7275,0,1,6,18,25
7276,1,6,11,17,35
7277,0,1,13,21,35
7278,1,0,2,12,15
7279,0,0,14,27,41
7280,0,0,6,14,20
7281,0,0,0,5,5
7282,0,0,6,8,14
7283,0,0,10,14,24
7284,0,0,7,12,19
7285,0,1,5,4,10
7286,0,0,3,12,15
7287,0,1,10,13,24
7288,0,2,7,16,25
7289,0,1,4,1,6
7290,0,0,3,1,4
7291,0,3,15,20,38
7292,0,0,14,17,31
7293,0,0,8,7,15
7294,0,1,10,12,23
7295,0,2,10,9,21
7296,0,0,9,10,19
7297,0,0,7,2,9
7298,1,0,4,14,19
7299,0,1,3,10,14
7300,1,0,15,20,36
7301,0,0,4,5,9
7302,1,1,2,7,11
7303,0,1,9,19,29
7304,0,0,8,6,14
7305,0,2,7,11,20
7307,0,0,2,5,7
7308,0,0,2,9,11
7309,0,0,10,20,30
7311,0,0,5,1,6
7312,0,0,25,21,46
7313,0,0,10,18,28
7315,1,1,9,39,50
7316,0,0,15,17,32
7317,0,0,7,10,17
7318,0,0,1,4,5
7319,0,1,0,7,8
7320,0,0,15,13,28
7321,0,1,3,8,12
7322,0,0,3,4,7
7323,1,0,8,9,18
7325,0,0,1,4,5
7327,0,0,9,34,43
7329,0,0,11,11,22
7330,0,1,9,19,29
7331,0,0,15,34,49
7332,0,0,2,5,7
7333,0,0,7,10,17
7334,0,2,14,34,50
7335,0,0,25,21,46
7336,0,0,2,10,12
7337,0,0,1,7,8
7338,0,0,5,7,12
7339,0,0,11,11,22
7340,0,0,10,18,28
7341,0,0,0,12,12
7342,0,0,8,15,23
7343,0,1,2,30,33
7344,0,3,0,7,10
7345,0,2,13,21,36
7346,0,0,15,13,28
7347,2,1,4,18,25
7348,0,0,5,14,19
7350,0,0,19,31,50
7351,0,1,5,15,21
7352,0,0,8,40,48
7353,0,0,10,3,13
7354,0,2,7,11,20
7355,1,1,13,30,45
7356,0,0,12,27,39
7357,0,1,3,10,14
7358,0,0,1,4,5
7359,0,0,3,5,8
7360,0,0,3,1,4
7362,1,1,4,31,37
7363,1,0,9,25,35
7364,0,0,1,3,4
7365,0,0,10,40,50
7366,0,0,7,13,20
7367,1,0,2,12,15
7368,1,0,9,25,35
7369,0,0,1,17,18
7370,0,0,8,40,48
7371,0,0,11,11,22
7372,1,1,4,31,37
7373,0,0,1,4,5
7374,0,0,0,5,5
7375,0,0,9,34,43
7376,0,1,5,15,21
7377,1,1,4,31,37
7378,2,1,4,18,25
7379,0,0,0,5,5
7381,0,2,4,11,17
7382,0,0,7,13,20
7383,0,1,5,15,21
7384,1,1,9,39,50
7385,0,0,10,9,19
7386,0,0,19,31,50
7387,0,1,7,2,10
7388,0,0,9,34,43
7389,0,2,10,7,19
7390,2,1,4,18,25
7391,1,2,15,21,39
7392,0,0,9,17,26
7393,1,0,9,25,35
7394,0,2,7,11,20
7395,0,0,8,6,14
7396,0,0,0,5,5
7397,0,3,9,8,20
7398,0,0,6,8,14
7399,0,0,10,3,13
7400,0,0,7,10,17
7401,1,1,4,31,37
7402,0,0,15,17,32
7404,0,0,3,5,8
7405,0,0,8,7,15
7407,0,0,18,32,50
7408,0,1,0,5,6
7409,0,0,17,26,43
7410,0,1,5,14,20
7411,0,0,5,15,20
7412,0,0,4,10,14
7413,0,0,25,21,46
7414,0,0,6,8,14
7416,1,1,4,31,37
7417,0,0,1,4,5
7418,0,0,3,4,7
7419,0,0,6,8,14
7420,0,0,14,22,36
7421,0,0,13,37,50
7422,0,0,25,21,46
7423,0,0,2,6,8
7424,1,0,10,17,28
7425,0,0,5,9,14
7426,0,3,13,11,27
7427,0,0,8,0,8
7428,0,1,3,2,6
7429,0,0,8,6,14
7430,0,0,10,26,36
7431,0,0,5,7,12
7432,0,0,2,3,5
7433,1,0,6,17,24
7434,0,0,5,10,15
7435,0,1,7,10,18
7436,0,0,14,25,39
7437,0,2,11,16,29
7438,0,0,7,9,16
7439,0,1,4,13,18
7440,0,1,2,8,11
7441,0,0,10,29,39
7442,0,0,7,11,18
7443,0,0,3,17,20
7444,0,5,7,27,39
7445,0,0,8,12,20
7446,0,0,5,5,10
7447,0,0,3,7,10
7448,0,1,9,20,30
7449,0,0,4,3,7
7450,0,0,1,7,8
7451,0,0,2,9,11
7452,0,0,7,9,16
7453,0,2,5,19,26
7454,0,1,13,15,29
7455,0,1,6,10,17
7456,0,1,15,14,30
7457,0,0,1,4,5
7458,0,0,13,14,27
7459,0,0,10,13,23
7460,0,1,4,9,14
7461,0,0,2,0,2
7462,0,0,10,20,30
7463,0,1,16,29,46
7464,0,0,8,2,10
7465,0,0,6,17,23
7467,0,0,18,30,48
7468,1,2,13,32,48
7469,0,0,15,21,36
7470,0,0,8,23,31
7471,0,0,6,10,16
7472,0,0,7,26,33
7473,0,0,3,4,7
7474,0,1,3,7,11
7475,0,0,14,15,29
7476,0,0,6,15,21
7477,0,0,7,17,24
7478,0,0,5,6,11
7480,0,0,13,21,34
7481,0,0,12,14,26
7482,0,0,8,13,21
7483,0,0,13,28,41
7484,0,0,2,3,5
7485,1,0,4,11,16
7486,0,0,12,15,27
7487,0,0,7,16,23
7488,0,0,8,23,31
7489,0,0,5,20,25
7490,1,1,12,35,49
7491,0,0,3,2,5
7492,0,0,11,22,33
7493,0,0,7,8,15
7494,0,0,6,18,24
7495,0,0,14,34,48
7496,0,0,7,22,29
7497,0,0,7,11,18
7498,0,2,9,9,20
7500,0,0,8,8,16
7501,0,0,6,4,10
7502,0,0,12,32,44
7503,0,0,2,8,10
7504,0,2,8,10,20
7505,0,0,6,6,12
7506,0,0,10,17,27
7507,0,0,4,5,9
7508,0,0,4,10,14
7509,0,0,3,4,7
7510,0,0,3,1,4
7511,0,0,11,27,38
7512,0,0,1,18,19
7513,0,1,9,12,22
7514,0,0,8,15,23
7515,0,0,14,27,41
7516,0,1,11,30,42
7517,0,0,5,2,7
7519,0,2,8,25,35
7520,0,0,7,43,50
7521,0,0,4,21,25
7522,0,0,6,4,10
7523,0,0,6,11,17
7524,0,0,8,10,18
7525,0,0,7,11,18
7526,0,0,7,8,15
7527,0,0,12,14,26
7528,0,0,10,4,14
7530,0,0,5,8,13
7531,0,0,3,16,19
7532,0,0,2,12,14
7533,0,0,6,7,13
7534,0,0,5,6,11
7535,0,0,1,4,5
7536,0,0,9,14,23
7538,0,0,9,11,20
7539,0,0,3,8,11
7540,0,0,6,8,14
7541,0,0,9,16,25
7542,0,1,5,14,20
7543,0,2,10,17,29
7544,0,0,3,13,16
7545,0,0,4,7,11
7546,0,0,7,6,13
7547,0,0,12,16,28
7548,0,0,0,5,5
7549,0,0,7,8,15
7550,0,0,14,30,44
7551,0,0,11,9,20
7552,0,0,13,20,33
7553,0,0,8,20,28
7554,0,0,12,38,50
7555,0,0,5,14,19
7556,0,0,4,6,10
7557,0,1,3,8,12
7558,0,0,5,18,23
7560,0,0,7,15,22
7561,0,0,3,3,6
7562,0,0,17,23,40
7563,0,1,7,13,21
7564,0,0,5,8,13
7565,0,0,4,8,12
7566,1,1,6,14,22
7568,0,0,17,26,43
7570,0,2,12,16,30
7571,0,0,11,16,27
7572,0,0,6,32,38
7573,0,0,5,12,17
7574,0,2,7,16,25
7575,0,0,5,3,8
7576,0,0,1,4,5
7577,0,0,10,11,21
7578,0,0,3,2,5
7579,0,0,19,28,47
7580,0,0,16,34,50
7581,0,3,6,21,30
7582,0,2,15,33,50
7583,1,0,19,19,39
7584,0,0,9,17,26
7585,0,0,5,10,15
7586,0,0,6,7,13
7587,0,1,19,27,47
7588,0,0,4,4,8
7589,0,0,5,7,12
7590,0,0,3,2,5
7591,0,0,4,7,11
7592,0,5,19,17,41
7593,0,0,9,19,28
7594,0,0,3,5,8
7595,0,0,6,11,17
7596,0,0,25,18,43
7597,0,0,4,9,13
7598,0,0,3,9,12
7599,0,0,1,6,7
7600,0,0,12,28,40
7601,0,0,4,18,22
7603,0,0,17,30,47
7604,0,0,4,13,17
7605,0,1,0,4,5
7606,0,1,11,11,23
7607,0,0,6,5,11
7608,0,4,17,29,50
7609,0,0,0,4,4
7610,0,0,13,10,23
7611,0,0,4,7,11
7612,0,0,2,3,5
7613,0,0,5,15,20
7614,0,0,6,8,14
7615,0,1,4,1,6
7616,1,0,5,10,16
7617,0,0,9,14,23
7618,0,1,0,4,5
7619,0,0,5,26,31
7620,0,0,5,18,23
7621,0,0,2,7,9
7622,0,1,18,24,43
7623,0,0,9,12,21
7624,0,4,6,17,27
7625,1,8,8,33,50
7626,0,0,6,5,11
7627,0,2,11,33,46
7629,0,1,14,20,35
7630,0,0,2,29,31
7631,0,2,12,11,25
7632,0,0,6,8,14
7633,0,10,0,5,15
7634,0,0,4,11,15
7635,0,0,4,11,15
7636,0,1,12,30,43
7637,0,0,3,2,5
7639,0,0,3,5,8
7642,1,0,10,39,50
7643,0,0,4,9,13
7644,0,0,16,29,45
7645,0,0,7,3,10
7646,0,0,2,6,8
7647,0,0,1,10,11
7648,0,0,9,5,14
7649,0,0,0,6,6
7650,1,3,9,16,29
7651,0,0,3,18,21
7652,1,0,2,12,15
7653,0,1,9,19,29
7654,1,4,10,27,42
7655,0,0,1,4,5
7656,0,0,1,3,4
7658,0,0,3,4,7
7659,0,0,6,8,14
7660,0,1,10,10,21
7661,1,1,2,7,11
7662,0,1,3,10,14
7663,8,1,4,31,44
7664,0,0,9,19,28
7665,0,0,7,15,22
7666,0,0,7,6,13
7667,0,1,5,15,21
7668,0,1,18,28,47
7669,0,1,9,13,23
7670,0,0,3,10,13
7671,0,0,16,32,48
7672,0,0,10,3,13
7673,0,2,14,34,50
7674,0,0,4,16,20
7675,0,0,11,13,24
7676,0,1,7,14,22
7677,0,0,11,20,31
7678,0,1,9,19,29
7679,1,1,3,23,28
7680,0,0,7,9,16
7681,0,0,3,8,11
7682,0,0,2,4,6
7683,0,0,2,3,5
7684,0,0,6,8,14
7685,0,0,3,9,12
7686,0,2,2,27,31
7687,0,0,11,15,26
7688,1,0,5,9,15
7689,0,2,7,13,22
7691,0,0,5,11,16
7693,0,0,4,1,5
7694,0,0,7,5,12
7695,0,1,5,28,34
7696,1,4,10,27,42
7697,0,0,18,26,44
7698,0,0,7,14,21
7699,0,0,11,19,30
7700,0,0,7,22,29
7701,1,0,5,3,9
7702,0,0,15,33,48
7703,0,0,9,18,27
7704,0,0,6,14,20
7705,0,0,10,39,49
7706,0,0,7,5,12
7707,1,1,13,30,45
7708,0,0,7,10,17
7709,0,0,8,15,23
7710,0,0,16,24,40
7711,0,0,8,9,17
7712,0,0,6,7,13
7713,0,0,1,13,14
7714,0,0,9,16,25
7715,2,0,11,37,50
7716,0,1,13,34,48
7717,0,0,2,4,6
7718,2,1,7,17,27
7719,0,0,7,11,18
7720,0,6,7,20,33
7721,0,0,2,5,7
7722,0,0,9,15,24
7723,0,0,5,14,19
7724,0,1,2,9,12
7725,0,0,10,17,27
7726,0,0,3,5,8
7727,3,0,0,13,16
7728,0,0,3,18,21
7729,0,0,2,4,6
7730,0,0,25,21,46
7731,0,0,5,15,20
7732,0,0,6,8,14
7733,1,0,17,31,49
7734,0,2,14,20,36
7735,0,2,15,33,50
7736,0,0,9,34,43
7737,1,0,6,17,24
7738,1,1,4,31,37
7739,0,0,1,4,5
7740,1,3,9,16,29
7741,8,1,4,31,44
7742,0,1,3,10,14
7743,0,0,7,10,17
7745,0,1,15,24,40
7746,0,0,14,25,39
7747,0,0,2,16,18
7748,0,1,5,28,34
7749,0,0,0,1,1
7750,0,0,7,13,20
7751,0,0,1,3,4
7752,0,0,5,6,11
7753,1,0,16,21,38
7754,0,1,10,10,21
7755,0,10,0,5,15
7756,0,0,20,30,50
7757,3,0,11,35,49
7758,1,0,8,11,20
7759,1,1,4,31,37
7760,1,0,2,12,15
7761,0,0,9,16,25
7762,0,0,1,4,5
7763,1,0,8,38,47
7765,0,1,5,15,21
7766,0,2,14,20,36
7767,0,0,9,34,43
7768,8,1,4,31,44
7769,1,1,3,23,28
7770,8,1,4,31,44
7771,0,0,9,16,25
7772,1,1,4,31,37
7773,0,0,2,16,18
7774,1,0,6,17,24
7775,0,0,9,34,43
7776,1,0,8,38,47
7777,0,0,14,25,39
7778,0,0,8,6,14
7779,0,1,5,15,21
7780,1,0,17,31,49
7781,0,0,10,3,13
7782,0,0,6,8,14
7783,0,0,3,5,8
7784,1,1,4,31,37
7785,8,1,4,31,44
7786,0,3,3,9,15
7787,0,0,4,7,11
7788,0,0,5,6,11
7789,0,0,0,7,7
7790,0,0,12,22,34
7791,0,1,8,29,38
7792,1,0,10,20,31
7793,0,0,14,12,26
7794,0,2,7,11,20
7795,1,0,10,17,28
7796,0,0,13,15,28
7797,0,0,2,5,7
7798,0,0,7,2,9
7799,0,1,12,9,22
7800,0,2,6,14,22
7801,0,0,5,7,12
7802,0,0,7,15,22
7803,0,0,10,25,35
7804,0,0,5,10,15
7805,0,0,8,11,19
7806,0,0,9,9,18
7807,0,0,4,3,7
7808,0,0,8,10,18
7809,0,0,8,13,21
7810,2,0,2,17,21
7811,0,0,5,4,9
7812,0,0,2,4,6
7813,1,0,8,21,30
7814,0,0,3,4,7
7815,0,0,8,2,10
7816,0,0,6,2,8
7817,0,0,12,18,30
7818,0,0,5,20,25
7819,0,1,1,5,7
7820,0,1,17,32,50
7821,0,0,12,7,19
7822,0,1,15,18,34
7823,0,0,7,10,17
7824,0,0,5,4,9
7825,0,0,10,5,15
7826,0,0,7,10,17
7827,1,0,11,17,29
7828,0,0,8,13,21
7829,1,0,11,17,29
7830,0,1,3,8,12
7831,1,0,1,13,15
7832,0,0,13,13,26
7833,0,0,1,6,7
7834,0,1,13,34,48
7835,0,0,9,27,36
7836,0,0,3,0,3
7837,0,0,15,13,28
7838,0,0,8,17,25
7839,0,0,9,15,24
7840,0,0,6,9,15
7841,0,0,9,37,46
7842,0,1,12,32,45
7843,0,0,9,12,21
7844,0,0,0,7,7
7845,0,0,7,8,15
7846,0,0,14,16,30
7847,0,0,13,11,24
7848,0,0,12,16,28
7849,0,1,3,11,15
7850,0,0,6,3,9
7851,0,0,3,8,11
7852,0,0,11,14,25
7853,0,0,10,4,14
7854,0,0,4,10,14
7855,0,0,4,10,14
7856,0,0,4,4,8
7857,1,1,9,39,50
7858,0,1,15,27,43
7859,0,0,10,25,35
7860,0,0,5,9,14
7861,0,1,8,15,24
7862,0,0,9,3,12
7864,0,1,5,6,12
7865,0,0,6,11,17
7866,0,0,5,2,7
7867,0,0,0,6,6
7868,0,0,9,17,26
7869,0,0,13,9,22
7870,0,1,6,16,23
7871,0,2,8,20,30
7872,0,0,2,12,14
7873,0,0,4,3,7
7874,0,0,10,7,17
7875,0,0,14,15,29
7876,0,1,13,20,34
7877,0,0,5,4,9
7878,0,0,6,9,15
7879,0,0,6,5,11
7880,0,0,1,2,3
7882,0,0,13,22,35
7883,0,0,8,12,20
7884,0,0,10,19,29
7885,0,0,3,7,10
7886,0,0,7,12,19
7887,0,0,16,34,50
7888,0,0,3,5,8
7890,0,0,6,20,26
7891,0,0,6,6,12
7892,1,0,7,20,28
7893,0,0,7,4,11
7894,0,0,9,24,33
7895,0,0,8,11,19
7896,0,0,4,5,9
7897,0,0,21,23,44
7898,0,0,4,6,10
7899,0,0,4,7,11
7900,0,1,11,5,17
7902,0,0,17,33,50
7903,0,0,14,30,44
7904,0,0,6,8,14
7905,0,0,9,7,16
7907,0,2,14,19,35
7908,0,1,12,24,37
7909,0,0,1,8,9
7910,0,3,3,12,18
7911,0,0,3,17,20
7912,1,0,11,13,25
7913,2,9,2,14,27
7914,0,0,2,4,6
7915,0,0,9,10,19
7916,0,0,6,13,19
7917,0,0,5,0,5
7918,0,0,8,10,18
7919,0,0,4,8,12
7920,0,0,10,6,16
7921,0,2,8,9,19
7922,0,3,6,21,30
7923,0,1,5,27,33
7924,0,0,5,9,14
7925,0,0,0,4,4
7926,0,0,3,3,6
7927,0,0,2,3,5
7928,0,0,7,7,14
7929,0,0,9,19,28
7930,0,0,5,16,21
7932,0,0,15,35,50
7933,0,0,15,26,41
7934,0,1,8,16,25
7935,0,1,7,9,17
7936,1,0,6,4,11
7937,0,0,6,11,17
7938,0,0,10,18,28
7939,0,0,5,10,15
7940,0,0,9,9,18
7941,0,0,12,33,45
7943,0,0,5,11,16
7944,0,0,4,19,23
7945,0,0,6,8,14
7946,0,0,4,8,12
7947,0,1,4,18,23
7948,0,0,3,4,7
7949,0,0,2,18,20
7950,0,2,7,13,22
7951,0,0,1,4,5
7952,0,0,4,5,9
7953,0,0,7,11,18
7954,0,0,3,2,5
7955,0,1,9,40,50
7957,0,0,12,17,29
7959,0,0,1,6,7
7960,0,1,3,3,7
7961,0,5,12,19,36
7962,0,0,6,10,16
7963,0,0,7,12,19
7964,0,0,10,12,22
7965,0,0,4,17,21
7966,0,1,5,13,19
7967,0,0,3,10,13
7968,0,2,3,18,23
7969,0,1,1,11,13
7972,0,0,5,12,17
7973,0,0,8,11,19
7974,0,2,4,23,29
7975,0,0,3,10,13
7976,0,0,3,6,9
7977,0,1,6,12,19
7978,0,0,1,6,7
7979,0,2,7,11,20
7980,0,0,0,5,5
7981,0,5,14,29,48
7982,0,0,9,15,24
7983,0,0,4,5,9
7984,0,0,12,27,39
7985,0,1,14,19,34
7987,0,0,11,35,46
7988,0,0,11,18,29
7989,0,0,2,3,5
7990,0,0,6,4,10
7991,0,0,10,8,18
7992,0,0,9,15,24
7993,0,1,10,39,50
7994,0,0,11,18,29
7995,1,0,15,30,46
7996,0,0,11,10,21
7997,0,2,6,22,30
7998,0,0,7,31,38
7999,0,1,12,32,45
8000,0,0,12,27,39
8001,0,1,8,40,49
8002,0,0,9,40,49
8003,0,0,12,22,34
8004,1,0,10,20,31
8005,0,0,13,25,38
8006,1,0,14,20,35
8007,0,0,8,10,18
8008,0,0,8,40,48
8009,0,0,10,23,33
8010,0,0,10,24,34
8011,0,0,6,9,15
8012,1,0,8,22,31
8013,1,1,4,17,23
8014,0,0,12,37,49
8015,1,0,14,32,47
8016,0,0,8,37,45
8017,0,3,7,10,20
8018,12,1,0,33,46
8019,0,0,12,25,37
8021,0,0,19,29,48
8022,0,0,11,8,19
8023,0,0,5,9,14
8024,0,0,15,32,47
8025,0,0,5,11,16
8026,0,1,16,29,46
8027,0,0,25,22,47
8028,0,0,4,8,12
8029,0,0,5,14,19
8030,0,0,9,9,18
8031,0,0,7,9,16
8032,0,0,6,10,16
8033,0,0,8,10,18
8034,0,1,11,13,25
8035,0,4,7,31,42
8036,0,0,6,2,8
8037,0,0,12,16,28
8038,0,0,7,16,23
8040,0,0,4,24,28
8041,0,1,2,6,9
8042,0,0,1,8,9
8043,0,1,11,5,17
8044,0,0,9,11,20
8045,0,1,14,19,34
8046,0,4,17,21,42
8047,0,0,5,6,11
8048,0,0,7,11,18
8050,0,0,2,10,12
8051,0,0,5,9,14
8052,0,0,4,6,10
8053,0,0,11,13,24
8054,0,1,0,26,27
8055,0,1,13,25,39
8056,0,0,12,11,23
8057,0,1,8,24,33
8058,0,1,4,17,22
8059,0,2,14,20,36
8060,0,0,6,17,23
8061,0,1,11,33,45
8062,0,0,14,36,50
8063,0,0,9,15,24
8064,0,0,15,13,28
8065,0,0,2,5,7
8066,0,0,2,3,5
8067,0,0,10,18,28
8068,0,0,3,10,13
8069,0,0,0,5,5
8070,0,2,7,11,20
8071,0,2,7,13,22
8072,0,0,7,12,19
8073,0,0,1,6,7
8074,0,2,4,23,29
8075,0,0,13,16,29
8076,0,2,10,38,50
8077,0,0,14,25,39
8078,0,0,5,11,16
8079,1,2,2,16,21
8080,0,2,7,13,22
8081,0,0,2,3,5
8082,1,1,4,4,10
8083,0,0,5,10,15
8084,0,0,13,32,45
8085,1,0,15,30,46
8086,0,0,21,23,44
8087,0,0,8,40,48
8088,12,1,0,33,46
8089,0,0,11,15,26
8090,0,2,14,20,36
8091,0,1,3,11,15
8092,0,1,15,18,34
8093,0,0,14,25,39
8094,0,0,11,35,46
8095,1,1,9,39,50
8096,0,2,7,11,20
8097,0,0,8,5,13
8100,0,0,0,2,2
8101,0,0,3,2,5
8102,0,1,5,14,20
8103,0,0,3,4,7
8104,1,0,8,9,18
8105,0,0,2,3,5
8106,0,0,5,3,8
8107,1,2,12,35,50
8108,0,1,6,14,21
8109,0,0,4,2,6
8110,0,0,3,2,5
8111,0,0,3,11,14
8112,0,0,2,7,9
8114,0,0,5,12,17
8115,0,1,10,11,22
8116,0,0,4,8,12
8117,0,0,6,17,23
8118,0,0,8,31,39
8119,0,1,14,34,49
8120,0,0,6,13,19
8121,0,0,3,12,15
8122,0,0,8,14,22
8123,0,1,6,6,13
8124,0,0,3,14,17
8125,0,0,6,14,20
8126,0,0,7,7,14
8127,1,0,10,8,19
8128,0,0,9,18,27
8129,0,0,7,12,19
8130,0,1,0,7,8
8131,0,0,1,6,7
8132,0,1,4,13,18
8133,0,0,4,3,7
8134,0,0,4,3,7
8135,0,0,1,5,6
8136,0,1,12,24,37
8137,0,0,3,6,9
8138,0,0,8,17,25
8139,0,1,5,14,20
8140,0,2,5,7,14
8141,0,0,9,9,18
8142,0,0,1,1,2
8143,0,0,13,32,45
8144,0,0,0,5,5
8145,0,0,5,27,32
8146,0,0,5,4,9
8147,3,1,6,26,36
8148,0,0,12,17,29
8149,0,0,6,15,21
8150,0,0,7,25,32
8151,0,2,13,27,42
8152,0,0,10,21,31
8153,0,0,6,13,19
8154,0,0,9,15,24
8155,0,1,6,10,17
8156,0,0,6,8,14
8158,0,0,5,3,8
8159,0,1,0,13,14
8160,0,0,7,27,34
8161,0,0,13,22,35
8162,0,0,2,1,3
8163,0,0,7,9,16
8164,0,0,2,0,2
8165,0,1,11,29,41
8166,0,0,3,6,9
8168,0,0,12,22,34
8169,0,0,11,27,38
8170,0,0,4,10,14
8171,0,0,17,32,49
8172,0,0,10,5,15
8173,0,0,4,1,5
8174,0,0,8,5,13
8175,0,0,6,9,15
8177,0,0,3,10,13
8178,0,0,9,12,21
8179,0,0,3,4,7
8180,0,0,3,9,12
8181,0,0,2,16,18
8182,0,0,7,8,15
8183,0,0,3,17,20
8184,0,1,7,18,26
8185,0,0,4,7,11
8186,0,0,4,7,11
8187,0,3,7,12,22
8188,0,0,12,10,22
8189,0,0,4,8,12
8190,0,1,9,21,31
8191,0,5,10,35,50
8192,0,1,12,32,45
8193,0,1,7,7,15
8194,0,1,2,22,25
8195,0,0,1,3,4
8196,0,0,3,14,17
8197,0,0,12,21,33
8198,0,1,2,8,11
8199,0,0,13,33,46
8200,0,0,4,9,13
8201,0,1,4,5,10
8202,1,0,7,7,15
8203,0,0,1,5,6
8204,0,0,4,2,6
8205,0,0,3,7,10
8206,0,0,8,6,14
8207,0,1,9,13,23
8208,0,0,4,6,10
8209,0,1,9,16,26
8210,3,0,5,8,16
8211,0,0,5,9,14
8212,0,1,18,20,39
8213,0,0,1,5,6
8214,0,0,4,29,33
8215,0,0,6,11,17
8216,0,0,5,14,19
8217,0,0,4,10,14
8219,0,3,14,28,45
8220,0,0,8,6,14
8221,0,5,6,20,31
8222,1,1,15,26,43
8223,0,0,10,5,15
8224,0,0,4,3,7
8225,0,0,3,10,13
8226,0,0,3,6,9
8227,0,0,4,8,12
8228,0,0,0,5,5
8229,0,1,12,37,50
8230,0,0,10,23,33
8231,0,0,5,9,14
8232,0,0,0,2,2
8233,0,0,12,34,46
8234,0,0,6,4,10
8235,0,0,7,15,22
8236,0,0,8,23,31
8237,0,0,2,5,7
8238,2,0,4,13,19
8239,0,0,0,1,1
8240,0,0,4,11,15
8241,0,0,0,5,5
8242,0,1,5,14,20
8243,0,1,3,11,15
8244,0,0,7,6,13
8245,1,0,8,9,18
8247,0,2,4,23,29
8248,0,0,3,4,7
8250,0,0,7,12,19
8251,0,0,0,5,5
8253,0,0,7,16,23
8254,0,0,10,40,50
8255,0,3,5,19,27
8256,0,1,11,36,48
8257,0,0,12,3,15
8258,0,0,2,12,14
8259,0,0,10,28,38
8260,0,0,3,6,9
8262,0,0,4,12,16
8263,0,0,2,5,7
8264,1,0,4,9,14
8265,0,0,14,18,32
8266,0,1,8,10,19
8267,2,0,10,37,49
8268,0,0,8,9,17
8269,0,0,5,13,18
8270,0,0,0,9,9
8271,0,0,9,14,23
8272,0,0,10,9,19
8273,0,2,5,15,22
8274,0,0,3,18,21
8275,0,0,10,22,32
8276,0,4,1,14,19
8277,0,1,5,32,38
8278,0,0,11,7,18
8279,0,2,17,27,46
8280,0,0,8,31,39
8281,2,0,4,13,19
8282,0,3,4,23,30
8283,0,0,12,17,29
8284,0,0,4,3,7
8285,0,1,19,28,48
8286,0,0,10,6,16
8287,0,0,7,11,18
8288,0,0,7,8,15
8289,1,0,7,30,38
8290,0,0,5,9,14
8291,0,0,0,9,9
8293,0,0,3,6,9
8294,6,0,4,32,42
8295,0,0,17,22,39
8296,0,1,10,17,28
8297,0,0,7,9,16
8298,0,0,8,24,32
8299,0,0,16,15,31
8300,0,0,4,12,16
8301,0,0,6,16,22
8302,0,0,6,11,17
8304,0,3,13,30,46
8305,0,0,11,39,50
8306,0,1,7,27,35
8307,0,2,8,19,29
8308,0,0,17,21,38
8309,0,1,8,35,44
8310,0,0,6,11,17
8311,0,0,16,28,44
8313,0,0,9,17,26
8314,0,0,11,11,22
8315,0,1,4,16,21
8316,0,0,9,22,31
8317,0,0,11,34,45
8318,1,0,13,24,38
8319,0,0,14,34,48
8320,0,0,7,21,28
8321,0,0,5,17,22
8322,0,0,11,26,37
8323,0,0,6,28,34
8324,3,0,1,15,19
8325,0,0,12,9,21
8326,0,1,18,18,37
8327,0,0,4,17,21
8328,0,0,0,1,1
8330,0,1,1,26,28
8331,0,0,0,10,10
8332,0,0,0,5,5
8333,0,0,5,5,10
8334,1,0,6,13,20
8335,1,1,15,26,43
8336,0,0,0,1,1
8337,1,1,3,23,28
8338,0,2,4,23,29
8339,3,0,5,8,16
8340,0,0,10,33,43
8341,0,0,7,12,19
8342,0,1,12,24,37
8343,0,0,0,5,5
8344,0,1,5,32,38
8345,1,0,8,15,24
8346,0,1,6,18,25
8347,0,0,11,20,31
8349,0,0,2,5,7
8350,0,2,8,19,29
8351,0,0,9,14,23
8352,1,0,15,32,48
8353,7,1,3,30,41
8354,0,2,14,34,50
8355,0,0,0,1,1
8356,0,0,9,16,25
8357,0,0,0,1,1
8358,0,0,0,5,5
8359,0,0,0,1,1
8360,0,0,9,16,25
8361,0,1,3,11,15
8362,1,1,3,23,28
8363,0,0,0,5,5
8365,0,0,0,5,5
8366,0,0,0,1,1
8367,0,0,5,6,11
8368,0,0,1,4,5
8369,0,2,6,21,29
8370,0,0,11,23,34
8371,0,0,14,25,39
8372,0,1,19,30,50
8373,1,0,8,41,50
8374,0,0,12,16,28
8375,0,0,5,4,9
8376,2,1,3,44,50
8377,1,0,8,18,27
8378,0,1,10,22,33
8379,0,0,7,7,14
8380,0,0,2,1,3
8381,0,0,10,8,18
8382,0,3,16,30,49
8383,0,0,6,16,22
8384,0,0,12,14,26
8386,0,0,7,4,11
8387,0,0,9,10,19
8388,0,0,8,9,17
8390,0,0,7,8,15
8391,0,0,4,19,23
8392,0,0,6,9,15
8393,0,0,6,4,10
8394,0,2,3,13,18
8395,0,1,20,22,43
8396,0,0,3,6,9
8397,0,0,15,24,39
8399,0,0,9,10,19
8401,0,0,4,6,10
8402,0,1,2,19,22
8403,0,0,5,1,6
8404,0,0,7,11,18
8406,0,0,4,0,4
8407,1,0,4,23,28
8408,0,0,4,10,14
8409,1,1,15,33,50
8410,0,0,2,14,16
8411,0,2,7,13,22
8412,0,0,7,7,14
8413,0,0,7,12,19
8414,0,0,7,10,17
8415,0,0,1,4,5
8416,0,0,5,23,28
8417,0,0,11,34,45
8418,1,0,8,18,27
8419,0,0,9,15,24
8420,0,0,17,23,40
8421,0,0,12,14,26
8422,0,1,17,20,38
8423,0,0,4,24,28
8424,0,0,0,5,5
8425,0,0,13,25,38
8426,0,0,10,32,42
8427,0,0,12,38,50
8428,0,0,3,15,18
8429,1,1,3,23,28
8430,1,0,3,4,8
8431,0,0,3,9,12
8432,0,0,4,13,17
8433,0,0,7,13,20
8434,0,0,7,25,32
8435,0,0,13,23,36
8436,0,0,4,7,11
8437,2,1,9,31,43
8438,0,0,7,19,26
8439,0,0,9,8,17
8440,0,0,7,9,16
8441,0,1,13,36,50
8442,0,2,8,20,30
8443,0,0,10,33,43
8444,0,0,1,11,12
8445,0,0,9,14,23
8446,0,0,3,11,14
8447,0,0,14,16,30
8448,0,2,3,13,18
8449,0,0,17,27,44
8450,0,0,14,27,41
8451,0,0,4,7,11
8452,0,0,2,3,5
8453,0,1,15,29,45
8454,1,0,8,19,28
8455,0,0,6,5,11
8456,0,0,11,13,24
8457,0,0,7,8,15
8458,0,0,13,37,50
8459,0,0,11,28,39
8460,0,0,2,14,16
8461,0,0,18,22,40
8462,0,0,6,6,12
8463,0,0,15,20,35
8464,1,0,12,21,34
8465,0,0,5,1,6
8466,0,1,10,10,21
8467,0,1,0,26,27
8468,0,2,7,13,22
8469,1,1,15,33,50
8470,0,0,7,12,19
8471,0,0,1,4,5
8472,0,0,13,23,36
8473,0,2,7,13,22
8475,0,2,2,10,14
8476,0,0,1,4,5
8477,1,1,3,23,28
8478,0,0,7,9,16
8479,0,0,0,5,5
8480,0,1,4,14,19
8481,0,0,1,4,5
8482,0,0,8,5,13
8483,0,1,4,5,10
8484,0,0,3,6,9
8485,0,0,9,23,32
8486,0,0,3,4,7
8488,0,1,3,3,7
8489,0,0,14,23,37
8490,1,1,7,14,23
8491,0,1,17,29,47
8492,0,0,4,13,17
8493,1,0,9,20,30
8494,0,0,5,9,14
8495,0,0,15,14,29
8496,0,0,11,18,29
8497,0,2,9,13,24
8498,1,0,16,25,42
8499,0,0,9,12,21
8500,0,1,17,32,50
8501,0,0,12,12,24
8502,0,0,16,34,50
8503,0,0,8,11,19
8504,0,0,8,12,20
8505,0,0,2,14,16
8506,1,1,7,33,42
8507,0,0,11,10,21
8509,0,0,21,29,50
8510,0,0,8,10,18
8511,0,0,10,11,21
8512,0,1,8,11,20
8513,0,0,9,33,42
8514,0,0,5,12,17
8515,0,0,7,43,50
8516,0,0,9,8,17
8517,0,1,8,13,22
8518,2,0,4,13,19
8519,0,0,3,13,16
8520,0,0,4,14,18
8521,0,0,7,4,11
8522,0,0,2,22,24
8523,0,0,6,12,18
8524,0,0,9,25,34
8525,0,0,12,14,26
8526,0,0,6,5,11
8527,0,1,17,30,48
8528,0,0,11,20,31
8529,0,0,12,11,23
8530,0,0,10,37,47
8531,0,0,3,6,9
8532,0,0,14,26,40
8533,0,1,2,27,30
8534,0,1,13,14,28
8535,0,1,6,16,23
8536,0,0,12,6,18
8537,0,0,1,1,2
8538,0,0,6,11,17
8539,0,0,4,8,12
8540,0,0,2,10,12
8541,0,0,19,31,50
8542,0,0,2,8,10
8543,0,0,5,2,7
8544,0,0,8,31,39
8545,0,0,6,17,23
8546,0,0,2,3,5
8547,0,0,11,8,19
8548,0,2,8,13,23
8549,0,0,6,3,9
8550,0,0,5,8,13
8551,0,0,3,7,10
8552,0,0,8,13,21
8553,0,0,1,10,11
8554,0,0,11,3,14
8556,0,0,6,5,11
8557,0,0,9,14,23
8558,0,0,2,6,8
8559,0,1,0,4,5
8560,0,1,1,21,23
8561,0,0,5,9,14
8562,0,1,14,9,24
8563,0,0,11,23,34
8564,0,0,6,4,10
8565,0,0,3,14,17
8566,0,0,3,11,14
8567,0,0,13,16,29
8568,0,0,6,1,7
8569,0,0,10,16,26
8570,0,0,9,16,25
8571,0,0,7,4,11
8572,0,0,10,14,24
8573,0,0,13,24,37
8574,0,0,3,14,17
8575,0,0,5,2,7
8576,1,1,8,14,24
8577,0,0,7,6,13
8578,0,0,7,8,15
8579,0,0,13,14,27
8580,0,0,5,1,6
8581,2,0,5,19,26
8582,0,0,11,7,18
8583,0,0,5,25,30
8584,0,1,9,8,18
8585,0,1,4,12,17
8586,0,0,5,15,20
8587,0,0,7,13,20
8588,0,0,5,10,15
8589,0,0,6,10,16
8590,0,0,5,13,18
8591,0,0,8,24,32
8592,0,0,6,16,22
8593,0,0,5,4,9
8594,0,0,7,9,16
8595,0,0,5,8,13
8596,0,1,4,5,10
8597,0,0,18,21,39
8599,0,2,8,19,29
8600,1,0,4,7,12
8601,0,0,6,3,9
8602,0,0,10,28,38
8603,0,0,12,15,27
8604,0,1,9,10,20
8605,0,0,9,18,27
8606,0,0,7,22,29
8607,0,0,10,9,19
8608,0,0,8,14,22
8609,0,0,10,23,33
8610,0,0,10,13,23
8611,0,0,15,35,50
8612,0,0,6,3,9
8613,0,0,15,17,32
8614,0,1,5,14,20
8615,0,1,0,7,8
8616,0,0,6,9,15
8617,0,0,6,20,26
8618,0,0,15,12,27
8619,0,0,6,15,21
8620,0,1,6,15,22
8621,0,0,14,22,36
8622,0,0,15,33,48
8623,0,0,5,6,11
8624,0,0,5,22,27
8625,0,0,4,10,14
8626,0,0,10,21,31
8627,0,0,7,9,16
8628,0,0,14,27,41
8629,0,0,2,6,8
8630,0,0,16,33,49
8631,0,1,16,21,38
8632,0,0,8,6,14
8633,0,2,5,10,17
8634,0,0,9,17,26
8635,0,0,15,26,41
8636,0,0,7,15,22
8637,0,1,11,23,35
8638,0,0,7,7,14
8639,1,0,1,4,6
8640,0,0,10,7,17
8641,0,0,4,9,13
8642,0,0,2,1,3
8643,0,0,14,25,39
8644,0,0,7,6,13
8645,0,0,4,8,12
8646,0,0,3,2,5
8647,0,0,10,14,24
8649,0,0,11,8,19
8650,0,0,9,17,26
8651,2,2,6,22,32
8652,1,0,6,26,33
8653,0,1,19,29,49
8654,0,0,2,5,7
8655,0,1,4,9,14
8656,0,0,8,23,31
8657,0,1,13,16,30
8658,0,1,4,5,10
8659,0,0,6,2,8
8660,0,0,12,16,28
8661,0,0,8,18,26
8662,0,0,4,12,16
8663,0,1,7,36,44
8664,1,0,8,22,31
8665,0,1,4,14,19
8666,0,0,1,4,5
8667,1,2,2,4,9
8668,0,0,3,7,10
8669,0,0,9,4,13
8670,0,0,5,6,11
8671,0,0,8,19,27
8672,0,0,0,4,4
8673,0,1,14,30,45
8674,0,0,6,17,23
8675,0,0,18,28,46
8676,0,0,2,6,8
8677,0,0,9,11,20
8678,0,0,4,9,13
8681,0,0,4,11,15
8682,0,0,5,1,6
8683,0,0,0,5,5
8684,0,0,10,24,34
8685,0,0,9,23,32
8686,0,2,10,14,26
8687,0,0,2,3,5
8689,0,0,5,7,12
8690,0,2,12,19,33
8691,0,0,8,5,13
8692,0,0,7,30,37
8693,1,1,15,33,50
8694,1,1,14,32,48
8698,0,0,7,10,17
8699,0,0,3,4,7
8700,0,1,6,12,19
8701,8,1,4,31,44
8702,0,0,7,8,15
8703,0,0,1,4,5
8704,4,3,6,32,45
8705,0,0,11,20,31
8706,0,0,15,25,40
8707,0,0,1,12,13
8708,1,1,5,24,31
8709,0,0,7,6,13
8710,0,1,17,29,47
8711,0,1,12,32,45
8712,0,0,8,32,40
8713,0,0,5,9,14
8714,0,0,5,12,17
8715,1,0,8,39,48
8716,0,1,16,33,50
8717,0,0,8,12,20
8718,1,0,4,14,19
8719,0,0,9,16,25
8720,0,0,16,34,50
8721,0,0,4,5,9
8722,0,0,10,33,43
8724,0,0,14,29,43
8725,0,0,11,9,20
8726,1,0,11,37,49
8727,0,0,10,31,41
8728,0,0,9,8,17
8729,0,0,7,14,21
8730,0,2,17,27,46
8731,0,5,3,40,48
8733,0,0,18,16,34
8734,0,0,16,17,33
8735,0,0,6,31,37
8736,0,0,8,14,22
8737,0,0,16,28,44
8738,0,0,16,28,44
8739,5,1,10,18,34
8740,0,0,11,31,42
8741,0,1,11,28,40
8742,0,0,7,9,16
8743,0,0,9,14,23
8744,0,0,5,1,6
8745,0,0,13,29,42
8746,0,0,5,11,16
8747,0,0,15,35,50
8748,0,0,3,8,11
8749,0,0,6,4,10
8750,0,0,10,27,37
8751,0,2,13,35,50
8752,0,0,8,9,17
8753,0,1,12,20,33
8754,0,0,8,4,12
8755,0,0,12,12,24
8756,1,1,14,32,48
8757,0,0,8,13,21
8758,0,0,6,10,16
8759,0,0,12,15,27
8760,0,0,3,7,10
8761,0,0,6,33,39
8762,0,0,5,13,18
8764,0,0,6,2,8
8765,0,0,7,15,22
8766,0,0,10,33,43
8767,0,0,12,15,27
8768,0,0,11,14,25
8769,0,0,1,7,8
8770,0,0,5,12,17
8771,0,0,10,22,32
8772,0,0,7,4,11
8773,0,0,1,5,6
8774,1,2,17,30,50
8775,0,1,16,33,50
8776,0,1,9,21,31
8777,0,0,13,37,50
8778,0,0,2,22,24
8779,0,2,7,28,37
8780,0,0,5,10,15
8781,0,0,0,1,1
8782,0,0,1,5,6
8783,0,0,6,14,20
8784,0,0,7,16,23
8785,0,0,7,26,33
8786,0,0,9,32,41
8787,0,0,8,19,27
8788,0,0,3,1,4
8789,0,0,5,16,21
8790,0,0,6,12,18
8791,1,0,9,34,44
8792,0,0,10,5,15
8793,0,0,8,37,45
8794,0,2,15,23,40
8795,0,0,10,20,30
8796,0,1,10,13,24
8797,0,0,23,27,50
8798,0,0,8,12,20
8799,0,1,12,26,39
8800,0,0,3,12,15
8801,0,0,6,25,31
8802,0,1,6,12,19
8803,0,0,10,10,20
8804,0,0,11,13,24
8805,1,1,16,32,50
8806,0,0,8,3,11
8808,0,0,6,18,24
8809,0,0,6,13,19
8810,0,0,7,10,17
8811,0,0,11,7,18
8812,0,0,11,18,29
8813,0,0,0,8,8
8814,1,1,15,33,50
8815,0,0,11,24,35
8816,0,0,2,14,16
8817,8,1,4,31,44
8818,2,0,4,13,19
8819,0,0,1,4,5
8820,2,1,4,18,25
8822,0,0,8,10,18
8823,0,0,10,33,43
8824,1,3,10,27,41
8825,1,0,9,19,29
8826,0,1,8,38,47
8827,0,1,11,28,40
8828,0,0,5,12,17
8829,0,0,2,22,24
8830,0,0,0,1,1
8831,0,0,7,8,15
8832,0,0,12,38,50
8833,0,0,1,5,6
8834,1,1,11,35,48
8835,0,0,7,10,17
8836,1,1,9,10,21
8837,0,0,2,9,11
8838,0,0,0,5,5
8840,0,0,12,33,45
8841,0,0,1,4,5
8842,8,1,4,31,44
8843,2,1,4,18,25
8844,8,1,4,31,44
8845,0,0,7,10,17
8846,2,1,4,18,25
8847,0,0,15,17,32
8848,0,0,5,7,12
8849,8,1,4,31,44
8850,0,1,8,10,19
8851,1,0,15,16,32
8852,0,0,4,1,5
8853,0,0,6,6,12
8854,0,0,13,28,41
8855,0,2,11,16,29
8856,0,0,4,16,20
8857,0,0,8,9,17
8858,0,0,12,11,23
8859,0,0,4,7,11
8860,0,0,4,10,14
8861,0,2,5,21,28
8862,0,0,10,29,39
8863,0,0,10,39,49
8864,0,0,1,4,5
8865,0,0,5,11,16
8866,0,2,3,17,22
8867,0,0,1,4,5
8868,0,0,7,8,15
8869,0,1,2,8,11
8870,0,2,10,9,21
8871,0,1,6,8,15
8872,0,0,0,8,8
8874,0,0,2,12,14
8875,0,2,7,41,50
8876,0,0,6,10,16
8877,0,0,11,5,16
8878,1,2,13,32,48
8879,0,0,6,17,23
8880,0,0,2,3,5
8881,0,1,5,18,24
8882,0,0,10,15,25
8883,0,0,1,6,7
8884,0,0,6,12,18
8885,0,1,14,32,47
8886,0,0,9,17,26
8887,0,1,5,23,29
8888,0,1,3,6,10
8889,0,0,3,13,16
8890,0,0,2,8,10
8891,0,0,5,6,11
8892,0,0,6,15,21
8893,0,0,2,4,6
8894,0,1,0,8,9
8895,0,0,12,16,28
8896,0,0,6,22,28
8897,0,1,8,18,27
8898,0,1,8,21,30
8899,0,0,7,11,18
8900,0,0,8,10,18
8901,0,0,9,12,21
8902,0,0,5,10,15
8903,0,0,10,14,24
8904,0,0,7,4,11
8905,1,0,10,25,36
8906,0,0,11,19,30
8907,0,0,1,7,8
8908,0,2,7,14,23
8909,0,0,10,10,20
8910,0,0,8,10,18
8911,0,1,9,10,20
8912,0,0,4,3,7
8913,0,0,4,1,5
8914,0,0,6,5,11
8915,0,1,2,16,19
8916,0,0,1,5,6
8917,0,0,5,2,7
8918,0,0,9,15,24
8919,0,0,12,16,28
8920,0,0,11,5,16
8921,0,0,9,17,26
8922,0,2,3,6,11
8923,0,0,1,2,3
8924,0,0,7,22,29
8925,0,0,11,6,17
8926,0,1,8,14,23
8927,0,0,8,10,18
8928,0,2,8,10,20
8929,0,0,19,31,50
8930,0,0,4,7,11
8931,0,0,3,0,3
8933,0,0,12,4,16
8934,0,5,14,29,48
8935,0,0,10,6,16
8936,0,2,9,39,50
8937,0,0,2,10,12
8938,0,0,4,1,5
8939,0,0,5,15,20
8940,0,0,2,3,5
8941,0,0,10,24,34
8942,0,0,2,2,4
8943,0,0,7,5,12
8944,0,0,6,4,10
8945,0,0,2,31,33
8946,0,1,2,6,9
8947,0,0,5,11,16
8948,0,2,4,5,11
8949,0,0,3,9,12
8950,0,0,6,0,6
8951,0,0,6,30,36
8952,0,0,2,17,19
8953,0,1,8,10,19
8954,0,0,18,25,43
8955,0,1,8,16,25
8956,0,0,7,6,13
8957,0,0,8,8,16
8958,0,0,5,13,18
8959,0,0,1,4,5
8960,1,0,5,7,13
8961,0,0,4,3,7
8962,0,0,3,5,8
8963,2,0,4,13,19
8964,0,6,4,40,50
8965,0,0,4,13,17
8966,0,0,1,2,3
8967,0,0,3,11,14
8968,0,0,3,1,4
8969,0,0,5,6,11
8971,0,0,5,6,11
8972,0,0,7,4,11
8973,0,1,8,14,23
8974,0,0,6,23,29
8975,0,0,4,4,8
8977,2,0,6,24,32
8978,0,0,1,0,1
8979,0,0,3,9,12
8980,0,0,13,11,24
8981,0,0,8,14,22
8982,0,0,6,2,8
8983,0,0,3,5,8
8984,0,2,14,19,35
8985,0,0,5,13,18
8986,0,0,4,23,27
8987,0,1,5,3,9
8988,1,0,1,11,13
8989,0,0,3,9,12
8990,0,0,5,8,13
8991,0,1,15,21,37
8992,0,0,6,4,10
8993,0,0,6,3,9
8994,0,3,15,30,48
8995,0,1,0,22,23
8996,0,0,5,8,13
8997,0,1,4,7,12
8998,0,3,2,14,19
8999,0,0,1,4,5
9000,0,0,1,6,7
9001,0,0,8,16,24
9002,0,0,2,19,21
9003,0,2,3,18,23
9004,0,0,3,10,13
9005,0,0,2,14,16
9006,0,0,6,14,20
9007,0,0,6,8,14
9008,0,0,7,23,30
9009,1,0,5,11,17
9010,0,3,4,13,20
9011,0,0,2,19,21
9012,1,0,15,16,32
9013,0,0,10,23,33
9014,0,0,5,16,21
9015,0,0,5,11,16
9016,0,0,3,14,17
9017,0,0,3,6,9
9018,0,0,10,7,17
9019,0,1,9,17,27
9020,0,1,13,23,37
9022,0,0,13,17,30
9023,0,0,6,3,9
9024,0,0,0,10,10
9025,0,0,2,4,6
9026,0,0,13,35,48
9028,0,0,10,40,50
9029,0,0,6,10,16
9031,0,1,8,30,39
9032,0,1,4,15,20
9033,0,2,2,16,20
9034,0,1,3,5,9
9035,0,0,7,10,17
9036,0,1,5,4,10
9037,0,1,9,13,23
9038,0,0,11,12,23
9039,0,0,16,29,45
9040,0,0,9,24,33
9041,0,1,7,2,10
9042,0,0,2,6,8
9043,0,0,8,14,22
9044,0,1,0,22,23
9046,0,0,2,9,11
9048,0,2,3,9,14
9049,2,0,8,13,23
9050,1,0,15,19,35
9051,4,2,2,29,37
9052,0,0,12,13,25
9053,0,0,7,11,18
9054,0,2,2,35,39
9055,0,1,6,5,12
9056,0,0,4,10,14
9057,0,0,9,20,29
9058,0,0,7,12,19
9059,0,0,6,5,11
9060,0,3,10,35,48
9061,0,1,8,12,21
9062,0,1,7,37,45
9063,1,0,12,24,37
9064,0,0,8,23,31
9065,0,0,12,18,30
9066,0,1,4,17,22
9067,1,1,2,15,19
9068,0,0,9,17,26
9069,0,0,2,19,21
9070,0,0,13,15,28
9071,0,1,2,7,10
9072,0,0,6,17,23
9073,0,0,1,7,8
9074,0,0,1,5,6
9075,0,0,9,15,24
9076,0,0,3,1,4
9077,1,0,7,30,38
9078,1,0,1,11,13
9079,0,3,15,30,48
9080,2,0,3,26,31
9081,0,0,2,12,14
9082,0,0,10,39,49
9083,4,2,2,29,37
9084,0,0,1,5,6
9085,0,0,14,36,50
9086,0,0,6,28,34
9087,0,0,9,17,26
9088,0,0,8,9,17
9089,0,0,4,7,11
9090,0,1,11,13,25
9091,0,0,3,1,4
9092,0,0,19,13,32
9093,0,1,8,32,41
9094,0,1,3,4,8
9095,0,0,10,19,29
9096,0,0,4,5,9
9097,0,0,4,16,20
9098,0,0,5,21,26
9099,0,1,19,30,50
9100,0,0,9,14,23
9101,0,0,0,8,8
9102,0,0,5,7,12
9103,0,0,3,7,10
9105,0,1,17,31,49
9106,0,3,7,33,43
9107,0,0,7,11,18
9108,0,1,11,33,45
9109,0,0,6,7,13
9110,0,0,6,13,19
9111,0,0,5,15,20
9112,0,0,4,8,12
9113,0,0,5,11,16
9115,0,1,13,19,33
9116,0,0,9,13,22
9117,1,0,8,25,34
9118,0,0,9,15,24
9119,0,1,5,37,43
9120,0,0,7,18,25
9121,0,1,3,39,43
9122,0,0,9,17,26
9123,0,0,7,11,18
9124,0,0,6,12,18
9125,1,0,4,11,16
9126,0,2,16,24,42
9127,0,0,12,14,26
9128,6,1,2,28,37
9129,0,0,5,5,10
9131,0,0,7,10,17
9133,0,0,6,4,10
9134,0,0,5,5,10
9135,0,1,8,19,28
9136,0,0,8,11,19
9137,0,1,13,26,40
9139,0,0,3,5,8
9140,0,0,6,5,11
9141,0,0,6,2,8
9142,0,0,5,18,23
9143,0,0,12,7,19
9144,0,0,4,1,5
9145,0,0,14,17,31
9146,0,1,2,3,6
9147,0,1,16,33,50
9148,0,0,10,21,31
9149,1,0,11,7,19
9150,0,0,4,7,11
9151,0,0,9,13,22
9152,0,0,9,14,23
9153,0,1,15,25,41
9154,0,0,10,34,44
9155,1,4,10,27,42
9156,0,0,13,29,42
9157,1,0,15,16,32
9158,0,0,14,34,48
9159,0,0,10,12,22
9160,0,0,6,23,29
9161,0,0,8,10,18
9162,0,0,6,17,23
9163,0,0,2,5,7
9164,0,0,18,27,45
9165,0,0,4,1,5
9166,0,1,13,16,30
9168,0,4,15,19,38
9169,0,0,14,19,33
9170,0,2,6,12,20
9171,2,1,3,19,25
9172,0,0,2,13,15
9173,1,3,11,20,35
9174,0,0,6,14,20
9175,0,0,2,6,8
9176,0,0,6,7,13
9177,0,0,6,7,13
9178,1,1,4,10,16
9179,0,0,5,3,8
9180,0,0,0,8,8
9181,0,1,0,22,23
9182,0,0,6,8,14
9183,0,0,8,22,30
9184,0,0,3,5,8
9186,0,0,9,40,49
9187,0,0,2,11,13
9188,1,0,4,8,13
9189,0,0,10,15,25
9190,0,1,11,17,29
9191,0,0,4,23,27
9192,0,0,4,0,4
9193,0,0,4,16,20
9194,0,0,3,7,10
9195,3,0,5,5,13
9196,0,0,17,16,33
9197,0,0,10,22,32
9198,0,0,7,8,15
9199,0,1,8,32,41
9200,0,0,1,4,5
9201,0,3,7,18,28
9202,0,0,7,14,21
9203,1,0,12,7,20
9204,0,0,6,3,9
9205,0,0,10,12,22
9206,4,0,3,17,24
9207,1,1,12,33,47
9209,0,0,8,8,16
9210,0,0,8,3,11
9211,0,0,2,10,12
9212,0,0,5,9,14
9213,0,0,11,24,35
9214,0,1,10,23,34
9215,0,0,9,12,21
9216,1,0,3,17,21
9217,0,0,6,12,18
9218,0,0,6,12,18
9219,0,0,4,6,10
9220,0,0,5,6,11
9221,0,1,10,31,42
9222,0,0,17,28,45
9223,1,0,5,14,20
9224,0,0,12,20,32
9225,0,1,17,22,40
9226,0,0,2,8,10
9227,0,0,8,8,16
9228,0,0,8,28,36
9229,0,1,9,23,33
9230,0,0,8,16,24
9231,0,0,5,4,9
9232,0,0,4,2,6
9233,0,0,3,13,16
9234,4,0,0,2,6
9235,0,0,12,20,32
9236,0,0,14,20,34
9237,0,0,12,16,28
9238,0,0,6,4,10
9239,0,0,12,34,46
9240,0,0,2,12,14
9241,0,0,9,18,27
9243,0,0,5,15,20
9244,0,0,0,5,5
9245,0,2,7,11,20
9247,0,0,2,6,8
9248,0,0,1,9,10
9249,1,0,6,17,24
9250,0,0,8,7,15
9251,0,0,0,5,5
9253,0,2,6,8,16
9254,0,0,1,3,4
9255,1,1,1,10,13
9256,0,0,8,14,22
9257,0,1,3,2,6
9258,0,1,10,39,50
9259,0,0,13,23,36
9260,2,1,4,23,30
9261,0,0,19,31,50
9262,0,1,12,37,50
9263,0,0,10,19,29
9264,1,0,6,17,24
9265,0,0,8,17,25
9266,0,0,2,10,12
9267,0,0,5,10,15
9268,1,3,4,27,35
9269,0,0,4,25,29
9270,0,1,9,30,40
9271,0,0,13,37,50
9272,0,0,11,32,43
9273,0,0,18,24,42
9275,0,0,11,20,31
9276,1,1,6,41,49
9277,0,0,13,12,25
9278,0,2,6,9,17
9279,0,0,4,21,25
9280,5,0,3,36,44
9281,0,0,9,19,28
9282,0,0,10,25,35
9283,0,2,14,34,50
9284,0,0,8,37,45
9285,0,1,13,19,33
9286,0,0,5,13,18
9287,0,0,7,16,23
9288,0,0,11,24,35
9289,0,0,8,18,26
9290,1,0,9,37,47
9291,0,0,7,15,22
9292,0,0,8,6,14
9293,0,0,12,32,44
9294,2,0,7,26,35
9295,0,1,9,12,22
9296,0,0,6,17,23
9297,0,0,13,37,50
9298,0,0,10,14,24
9299,0,0,14,27,41
9300,0,0,2,3,5
9301,0,0,5,12,17
9302,0,0,13,21,34
9303,3,1,4,13,21
9304,0,0,4,9,13
9305,0,0,2,11,13
9306,0,0,8,32,40
9307,0,0,11,21,32
9308,0,0,2,8,10
9309,0,0,11,12,23
9310,0,0,13,30,43
9311,0,0,1,20,21
9312,0,0,12,29,41
9313,3,0,5,5,13
9314,1,0,2,7,10
9315,0,0,2,8,10
9316,0,1,11,14,26
9318,0,0,15,35,50
9319,0,0,4,5,9
9320,0,0,4,14,18
9321,5,0,3,33,41
9322,0,2,9,33,44
9323,0,0,2,9,11
9324,0,1,10,10,21
9325,4,1,2,20,27
9326,0,0,8,20,28
9328,0,0,7,14,21
9329,1,0,2,12,15
9330,0,3,3,19,25
9331,0,0,12,30,42
9332,0,0,3,6,9
9333,0,0,5,8,13
9335,0,0,0,7,7
9336,0,0,10,6,16
9338,0,2,7,11,20
9339,0,0,20,30,50
9340,1,4,10,27,42
9341,0,1,0,22,23
9342,0,0,2,3,5
9343,0,0,3,10,13
9344,0,0,5,11,16
9345,4,0,0,2,6
9346,1,0,3,15,19
9347,0,0,3,26,29
9348,3,1,4,13,21
9349,1,0,14,35,50
9350,1,0,9,25,35
9351,0,0,5,13,18
9352,0,0,5,22,27
9354,5,0,3,36,44
9355,0,0,1,1,2
9356,0,0,11,34,45
9357,1,0,2,22,25
9358,0,3,3,19,25
9359,3,1,7,20,31
9360,0,0,9,20,29
9361,0,0,8,14,22
9363,1,1,1,10,13
9364,3,0,7,22,32
9365,0,0,14,17,31
9366,2,0,10,20,32
9367,0,0,7,8,15
9368,1,0,2,12,15
9369,1,1,8,22,32
9370,1,1,4,18,24
9371,0,0,8,29,37
9372,2,0,10,20,32
9373,1,0,14,35,50
9374,1,0,9,25,35
9375,0,0,7,16,23
9376,1,0,11,16,28
9377,1,0,0,11,12
9378,2,0,10,20,32
9379,1,1,8,22,32
9380,0,0,0,5,5
9381,0,0,0,5,5
9382,0,0,19,31,50
9383,1,0,6,17,24
9384,0,0,0,5,5
9385,0,2,7,11,20
9386,1,0,9,25,35
9387,0,0,2,15,17
9388,2,0,4,11,17
9389,0,0,17,33,50
9390,0,2,15,16,33
9391,0,0,10,18,28
9392,2,1,20,26,49
9393,0,1,3,1,5
9394,0,0,19,27,46
9395,2,1,5,42,50
9396,0,0,19,27,46
9397,2,1,5,42,50
9398,0,0,2,15,17
9399,0,1,12,35,48
9400,0,2,7,39,48
9401,0,1,12,35,48
9402,2,1,5,42,50
9403,2,1,5,42,50
9404,0,0,10,18,28
9405,0,2,7,39,48
9406,0,0,6,9,15
9407,0,1,12,35,48
9408,0,0,10,18,28
9409,0,0,19,27,46
9410,2,1,5,42,50
9411,1,0,7,42,50
9412,0,1,11,9,21
9413,1,1,10,36,48
9414,0,0,2,5,7
9415,0,0,1,4,5
9416,0,1,2,7,10
9417,0,0,4,19,23
9418,0,0,3,5,8
9419,0,0,3,5,8
9420,0,0,2,9,11
9421,0,7,5,17,29
9422,0,0,6,8,14
9423,0,1,5,11,17
9424,4,0,0,5,9
9425,0,0,4,6,10
9426,0,0,10,12,22
9427,0,0,2,8,10
9428,0,0,19,27,46
9429,0,2,6,19,27
9430,0,0,7,22,29
9431,0,1,8,17,26
9432,0,0,3,2,5
9433,0,0,8,12,20
9434,0,0,6,10,16
9435,0,1,7,19,27
9436,1,0,4,7,12
9437,0,0,8,27,35
9438,0,0,7,18,25
9439,1,1,12,36,50
9440,0,0,4,19,23
9441,0,0,12,15,27
9442,0,0,5,12,17
9443,0,0,5,12,17
9444,0,0,6,7,13
9445,0,1,14,29,44
9446,0,0,1,3,4
9447,0,2,5,13,20
9448,0,1,13,17,31
9449,0,1,5,13,19
9450,0,0,0,1,1
9451,0,0,3,12,15
9452,0,0,4,6,10
9453,1,0,7,15,23
9454,0,1,5,18,24
9455,2,0,8,33,43
9456,0,0,10,7,17
9457,0,0,6,17,23
9458,0,0,8,5,13
9459,0,0,12,18,30
9460,0,0,1,4,5
9461,0,0,10,17,27
9462,0,0,5,3,8
9463,0,0,3,2,5
9464,0,0,2,4,6
9465,0,0,4,5,9
9466,0,0,3,4,7
9467,0,0,5,5,10
9468,0,0,5,13,18
9469,0,0,7,12,19
9470,0,0,5,3,8
9471,0,1,11,9,21
9472,0,0,4,9,13
9473,0,0,4,6,10
9474,0,2,3,9,14
9475,0,0,10,16,26
9476,0,0,0,3,3
9477,0,0,7,21,28
9478,0,0,0,1,1
9479,0,0,5,8,13
9480,0,0,4,2,6
9481,0,0,2,11,13
9482,0,4,9,19,32
9483,0,2,7,12,21
9484,0,1,10,38,49
9485,1,1,0,8,10
9486,0,0,5,3,8
9487,0,0,9,23,32
9488,0,0,14,28,42
9489,0,5,3,2,10
9490,0,0,12,24,36
9491,1,1,4,18,24
9492,0,0,0,5,5
9493,0,0,0,7,7
9494,0,0,0,8,8
9495,0,4,5,11,20
9496,0,2,2,4,8
9497,0,1,8,8,17
9498,0,0,4,11,15
9499,0,1,3,7,11
9500,0,0,1,5,6
9501,0,1,3,8,12
9502,4,0,0,5,9
9503,0,0,2,6,8
9504,0,1,5,11,17
9505,0,1,2,6,9
9506,0,0,1,5,6
9507,0,0,13,9,22
9508,0,0,2,12,14
9509,1,2,2,3,8
9510,0,0,4,17,21
9511,0,0,1,2,3
9512,0,0,5,4,9
9513,0,0,2,5,7
9515,0,2,9,14,25
9516,0,0,14,32,46
9517,1,1,10,36,48
9518,0,3,3,32,38
9519,0,0,11,24,35
9520,0,0,3,2,5
9521,0,0,1,7,8
9522,0,0,5,3,8
9523,0,0,9,18,27
9525,0,0,15,35,50
9526,0,1,2,12,15
9527,3,9,4,34,50
9528,0,1,4,17,22
9529,0,0,4,8,12
9530,0,0,4,3,7
9531,0,0,1,4,5
9532,2,1,5,42,50
9533,0,1,6,27,34
9534,0,0,3,5,8
9535,0,0,6,8,14
9536,1,0,12,34,47
9537,0,1,11,22,34
9538,1,0,7,42,50
9539,0,16,2,18,36
9541,0,0,3,3,6
9542,0,0,5,3,8
9543,0,0,9,14,23
9544,0,0,4,3,7
9545,0,0,19,27,46
9546,0,0,17,24,41
9547,0,0,16,31,47
9548,0,3,3,32,38
9549,1,0,4,16,21
9550,0,0,4,15,19
9551,0,0,7,17,24
9552,0,0,4,19,23
9553,0,1,6,5,12
9554,0,0,13,15,28
9555,0,0,13,30,43
9556,0,0,11,29,40
9557,2,0,8,33,43
9558,0,0,10,21,31
9559,1,1,4,16,22
9560,0,1,2,7,10
9561,0,0,8,12,20
9562,0,0,2,5,7
9563,0,1,2,12,15
9564,0,1,8,19,28
9565,0,0,7,21,28
9566,1,1,0,8,10
9567,0,0,15,35,50
9568,0,0,3,5,8
9569,0,0,1,4,5
9570,0,1,11,9,21
9571,2,1,5,42,50
9572,0,0,0,8,8
9573,1,0,7,42,50
9574,0,7,5,17,29
9575,1,0,12,34,47
9577,0,16,2,18,36
9578,1,0,8,35,44
9579,2,1,5,42,50
9580,0,7,5,17,29
9581,0,1,8,19,28
9582,1,0,13,26,40
9583,0,0,4,8,12
9584,0,7,5,17,29
9585,2,1,5,42,50
9586,0,0,1,17,18
9588,0,0,3,5,8
9589,0,1,2,7,10
9591,0,0,1,4,5
9592,0,0,7,21,28
9594,0,0,10,21,31
9596,0,0,15,35,50
9598,1,0,4,16,21
9599,0,1,2,7,10
9600,0,0,4,15,19
9601,0,1,3,11,15
9602,0,1,4,17,22
9603,0,2,5,5,12
9604,1,1,4,16,22
9605,0,2,4,10,16
9606,4,0,3,23,30
9607,0,0,5,3,8
9608,0,0,6,3,9
9611,1,0,0,4,5
9612,0,2,2,15,19
9613,0,2,9,14,25
9614,0,1,2,12,15
9615,2,0,2,15,19
9616,0,0,7,3,10
9617,0,0,5,12,17
9618,0,0,3,6,9
9619,0,0,19,27,46
9620,0,1,6,5,12
9621,0,0,13,15,28
9622,0,1,6,27,34
9623,0,0,10,17,27
9624,0,0,10,21,31
9625,3,9,4,34,50
9626,0,0,4,8,12
9627,0,0,5,13,18
9628,0,0,13,30,43
9629,0,0,14,32,46
9630,0,0,7,21,28
9631,0,16,2,18,36
9632,0,1,8,19,28
9633,0,1,11,22,34
9634,0,7,5,17,29
9635,2,1,5,42,50
9636,0,0,5,8,13
9640,0,0,4,2,6
9641,0,0,3,2,5
9642,0,0,3,5,8
9643,1,1,10,36,48
9644,0,2,7,10,19
9645,0,0,4,7,11
9646,0,0,4,1,5
9647,0,1,9,9,19
9648,0,0,3,9,12
9649,0,0,3,5,8
9650,0,1,11,9,21
9651,0,1,5,11,17
9652,0,0,1,4,5
9653,0,0,2,6,8
9654,0,1,2,7,10
9655,1,0,6,15,22
9656,0,0,8,24,32
9657,0,1,5,15,21
9658,0,0,1,1,2
9659,0,2,12,8,22
9660,0,1,18,31,50
9661,1,0,7,10,18
9662,1,0,10,17,28
9663,0,1,16,13,30
9664,0,1,10,25,36
9665,0,0,6,1,7
9666,0,1,10,25,36
9667,0,1,1,6,8
9668,0,2,6,17,25
9669,0,1,8,14,23
9670,0,0,5,11,16
9671,0,0,10,11,21
9672,0,1,5,3,9
9673,0,1,4,17,22
9674,0,0,5,3,8
9675,0,0,1,13,14
9676,0,0,3,6,9
9677,0,0,12,24,36
9678,0,1,5,13,19
9679,0,0,14,32,46
9680,0,2,14,22,38
9681,0,0,3,8,11
9682,0,0,8,22,30
9683,0,0,2,9,11
9684,0,0,1,4,5
9685,0,0,2,4,6
9686,0,0,7,16,23
9687,5,0,1,29,35
9688,0,0,2,4,6
9689,0,0,6,2,8
9690,0,2,6,25,33
9691,0,1,9,23,33
9692,0,1,14,25,40
9693,0,0,1,20,21
9694,0,0,13,15,28
9695,0,0,13,25,38
9696,0,1,13,19,33
9697,0,0,0,1,1
9698,0,0,8,9,17
9699,0,0,6,5,11
9700,0,1,12,29,42
9701,0,0,15,32,47
9702,0,0,10,7,17
9703,0,0,8,19,27
9704,0,2,4,20,26
9705,0,0,2,5,7
9706,0,0,9,17,26
9707,0,0,4,8,12
9708,0,0,4,21,25
9709,0,3,6,16,25
9710,0,0,11,9,20
9711,0,0,12,14,26
9712,0,0,3,6,9
9713,0,0,5,8,13
9714,0,0,3,9,12
9715,0,1,6,9,16
9716,0,1,5,19,25
9717,0,0,4,27,31
9718,0,0,1,7,8
9719,1,0,13,36,50
9720,0,0,5,1,6
9721,0,0,8,3,11
9722,0,0,8,19,27
9723,0,1,5,9,15
9724,0,0,4,12,16
9725,0,0,4,6,10
9726,0,0,9,29,38
9727,0,0,5,12,17
9728,0,0,0,9,9
9729,0,0,3,22,25
9730,0,0,12,30,42
9731,0,0,9,11,20
9732,0,0,8,6,14
9734,0,0,3,3,6
9735,0,0,9,6,15
9736,0,0,5,6,11
9737,0,0,6,15,21
9738,0,1,10,32,43
9739,0,1,8,18,27
9740,5,0,7,26,38
9741,0,0,8,18,26
9742,0,1,7,13,21
9743,0,0,4,5,9
9744,0,0,1,5,6
9745,0,1,19,30,50
9746,0,0,10,13,23
9747,0,2,11,14,27
9748,0,0,4,18,22
9749,0,0,3,8,11
9750,0,0,10,27,37
9751,0,1,9,20,30
9752,0,0,4,0,4
9753,0,0,3,24,27
9755,0,0,0,5,5
9756,1,0,11,36,48
9757,0,0,2,1,3
9758,0,0,10,15,25
9759,0,0,4,7,11
9760,0,0,3,15,18
9761,0,0,4,6,10
9762,0,0,4,5,9
9763,0,0,5,13,18
9764,0,0,9,21,30
9765,0,0,3,7,10
9766,0,0,9,4,13
9767,0,0,11,8,19
9768,0,2,16,23,41
9769,0,0,5,6,11
9770,0,2,7,12,21
9771,0,1,3,4,8
9772,0,0,9,6,15
9773,0,1,2,8,11
9775,0,0,4,6,10
9776,0,0,7,8,15
9777,0,1,12,35,48
9778,0,0,1,5,6
9779,0,4,3,8,15
9780,0,0,9,5,14
9781,1,0,13,33,47
9782,0,2,6,17,25
9783,0,0,15,35,50
9784,0,0,7,10,17
9785,1,0,0,8,9
9786,1,0,3,11,15
9787,0,0,8,16,24
9788,0,0,5,12,17
9789,0,0,11,22,33
9790,0,1,2,22,25
9791,0,3,10,10,23
9792,0,0,3,6,9
9793,0,0,6,14,20
9794,0,0,6,6,12
9795,0,1,15,18,34
9796,0,0,5,5,10
9797,0,2,13,35,50
9798,0,0,3,8,11
9799,0,0,4,9,13
9800,0,0,3,3,6
9802,0,0,3,3,6
9803,0,0,4,4,8
9804,1,2,7,8,18
9805,0,0,7,8,15
9806,0,0,0,5,5
9807,2,0,13,34,49
9808,1,0,12,26,39
9809,0,0,11,16,27
9810,0,0,4,4,8
9811,0,0,7,2,9
9812,0,1,9,6,16
9813,0,0,15,29,44
9814,0,0,0,6,6
9815,0,0,19,30,49
9816,0,0,1,5,6
9817,0,0,4,22,26
9818,0,0,9,15,24
9819,0,0,5,5,10
9820,0,0,7,5,12
9822,0,1,9,10,20
9823,0,0,7,12,19
9824,0,0,8,17,25
9825,0,0,2,5,7
9826,0,0,1,8,9
9828,0,0,5,11,16
9829,0,0,3,6,9
9830,1,0,6,6,13
9831,0,1,10,16,27
9832,0,3,16,11,30
9834,0,1,8,5,14
9835,0,1,3,9,13
9836,0,0,0,6,6
9837,0,0,3,8,11
9838,0,0,8,11,19
9839,1,1,7,20,29
9840,0,0,10,18,28
9841,0,0,5,6,11
9842,0,2,6,14,22
9843,1,1,12,22,36
9845,0,0,0,5,5
9846,0,0,1,13,14
9848,0,1,2,3,6
9849,0,1,3,3,7
9850,0,0,5,3,8
9851,0,1,3,8,12
9852,0,0,13,19,32
9855,0,0,14,28,42
9856,0,0,4,9,13
9857,0,0,2,4,6
9858,0,0,5,3,8
9859,0,0,1,7,8
9860,1,0,4,12,17
9861,1,1,10,36,48
9862,0,0,0,3,3
9863,0,0,2,6,8
9864,0,0,5,12,17
9865,1,0,1,4,6
9866,0,0,1,5,6
9867,0,0,7,21,28
9868,0,0,6,4,10
9869,2,0,8,33,43
9870,0,1,11,9,21
9871,0,1,2,12,15
9872,0,0,4,3,7
9873,0,0,0,6,6
9874,0,1,9,9,19
9875,0,1,4,33,38
9877,1,9,3,26,39
9878,2,1,5,42,50
9879,0,0,13,17,30
9880,0,0,1,4,5
9881,0,0,3,5,8
9882,1,1,0,8,10
9883,0,1,5,11,17
9884,0,0,11,20,31
9885,0,5,12,18,35
9886,0,0,5,22,27
9887,0,0,9,20,29
9888,0,0,11,35,46
9889,0,1,9,14,24
9890,0,0,12,24,36
9891,0,1,18,31,50
9892,0,1,10,25,36
9893,0,1,3,19,23
9894,0,0,5,13,18
9895,0,0,3,3,6
9896,0,0,13,13,26
9897,0,0,7,20,27
9898,0,0,2,3,5
9899,0,2,7,16,25
9900,0,0,7,19,26
9901,0,0,14,28,42
9902,0,0,5,3,8
9903,0,0,13,30,43
9904,0,0,14,36,50
9905,0,2,6,6,14
9906,0,0,4,29,33
9907,0,0,10,21,31
9908,2,0,9,20,31
9909,0,0,2,4,6
9910,0,0,11,12,23
9911,0,0,8,14,22
9912,0,0,16,34,50
9913,0,1,9,22,32
9914,0,0,16,9,25
9915,0,0,9,7,16
9916,0,0,10,7,17
9917,1,0,7,30,38
9918,0,0,6,10,16
9919,0,0,14,24,38
9920,0,0,14,26,40
9921,0,4,16,15,35
9922,0,0,6,4,10
9923,1,0,16,24,41
9924,0,0,7,25,32
9925,0,0,8,6,14
9926,0,1,17,29,47
9927,0,0,13,19,32
9928,4,0,11,33,48
9929,0,0,2,12,14
9930,0,1,7,15,23
9931,0,0,7,20,27
9932,0,0,5,6,11
9933,0,0,1,5,6
9934,0,2,9,28,39
9935,0,0,3,11,14
9936,1,1,21,17,40
9937,0,0,2,6,8
9938,0,0,6,14,20
9939,0,3,6,21,30
9940,0,1,6,5,12
9941,0,0,4,15,19
9942,0,0,8,31,39
9943,0,0,7,21,28
9944,0,0,9,6,15
9945,0,0,0,2,2
9946,2,0,7,41,50
9947,1,9,3,26,39
9949,0,1,2,22,25
9950,0,0,13,17,30
9951,0,2,6,7,15
9952,0,1,0,3,4
9953,0,0,5,12,17
9954,1,0,4,12,17
9955,0,0,2,4,6
9956,0,1,10,22,33
9958,0,1,8,14,23
9959,1,0,8,20,29
9960,0,0,9,6,15
9961,0,1,1,6,8
9962,0,1,10,32,43
9963,1,0,7,10,18
9964,0,1,12,37,50
9966,0,1,2,12,15
9967,2,0,8,33,43
9968,2,1,5,42,50
9969,0,0,15,35,50
9970,0,1,9,20,30
9971,0,1,11,9,21
9972,0,0,3,5,8
9973,0,1,2,7,10
9974,0,1,12,37,50
9975,0,0,5,22,27
9976,1,0,4,22,27
9977,2,1,5,42,50
9978,0,0,4,24,28
9980,2,1,5,42,50
9981,0,0,3,9,12
9982,2,1,6,27,36
9984,0,0,7,17,24
9985,0,0,0,6,6
9987,0,0,3,5,8
9989,0,0,1,4,5
9990,0,1,2,7,10
9991,0,0,7,21,28
9993,1,0,8,20,29
9996,0,0,0,5,5
9997,0,1,2,19,22
9998,1,0,1,4,6
9999,0,0,7,17,24
10000,0,0,7,19,26
10001,0,0,4,9,13
10002,0,0,3,9,12
10003,0,1,2,7,10
10004,0,1,10,22,33
10005,0,0,15,35,50
10007,0,0,0,5,5
10008,0,1,6,5,12
10009,0,0,7,21,28
10010,0,0,11,17,28
10011,0,0,14,32,46
10012,0,0,13,30,43
10014,0,1,2,12,15
10015,0,0,5,3,8
10016,0,0,5,12,17
10017,0,1,4,33,38
10018,2,1,5,42,50
10020,0,1,3,3,7
10021,1,0,6,29,36
10022,0,0,2,9,11
10023,0,0,3,8,11
10024,0,0,0,8,8
10025,0,0,3,1,4
10026,0,0,7,13,20
10027,0,0,4,5,9
10028,0,1,2,7,10
10029,0,1,11,9,21
10031,0,1,9,9,19
10032,0,0,3,5,8
10033,0,0,3,11,14
10034,0,1,2,11,14
10035,0,0,7,20,27
10036,0,2,9,14,25
10037,0,2,8,11,21
10038,1,1,8,19,29
10039,0,1,10,12,23
10040,1,0,10,17,28
10041,0,0,1,6,7
10042,0,0,3,5,8
10043,0,0,11,23,34
10044,0,1,4,5,10
10046,2,0,10,38,50
10047,0,0,4,3,7
10048,0,0,4,5,9
10049,0,0,2,2,4
10050,0,0,5,2,7
10051,0,1,10,29,40
10052,0,0,26,24,50
10053,0,0,10,20,30
10054,1,0,5,33,39
10055,0,0,7,18,25
10056,0,1,11,38,50
10057,0,0,12,15,27
10058,0,0,7,23,30
10059,0,1,1,9,11
10060,0,0,5,3,8
10061,0,0,7,7,14
10062,0,0,4,8,12
10063,0,0,5,6,11
10064,0,0,3,14,17
10065,0,0,2,7,9
10066,0,0,5,9,14
10067,0,0,8,14,22
10068,0,0,6,7,13
10069,0,0,8,23,31
10070,0,0,11,27,38
10071,0,0,2,4,6
10072,0,0,1,12,13
10073,0,0,9,33,42
10074,0,0,6,18,24
10075,1,0,9,33,43
10076,0,0,5,0,5
10077,2,1,4,22,29
10078,0,0,9,23,32
10079,0,0,4,3,7
10080,0,0,15,35,50
10081,0,0,16,22,38
10082,0,0,6,15,21
10083,0,1,7,10,18
10084,0,0,6,17,23
10085,0,2,6,21,29
10086,0,0,2,7,9
10087,0,0,3,5,8
10088,0,0,3,7,10
10089,0,2,2,26,30
10091,0,0,0,23,23
10092,0,0,1,6,7
10093,0,0,15,17,32
10094,0,0,15,34,49
10095,0,0,7,18,25
10096,0,3,8,20,31
10097,0,0,4,11,15
10098,0,0,7,8,15
10099,1,0,4,16,21
10100,0,0,4,3,7
10101,0,0,4,10,14
10102,0,0,3,10,13
10103,0,0,3,34,37
10104,1,0,5,13,19
10105,0,0,8,11,19
10106,0,0,9,18,27
10107,0,0,9,6,15
10108,0,0,9,14,23
10109,0,0,8,30,38
10110,0,1,17,32,50
10111,0,0,11,12,23
10112,0,0,5,11,16
10113,0,3,2,10,15
10115,0,1,12,24,37
10116,0,0,7,8,15
10117,0,0,5,12,17
10118,0,0,5,7,12
10119,0,0,6,4,10
10120,0,0,6,23,29
10121,0,0,3,14,17
10122,0,0,9,3,12
10123,0,0,7,2,9
10124,0,0,3,8,11
10125,0,0,5,5,10
10126,0,0,3,11,14
10127,0,0,1,5,6
10128,0,2,4,14,20
10129,0,0,15,31,46
10130,0,0,11,16,27
10131,0,0,20,29,49
10132,0,0,3,7,10
10133,3,0,0,9,12
10134,0,0,1,7,8
10135,0,0,1,10,11
10136,0,0,9,17,26
10137,3,9,4,34,50
10138,0,1,6,18,25
10139,0,0,1,5,6
10140,0,0,4,3,7
10141,11,0,0,16,27
10142,0,1,9,9,19
10143,0,0,2,11,13
10144,0,1,5,7,13
10145,1,0,1,4,6
10146,0,0,1,7,8
10147,0,0,0,4,4
10148,0,1,9,31,41
10149,0,0,2,5,7
10150,0,0,9,4,13
10151,0,0,2,10,12
10152,0,0,2,1,3
10153,0,0,16,34,50
10154,0,0,6,9,15
10155,0,0,11,31,42
10156,0,0,9,11,20
10157,0,0,2,4,6
10158,0,1,6,15,22
10159,0,0,9,21,30
10160,0,0,5,3,8
10161,0,1,16,21,38
10162,0,0,6,3,9
10163,0,0,3,2,5
10164,1,0,7,11,19
10165,0,0,7,2,9
10166,0,0,3,8,11
10167,0,0,0,5,5
10168,0,1,9,40,50
10169,0,0,4,1,5
10170,0,2,3,10,15
10171,0,1,6,19,26
10172,0,0,5,9,14
10173,0,0,5,18,23
10174,0,0,0,5,5
10175,0,0,6,17,23
10176,0,2,12,36,50
10177,0,0,10,14,24
10178,0,2,5,10,17
10179,0,0,0,8,8
10180,0,0,6,4,10
10181,0,0,8,3,11
10182,0,0,3,7,10
10183,0,0,9,12,21
10184,0,0,5,11,16
10185,0,0,3,7,10
10186,1,1,10,15,27
10187,0,0,6,9,15
10188,0,0,4,13,17
10189,0,0,4,2,6
10190,0,0,8,5,13
10191,0,1,3,3,7
10192,0,0,3,3,6
10193,0,1,1,15,17
10194,1,1,5,18,25
10195,1,0,7,10,18
10196,0,2,17,26,45
10197,0,0,11,35,46
10198,1,0,6,29,36
10199,0,0,6,37,43
10200,0,0,3,4,7
10201,0,0,10,15,25
10202,1,0,4,10,15
10203,0,0,6,14,20
10204,2,2,4,15,23
10205,0,0,7,21,28
10206,0,1,9,20,30
10207,0,0,14,36,50
10208,0,0,6,7,13
10209,0,0,5,15,20
10210,0,0,1,5,6
10211,0,1,11,9,21
10212,1,0,18,31,50
10213,0,0,3,5,8
10214,0,0,13,9,22
10215,0,3,1,9,13
10216,0,1,2,12,15
10217,0,0,2,9,11
10218,0,0,2,6,8
10219,0,1,16,33,50
10220,0,0,18,32,50
10221,0,1,6,33,40
10222,1,0,8,20,29
10223,0,1,14,33,48
10224,0,0,4,2,6
10225,0,0,10,15,25
10226,0,0,20,30,50
10227,0,0,3,10,13
10228,0,0,5,3,8
10229,0,0,6,16,22
10230,0,0,2,19,21
10231,0,0,8,15,23
10232,2,0,10,38,50
10233,0,0,6,37,43
10234,0,0,7,17,24
10235,0,1,10,22,33
10236,0,0,9,12,21
10237,0,0,6,18,24
10238,0,0,3,11,14
10239,1,0,10,39,50
10240,0,0,9,29,38
10241,0,1,7,15,23
10242,0,0,5,11,16
10243,0,0,8,18,26
10244,0,0,8,17,25
10245,1,0,10,19,30
10247,1,0,8,22,31
10248,0,0,2,13,15
10249,0,0,7,17,24
10250,0,0,15,24,39
10251,0,0,19,31,50
10252,0,2,7,39,48
10253,0,0,14,30,44
10254,0,0,7,27,34
10255,0,0,13,33,46
10256,0,2,17,26,45
10257,0,0,9,10,19
10258,0,1,6,9,16
10259,1,0,7,41,49
10260,0,0,4,8,12
10261,0,1,9,13,23
10262,0,0,14,16,30
10263,1,0,4,27,32
10264,0,3,7,30,40
10265,0,2,2,17,21
10266,0,0,2,7,9
10267,0,0,15,34,49
10268,0,0,10,8,18
10269,1,0,13,29,43
10270,0,1,1,10,12
10271,0,0,9,13,22
10272,1,0,18,31,50
10273,0,1,2,26,29
10274,1,0,9,34,44
10275,1,0,14,27,42
10276,0,0,6,7,13
10277,0,0,6,10,16
10278,0,3,2,24,29
10279,0,1,6,26,33
10280,0,0,7,17,24
10281,0,0,6,14,20
10282,0,0,10,40,50
10283,0,2,9,24,35
10284,0,0,6,4,10
10285,2,0,8,33,43
10286,0,0,0,4,4
10287,3,0,1,8,12
10288,0,1,11,9,21
10289,1,0,10,39,50
10290,1,3,9,21,34
10291,3,0,6,21,30
10292,0,0,13,37,50
10293,0,0,6,12,18
10294,0,0,5,2,7
10295,0,0,7,15,22
10296,1,0,7,10,18
10297,1,1,7,18,27
10298,0,0,11,14,25
10299,0,0,5,15,20
10300,0,0,6,3,9
10301,0,0,7,21,28
10302,0,1,2,7,10
10303,1,1,4,16,22
10305,0,0,1,5,6
10306,0,1,9,20,30
10307,0,0,5,12,17
10308,0,0,5,3,8
10309,0,0,11,39,50
10310,0,1,2,12,15
10311,0,0,7,17,24
10312,0,0,13,29,42
10313,0,0,16,33,49
10314,0,0,8,7,15
10315,0,0,16,34,50
10316,1,0,4,14,19
10317,0,0,10,10,20
10318,0,1,1,6,8
10319,0,0,6,15,21
10320,2,2,4,15,23
10321,1,0,6,29,36
10322,1,0,10,39,50
10323,0,0,2,11,13
10324,0,0,3,5,8
10325,0,0,6,26,32
10326,0,1,2,7,10
10327,0,0,7,21,28
10328,1,0,8,20,29
10329,0,1,10,22,33
10330,3,0,0,9,12
10331,1,0,1,4,6
10332,0,1,2,7,10
10333,0,1,2,12,15
10334,0,0,7,21,28
10335,3,9,4,34,50
10336,1,1,4,16,22
10337,0,2,7,39,48
10338,0,0,11,35,46
10339,0,2,9,14,25
10340,0,0,3,25,28
10341,0,0,6,6,12
10342,0,2,3,19,24
10343,0,0,2,8,10
10344,0,0,10,22,32
10345,0,0,14,33,47
10346,0,0,10,19,29
10347,1,0,5,16,22
10348,0,0,8,14,22
10349,0,0,13,30,43
10350,0,0,5,28,33
10351,0,1,10,12,23
10352,0,0,2,21,23
10353,0,0,2,23,25
10354,0,0,2,19,21
10355,0,0,7,26,33
10356,1,0,5,11,17
10357,0,0,9,28,37
10358,0,0,6,16,22
10359,0,1,13,28,42
10360,0,0,10,11,21
10361,0,0,20,25,45
10362,1,1,2,26,30
10363,0,0,13,37,50
10366,0,0,3,18,21
10367,0,0,11,21,32
10368,0,0,8,21,29
10369,0,0,4,4,8
10370,0,0,2,3,5
10371,0,0,0,2,2
10372,0,0,4,9,13
10373,0,0,13,36,49
10375,0,0,3,6,9
10376,0,3,12,33,48
10377,0,0,9,15,24
10378,0,0,3,7,10
10379,0,1,1,4,6
10380,0,0,3,9,12
10382,0,0,8,19,27
10383,1,0,3,8,12
10384,0,0,3,4,7
10385,0,0,8,14,22
10386,0,0,2,7,9
10387,0,0,6,12,18
10388,1,0,13,17,31
10389,0,0,3,10,13
10390,0,0,5,7,12
10391,0,0,4,7,11
10392,0,0,6,10,16
10393,0,0,7,23,30
10394,1,1,7,41,50
10395,0,0,21,29,50
10396,1,0,10,39,50
10397,0,0,17,33,50
10398,0,0,8,37,45
10399,1,0,5,16,22
10400,0,0,9,34,43
10401,0,0,4,2,6
10402,0,0,5,25,30
10403,0,0,8,16,24
10404,0,0,13,20,33
10405,1,1,7,31,40
10406,0,5,1,12,18
10407,0,0,10,12,22
10408,0,0,11,25,36
10409,0,1,7,20,28
10410,0,3,15,29,47
10411,0,0,6,15,21
10412,0,0,7,17,24
10413,0,0,8,37,45
10414,0,0,12,26,38
10415,0,0,14,30,44
10416,0,0,3,9,12
10417,0,0,7,11,18
10418,0,0,8,24,32
10419,0,1,5,8,14
10420,0,0,4,15,19
10421,0,0,7,8,15
10422,0,0,1,10,11
10423,0,0,3,8,11
10424,0,0,17,31,48
10425,2,0,6,34,42
10426,7,1,3,20,31
10427,0,0,9,13,22
10428,1,0,5,27,33
10429,0,1,12,36,49
10430,0,2,4,16,22
10431,0,0,6,9,15
10432,0,0,11,25,36
10433,0,0,5,27,32
10434,0,1,6,18,25
10435,0,1,8,37,46
10436,0,1,14,30,45
10437,0,0,11,17,28
10438,0,0,6,7,13
10439,0,1,12,35,48
10440,0,0,5,10,15
10441,0,0,4,12,16
10442,2,0,4,13,19
10443,0,0,7,10,17
10445,1,0,2,24,27
10446,0,0,12,23,35
10447,3,1,2,15,21
10448,1,0,7,18,26
10449,1,0,3,14,18
10450,0,0,1,1,2
10451,2,0,5,12,19
10452,0,0,5,7,12
10453,0,0,2,8,10
10454,0,2,2,5,9
10455,0,0,8,16,24
10456,0,0,3,17,20
10457,0,2,17,26,45
10458,0,0,2,16,18
10459,0,0,2,15,17
10460,1,0,1,11,13
10461,0,1,6,8,15
10462,0,0,7,26,33
10463,3,1,2,15,21
10464,0,0,21,29,50
10465,2,0,6,34,42
10466,1,2,8,25,36
10467,0,1,12,35,48
10468,1,0,10,39,50
10470,0,2,4,16,22
10471,0,0,8,35,43
10472,2,1,2,21,26
10473,1,0,1,12,14
10474,7,1,3,20,31
10475,0,0,16,34,50
10476,0,0,10,18,28
10477,0,0,2,8,10
10478,0,1,12,35,48
10479,0,0,10,18,28
10480,0,0,2,9,11
10481,0,0,1,4,5
10482,0,0,2,0,2
10483,0,0,2,6,8
10484,0,0,6,8,14
10485,4,0,0,5,9
10486,0,0,1,7,8
10488,0,0,4,17,21
10489,0,0,5,7,12
10490,0,0,12,27,39
10491,0,0,4,15,19
10492,0,0,0,6,6
10493,0,2,5,16,23
10494,0,0,6,1,7
10495,0,0,5,26,31
10496,0,0,1,1,2
10497,0,0,12,26,38
10498,0,0,11,19,30
10499,0,0,0,24,24
10500,0,0,9,30,39
10501,0,0,12,24,36
10502,0,0,2,6,8
10503,0,0,4,9,13
10504,0,0,6,7,13
10505,0,0,8,3,11
10506,0,0,1,5,6
10507,0,0,4,4,8
10508,0,0,7,17,24
10509,2,0,0,5,7
10510,0,0,4,9,13
10511,0,0,0,6,6
10512,0,0,4,14,18
10513,0,0,15,35,50
10514,0,0,6,13,19
10515,0,1,2,13,16
10516,0,1,1,24,26
10517,0,0,2,1,3
10518,0,0,8,8,16
10519,0,0,9,17,26
10520,0,0,3,3,6
10521,0,0,5,7,12
10522,0,0,3,13,16
10523,0,0,4,11,15
10524,0,0,7,8,15
10525,0,0,3,9,12
10526,0,1,0,10,11
10527,0,0,4,8,12
10528,0,0,5,25,30
10529,1,2,15,32,50
10530,0,0,7,17,24
10531,1,0,5,13,19
10532,0,0,5,34,39
10533,0,0,2,4,6
10534,0,0,7,16,23
10535,0,0,6,9,15
10536,0,0,6,2,8
10537,0,0,9,8,17
10538,0,0,4,3,7
10539,1,0,9,14,24
10540,0,2,3,16,21
10541,0,0,4,15,19
10542,0,0,4,10,14
10543,0,0,12,18,30
10544,0,0,6,11,17
10545,0,0,8,10,18
10546,0,1,0,6,7
10547,0,0,7,14,21
10549,1,0,12,34,47
10550,0,0,8,15,23
10551,0,0,6,2,8
10552,0,0,4,4,8
10553,0,0,8,12,20
10554,1,0,5,7,13
10555,0,0,6,8,14
10556,0,0,5,12,17
10557,4,0,0,5,9
10558,0,0,8,16,24
10559,3,0,0,9,12
10560,0,0,2,9,11
10561,0,0,5,11,16
10562,0,0,1,4,5
10563,0,0,6,14,20
10564,0,0,12,33,45
10565,0,0,11,23,34
10566,0,0,10,26,36
10567,0,0,7,15,22
10568,0,3,12,33,48
10569,0,0,8,12,20
10570,0,0,7,3,10
10571,0,1,9,17,27
10572,0,0,8,18,26
10573,0,0,5,8,13
10574,0,1,7,31,39
10575,0,0,2,18,20
10576,0,0,5,23,28
10577,2,0,6,25,33
10578,0,0,15,34,49
10579,0,0,5,6,11
10580,0,0,0,24,24
10581,0,0,2,9,11
10582,1,0,6,7,14
10584,0,0,5,15,20
10585,0,0,6,19,25
10586,0,0,9,10,19
10587,0,0,16,24,40
10588,0,0,1,4,5
10589,0,1,1,16,18
10590,0,0,7,31,38
10591,0,0,11,19,30
10592,0,0,14,22,36
10594,0,0,17,27,44
10595,0,0,4,6,10
10596,0,0,1,10,11
10597,0,0,9,7,16
10598,0,0,13,23,36
10599,0,0,12,31,43
10600,0,0,8,27,35
10601,0,0,10,7,17
10602,0,1,4,24,29
10603,0,0,6,3,9
10604,0,0,1,4,5
10605,0,0,10,18,28
10606,0,0,4,14,18
10607,0,0,12,38,50
10608,0,0,11,10,21
10609,0,0,4,14,18
10610,0,0,6,11,17
10611,0,0,6,2,8
10612,0,0,4,5,9
10613,0,0,16,33,49
10614,0,0,9,21,30
10615,0,0,1,7,8
10616,0,1,12,37,50
10617,0,3,15,19,37
10618,2,1,11,29,43
10619,0,1,20,29,50
10620,0,0,6,10,16
10621,0,0,10,15,25
10622,0,0,4,9,13
10623,0,0,5,9,14
10624,0,0,9,22,31
10625,0,0,13,37,50
10626,1,0,8,30,39
10627,0,0,5,16,21
10628,0,0,1,6,7
10629,0,0,9,12,21
10630,0,0,8,12,20
10631,0,0,4,16,20
10632,2,0,9,20,31
10634,0,0,5,11,16
10635,0,2,7,15,24
10636,0,0,1,4,5
10637,0,0,6,14,20
10638,1,0,12,34,47
10639,0,0,8,16,24
10640,0,0,5,12,17
10641,0,0,11,30,41
10642,0,0,12,23,35
10643,0,0,13,30,43
10644,2,2,4,19,27
10645,5,1,5,39,50
10646,0,2,7,15,24
10647,0,1,12,37,50
10648,0,0,4,5,9
10649,0,0,1,33,34
10650,0,0,10,40,50
10651,1,0,5,14,20
10652,0,2,5,31,38
10653,1,1,7,25,34
10654,0,0,0,6,6
10655,0,0,11,24,35
10656,1,1,7,25,34
10657,0,0,1,4,5
10658,0,2,7,15,24
10659,3,0,0,9,12
10660,0,0,4,9,13
10661,1,0,6,29,36
10662,0,0,7,15,22
10663,0,0,7,2,9
10665,0,7,5,17,29
10666,1,0,7,42,50
10667,0,1,4,4,9
10668,0,0,1,4,5
10669,0,0,5,18,23
10670,0,0,5,3,8
10671,0,0,3,8,11
10672,0,4,3,12,19
10673,0,0,5,15,20
10674,1,3,11,34,49
10675,0,1,10,35,46
10676,0,0,7,15,22
10677,0,0,6,12,18
10678,0,1,6,17,24
10679,0,0,6,13,19
10680,0,3,10,20,33
10681,0,0,2,30,32
10682,0,0,3,8,11
10683,0,1,8,25,34
10684,0,0,4,19,23
10685,0,0,15,32,47
10686,0,2,5,21,28
10687,0,0,14,36,50
10688,1,0,13,10,24
10689,0,1,8,17,26
10690,0,0,7,18,25
10691,0,0,6,15,21
10692,0,0,5,16,21
10693,1,0,0,14,15
10694,0,0,4,4,8
10695,0,0,12,27,39
10696,0,0,6,13,19
10697,0,0,4,8,12
10698,0,1,14,24,39
10699,0,0,8,14,22
10700,0,0,5,22,27
10701,0,0,3,13,16
10702,1,1,3,21,26
10703,0,0,5,14,19
10704,0,1,4,10,15
10705,0,0,6,11,17
10706,0,0,6,20,26
10707,0,0,8,23,31
10708,1,0,4,24,29
10709,0,0,2,5,7
10710,0,0,14,28,42
10711,0,0,6,16,22
10712,1,0,7,16,24
10713,0,0,3,7,10
10714,0,1,6,22,29
10715,0,0,15,22,37
10716,0,0,7,29,36
10717,1,2,6,15,24
10718,0,0,7,16,23
10719,0,0,10,17,27
10720,0,2,10,36,48
10721,0,0,6,15,21
10722,0,0,0,12,12
10723,0,2,14,29,45
10724,0,0,7,4,11
10725,0,1,14,22,37
10726,0,0,18,27,45
10727,0,1,5,17,23
10728,0,0,4,17,21
10729,0,0,7,22,29
10730,0,0,7,20,27
10731,1,0,6,16,23
10732,0,0,13,24,37
10733,0,1,17,32,50
10734,0,0,5,6,11
10735,0,0,9,23,32
10736,0,0,4,8,12
10737,0,0,14,29,43
10738,0,0,5,17,22
10739,0,0,14,30,44
10740,0,0,12,33,45
10741,0,0,17,28,45
10742,0,1,1,40,42
10743,0,0,5,7,12
10744,0,0,10,16,26
10745,0,0,6,9,15
10746,0,0,4,9,13
10747,0,1,12,26,39
10748,0,0,5,17,22
10749,0,0,3,12,15
10750,0,2,15,30,47
10751,0,0,1,9,10
10752,0,1,7,21,29
10753,0,1,4,4,9
10754,0,0,5,15,20
10755,1,2,11,36,50
10756,0,0,2,3,5
10757,0,0,7,8,15
10758,0,0,7,7,14
10759,0,0,10,28,38
10760,0,0,14,16,30
10761,0,1,6,15,22
10762,0,0,11,17,28
10763,0,0,0,11,11
10764,0,3,14,23,40
10765,0,0,11,18,29
10766,0,0,11,9,20
10767,0,0,8,5,13
10768,0,0,4,17,21
10769,0,0,11,17,28
10770,0,0,1,3,4
10771,0,0,7,5,12
10772,2,3,6,24,35
10773,0,0,3,9,12
10774,0,0,8,25,33
10775,1,4,11,30,46
10776,0,0,8,10,18
10777,1,1,5,18,25
10778,0,0,3,6,9
10779,0,0,9,12,21
10780,0,0,3,5,8
10781,0,0,1,10,11
10782,0,0,7,4,11
10783,0,0,12,29,41
10784,0,0,11,19,30
10785,0,1,2,13,16
10787,0,0,2,12,14
10788,2,1,16,20,39
10789,1,0,3,14,18
10790,0,0,6,2,8
10791,1,0,4,21,26
10792,0,1,5,29,35
10793,0,1,3,17,21
10794,0,0,5,9,14
10795,0,1,7,14,22
10796,0,0,2,14,16
10797,1,0,14,25,40
10798,0,1,5,13,19
10799,0,0,5,4,9
10800,0,0,2,48,50
10801,0,0,7,9,16
10802,0,0,6,6,12
10803,0,0,11,39,50
10804,0,0,10,14,24
10805,0,0,6,15,21
10806,0,1,4,11,16
10807,0,1,2,4,7
10808,0,0,12,15,27
10809,0,0,1,6,7
10810,0,0,12,31,43
10811,0,0,5,11,16
10812,0,0,11,25,36
10813,0,0,6,7,13
10814,0,0,12,18,30
10815,0,0,4,6,10
10816,0,0,5,6,11
10817,3,0,4,21,28
10818,0,0,4,5,9
10819,0,1,1,4,6
10820,0,0,15,12,27
10821,0,4,7,5,16
10822,1,1,4,19,25
10823,0,0,5,4,9
10824,2,0,9,32,43
10825,0,0,1,8,9
10826,1,1,5,43,50
10827,0,0,5,15,20
10828,0,0,2,15,17
10829,0,0,3,3,6
10830,0,1,6,16,23
10831,0,0,6,18,24
10832,0,0,5,5,10
10833,0,0,11,30,41
10834,0,1,0,11,12
10835,0,0,10,14,24
10836,0,0,5,10,15
10837,0,1,3,18,22
10838,0,0,6,13,19
10839,0,0,8,20,28
10840,0,0,10,10,20
10841,0,0,0,2,2
10842,0,0,8,12,20
10843,0,1,12,17,30
10844,0,0,10,14,24
10845,0,0,5,11,16
10846,0,0,3,5,8
10847,0,1,4,7,12
10848,0,1,16,31,48
10849,0,0,6,9,15
10850,0,0,11,13,24
10851,0,0,0,1,1
10852,0,0,5,1,6
10853,0,0,4,10,14
10854,0,3,8,18,29
10855,0,0,2,8,10
10856,0,0,8,21,29
10857,0,0,0,6,6
10858,0,0,19,25,44
10859,0,0,4,10,14
10861,0,0,5,11,16
10862,0,0,7,16,23
10863,1,0,11,35,47
10864,0,0,1,8,9
10865,0,0,7,9,16
10866,0,0,5,5,10
10867,0,0,14,30,44
10868,0,1,10,20,31
10869,0,0,4,18,22
10870,2,1,5,42,50
10871,0,0,5,17,22
10872,0,0,7,25,32
10873,0,1,8,6,15
10874,1,1,13,22,37
10875,0,0,2,13,15
10876,0,0,1,16,17
10877,0,1,5,10,16
10878,0,0,6,7,13
10879,1,0,12,24,37
10881,0,0,5,3,8
10883,0,0,1,4,5
10884,0,0,3,2,5
10885,1,1,7,5,14
10887,0,0,11,13,24
10888,0,0,9,27,36
10889,0,0,4,2,6
10890,0,0,6,7,13
10891,0,0,6,7,13
10892,0,0,17,27,44
10893,0,0,5,34,39
10894,1,0,6,29,36
10896,0,0,6,29,35
10897,0,0,11,24,35
10900,0,0,1,6,7
10902,0,0,6,9,15
10903,0,0,4,22,26
10904,0,0,11,13,24
10905,0,0,7,8,15
10906,0,0,1,5,6
10907,0,0,3,8,11
10908,0,0,6,3,9
10909,0,1,4,17,22
10910,0,0,6,16,22
10911,0,0,1,4,5
10912,1,0,7,42,50
10913,0,0,13,17,30
10914,0,0,5,11,16
10915,0,0,6,10,16
10916,0,0,12,33,45
10917,0,0,6,8,14
10918,0,1,10,33,44
10919,1,0,9,23,33
10920,4,3,6,32,45
10921,0,1,1,28,30
10922,2,0,8,16,26
10923,0,0,12,32,44
10924,0,0,4,4,8
10925,0,1,3,14,18
10926,0,0,10,14,24
10927,0,0,19,31,50
10928,1,0,11,35,47
10929,2,0,5,18,25
10930,0,0,12,38,50
10931,0,2,11,28,41
10932,0,1,10,19,30
10933,0,0,14,33,47
10934,0,0,4,5,9
10935,0,1,16,32,49
10936,0,0,7,22,29
10937,0,3,13,34,50
10938,0,0,8,23,31
10939,0,1,3,23,27
10940,0,0,7,9,16
10941,0,0,10,26,36
10942,0,0,14,28,42
10943,0,0,6,20,26
10944,0,1,4,10,15
10946,1,1,6,42,50
10947,0,0,12,15,27
10948,0,0,8,5,13
10949,0,1,7,19,27
10950,1,2,10,37,50
10951,0,1,12,35,48
10952,0,0,5,14,19
10953,0,0,1,7,8
10954,0,0,9,20,29
10955,0,0,12,25,37
10956,2,0,2,21,25
10957,0,0,21,29,50
10958,3,1,8,24,36
10959,0,0,10,21,31
10960,2,0,5,13,20
10961,1,1,5,5,12
10962,0,0,0,1,1
10963,0,1,9,24,34
10965,0,2,9,16,27
10966,0,0,3,13,16
10967,0,1,2,14,17
10968,0,0,10,25,35
10969,0,1,10,39,50
10970,0,0,14,30,44
10971,0,0,13,20,33
10972,0,0,9,36,45
10973,0,0,9,37,46
10974,0,0,6,29,35
10975,1,0,16,20,37
10976,1,0,12,33,46
10977,0,0,14,29,43
10978,0,0,4,13,17
10979,0,0,9,21,30
10980,5,1,10,18,34
10981,0,0,5,14,19
10982,1,0,8,40,49
10983,0,0,5,21,26
10984,1,0,6,16,23
10985,0,1,5,21,27
10986,0,1,3,4,8
10987,1,0,13,20,34
10988,1,1,15,33,50
10989,0,0,8,19,27
10990,0,0,4,11,15
10991,1,2,6,36,45
10992,0,0,7,20,27
10993,0,1,12,19,32
10994,0,0,4,13,17
10995,0,0,9,8,17
10996,0,0,15,13,28
10997,0,0,13,33,46
10998,0,1,12,30,43
11000,0,0,15,35,50
11001,0,0,3,6,9
11002,0,2,16,17,35
11004,0,0,4,25,29
11005,0,1,10,37,48
11006,1,1,17,31,50
11007,0,0,4,10,14
11008,0,0,9,27,36
11009,0,0,4,14,18
11010,0,0,1,36,37
11013,0,0,2,8,10
11014,0,0,8,12,20
11015,0,0,13,37,50
11016,0,0,2,10,12
11017,0,0,9,12,21
11018,0,0,14,36,50
11019,1,0,7,16,24
11020,0,0,14,35,49
11021,0,0,12,15,27
11022,1,0,12,14,27
11023,0,0,7,10,17
11024,0,2,12,19,33
11025,0,0,13,28,41
11026,1,0,5,22,28
11027,0,0,9,14,23
11028,0,0,14,26,40
11029,1,0,5,18,24
11031,0,0,6,22,28
11032,2,0,7,8,17
11033,0,0,4,9,13
11034,3,0,1,14,18
11035,0,0,7,30,37
11036,0,0,8,7,15
11037,0,0,13,35,48
11038,0,0,6,15,21
11039,0,1,3,10,14
11040,0,0,8,10,18
11041,0,0,13,15,28
11042,0,0,1,8,9
11043,1,0,3,13,17
11044,0,1,3,18,22
11045,0,0,10,16,26
11046,4,1,4,10,19
11047,2,0,1,6,9
11048,0,0,11,31,42
11049,0,3,1,13,17
11050,0,0,15,32,47
11051,0,1,5,3,9
11052,0,1,9,20,30
11054,0,0,10,25,35
11055,0,0,5,23,28
11056,1,2,10,26,39
11057,0,2,5,21,28
11058,0,0,3,4,7
11059,0,0,6,14,20
11060,2,1,10,36,49
11061,4,0,4,18,26
11062,0,0,0,7,7
11063,0,0,4,22,26
11064,2,0,7,17,26
11065,1,0,8,41,50
11066,0,0,4,3,7
11067,0,0,14,23,37
11068,0,0,2,13,15
11069,0,0,5,5,10
11070,0,0,17,33,50
11071,1,1,7,13,22
11072,0,1,1,23,25
11073,0,0,5,13,18
11074,0,0,6,3,9
11075,0,1,7,22,30
11076,0,0,3,5,8
11077,0,0,13,17,30
11079,0,0,11,13,24
11080,0,0,9,15,24
11081,0,2,1,12,15
11082,0,0,14,33,47
11083,0,0,9,12,21
11084,0,0,12,21,33
11085,1,0,4,12,17
11087,0,0,1,5,6
11088,0,2,4,16,22
11089,2,1,10,37,50
11090,0,1,14,24,39
11091,0,0,5,34,39
11092,0,0,1,7,8
11093,1,2,6,15,24
11094,0,0,14,36,50
11095,0,7,5,17,29
11096,2,1,5,42,50
11097,0,0,5,11,16
11098,1,0,7,42,50
11099,1,0,1,8,10
11100,0,0,6,9,15
11101,0,0,1,4,5
11102,1,2,13,17,33
11103,2,0,5,19,26
11104,2,0,10,38,50
11105,0,0,21,29,50
11106,1,1,10,38,50
11107,0,0,19,31,50
11108,0,0,9,20,29
11109,0,4,14,21,39
11110,1,0,12,37,50
11111,0,1,4,45,50
11112,0,0,6,15,21
11113,0,0,10,15,25
11114,1,0,6,29,36
11115,0,0,4,11,15
11116,0,0,5,14,19
11117,1,0,4,12,17
11118,0,0,5,4,9
11119,1,0,5,11,17
11120,0,0,8,10,18
11121,1,0,5,17,23
11122,0,2,6,21,29
11123,1,0,0,20,21
11124,0,3,5,27,35
11125,0,0,8,27,35
11126,3,0,1,14,18
11127,1,0,9,19,29
11128,0,0,9,28,37
11129,0,0,14,36,50
11131,0,0,5,11,16
11132,1,0,5,21,27
11133,2,1,5,42,50
11134,0,0,11,23,34
11135,0,0,10,19,29
11136,0,0,7,8,15
11137,0,7,5,17,29
11138,0,1,3,18,22
11139,0,2,4,16,22
11140,0,0,0,12,12
11141,2,1,5,42,50
11142,0,7,5,17,29
11143,1,1,9,10,21
11144,0,1,12,19,32
11145,0,0,11,13,24
11146,1,1,7,25,34
11147,0,0,8,12,20
11149,1,1,7,25,34
11150,0,0,8,23,31
11151,0,0,1,4,5
11152,0,0,10,21,31
11154,0,1,14,24,39
11155,2,1,5,42,50
11156,0,0,2,13,15
11157,0,7,5,17,29
11158,0,0,13,15,28
11159,0,1,4,17,22
11160,0,0,2,8,10
11161,0,0,10,21,31
11162,0,0,4,19,23
11163,0,0,7,13,20
11164,0,0,15,29,44
11165,0,0,3,11,14
11166,0,0,3,5,8
11167,0,0,8,21,29
11168,0,0,6,20,26
11169,0,0,3,4,7
11170,0,1,7,32,40
11171,0,0,6,7,13
11172,0,0,0,5,5
11173,0,1,9,25,35
11174,0,0,6,11,17
11175,0,1,1,12,14
11176,1,0,10,39,50
11177,0,1,9,13,23
11178,1,1,12,29,43
11179,0,2,4,24,30
11180,0,0,4,3,7
11181,0,0,6,7,13
11183,0,4,12,7,23
11184,0,1,11,28,40
11185,0,0,3,15,18
11186,0,0,14,27,41
11187,0,0,6,15,21
11188,0,0,5,20,25
11189,0,0,4,15,19
11190,0,0,8,9,17
11191,0,1,6,21,28
11192,0,0,1,2,3
11193,0,0,4,13,17
11194,0,0,1,10,11
11195,1,0,18,29,48
11196,0,0,3,8,11
11197,0,0,17,27,44
11198,1,0,5,44,50
11199,0,0,10,24,34
11200,0,0,0,11,11
11201,0,1,8,28,37
11202,0,0,6,12,18
11203,0,0,3,11,14
11204,1,0,12,37,50
11205,0,0,4,10,14
11206,0,1,3,7,11
11207,0,0,6,11,17
11208,0,0,10,12,22
11209,1,0,6,21,28
11210,0,0,4,8,12
11211,0,0,2,26,28
11212,2,0,1,8,11
11213,0,1,9,15,25
11215,0,1,2,12,15
11216,0,0,7,16,23
11217,0,0,13,36,49
11218,1,2,3,18,24
11221,0,0,8,5,13
11222,0,0,7,12,19
11223,0,0,9,33,42
11224,1,0,11,35,47
11225,0,0,3,6,9
11226,0,0,13,31,44
11227,0,0,3,4,7
11228,0,2,8,28,38
11229,0,1,3,25,29
11230,0,1,1,9,11
11231,0,0,16,33,49
11232,0,0,0,6,6
11233,0,0,8,17,25
11234,0,1,8,15,24
11235,0,0,12,35,47
11236,0,0,7,13,20
11237,0,0,6,19,25
11238,0,1,9,15,25
11239,0,0,8,22,30
11240,0,0,6,16,22
11241,0,0,10,12,22
11242,0,2,3,8,13
11243,1,0,10,39,50
11244,0,0,8,26,34
11245,0,0,7,16,23
11246,1,0,0,5,6
11247,0,1,6,18,25
11248,0,0,6,5,11
11251,0,1,3,36,40
11252,3,1,2,9,15
11253,0,0,4,9,13
11254,1,0,11,22,34
11255,0,1,3,11,15
11256,0,1,14,18,33
11257,0,0,8,23,31
11258,3,0,5,11,19
11259,0,2,8,38,48
11260,1,0,2,32,35
11261,0,0,6,25,31
11262,0,1,6,24,31
11263,0,0,2,22,24
11264,1,0,1,3,5
11265,0,0,8,19,27
11266,0,2,9,39,50
11267,0,0,2,4,6
11268,0,1,7,37,45
11269,1,0,0,10,11
11270,0,0,4,12,16
11271,0,0,16,32,48
11272,0,1,2,32,35
11273,0,0,15,29,44
11274,1,0,6,21,28
11275,6,0,3,15,24
11276,1,0,12,24,37
11277,0,1,14,35,50
11278,0,0,12,24,36
11279,0,0,5,5,10
11280,0,0,4,2,6
11282,0,0,4,19,23
11283,0,1,2,12,15
11284,0,0,7,12,19
11285,0,0,10,20,30
11286,0,0,1,21,22
11287,0,2,8,28,38
11288,0,0,3,4,7
11289,0,0,2,22,24
11290,0,0,0,9,9
11291,3,1,2,9,15
11292,1,2,3,18,24
11293,0,0,6,20,26
11294,0,0,1,13,14
11296,0,1,3,25,29
11297,0,1,7,17,25
11298,0,0,1,17,18
11299,0,2,4,43,49
11303,1,2,3,18,24
11305,0,1,2,12,15
11306,1,0,6,29,36
11307,0,0,9,12,21
11308,0,0,7,16,23
11310,0,0,2,3,5
11311,0,0,3,2,5
11312,0,0,0,3,3
11313,0,0,3,9,12
11314,0,1,2,7,10
11315,0,0,12,16,28
11316,0,0,2,7,9
11317,0,0,7,7,14
11318,1,1,6,20,28
11319,0,1,9,11,21
11320,1,1,7,41,50
11321,0,0,7,21,28
11322,0,0,6,9,15
11323,0,0,13,36,49
11324,0,1,6,7,14
11325,0,0,4,13,17
11326,0,1,6,30,37
11327,0,0,6,16,22
11328,0,1,6,20,27
11329,1,0,7,13,21
11330,0,1,11,38,50
11331,0,0,3,10,13
11332,0,0,10,30,40
11333,0,0,1,8,9
11334,0,0,3,9,12
11335,0,0,3,19,22
11336,0,0,3,1,4
11337,1,0,8,25,34
11338,1,1,7,34,43
11339,0,1,14,15,30
11340,0,1,8,15,24
11341,0,1,3,12,16
11342,0,0,6,12,18
11343,0,2,12,22,36
11344,0,1,9,15,25
11345,0,0,8,13,21
11346,1,0,15,32,48
11347,0,1,9,15,25
11348,0,0,3,5,8
11349,3,1,3,28,35
11350,0,0,10,17,27
11351,1,0,7,33,41
11352,0,1,5,18,24
11353,0,0,5,12,17
11354,1,0,0,10,11
11355,0,0,2,10,12
11356,0,0,10,18,28
11357,0,0,4,14,18
11358,0,0,7,16,23
11359,0,0,6,10,16
11360,0,2,6,21,29
11361,0,0,6,25,31
11362,0,0,8,24,32
11363,1,0,6,29,36
11364,0,0,5,13,18
11365,0,0,3,7,10
11366,0,0,11,18,29
11368,0,0,7,19,26
11369,0,0,6,11,17
11370,0,0,8,10,18
11371,1,0,8,6,15
11372,0,0,16,25,41
11373,0,0,12,14,26
11374,0,0,5,8,13
11375,0,0,6,6,12
11376,0,0,5,22,27
11378,0,0,4,4,8
11379,2,2,15,29,48
11380,0,0,8,6,14
11381,0,0,9,14,23
11382,1,0,8,29,38
11383,0,0,4,9,13
11384,0,0,12,15,27
11385,0,1,17,19,37
11386,0,0,3,5,8
11387,1,0,7,26,34
11388,0,0,12,11,23
11389,0,0,14,27,41
11390,0,0,7,8,15
11391,2,1,13,27,43
11392,0,3,11,15,29
11393,0,0,4,4,8
11394,0,1,8,8,17
11395,0,0,4,3,7
11396,2,1,17,26,46
11397,0,0,4,11,15
11398,0,0,0,10,10
11399,0,0,2,18,20
11400,0,1,1,9,11
11401,0,0,0,6,6
11402,0,0,9,12,21
11403,0,0,7,14,21
11404,0,0,12,38,50
11405,0,0,2,3,5
11406,0,0,11,36,47
11407,0,3,3,14,20
11408,0,0,9,6,15
11409,0,0,4,18,22
11410,0,1,6,27,34
11411,0,1,10,26,37
11412,0,2,17,31,50
11413,0,0,8,5,13
11414,0,0,9,28,37
11416,0,0,1,15,16
11417,0,0,8,29,37
11418,0,1,9,15,25
11419,0,0,6,19,25
11420,0,0,13,21,34
11421,1,1,15,28,45
11422,0,1,2,10,13
11423,1,6,10,29,46
11424,0,0,4,5,9
11425,0,0,7,16,23
11426,0,0,1,14,15
11427,0,0,15,30,45
11428,0,1,4,33,38
11429,0,1,7,10,18
11430,0,0,4,5,9
11431,0,0,7,8,15
11432,2,0,4,17,23
11433,0,1,10,38,49
11434,2,0,5,19,26
11435,2,5,5,29,41
11436,0,0,3,10,13
11437,0,2,11,35,48
11438,0,2,11,31,44
11439,0,0,7,12,19
11440,0,0,9,24,33
11441,0,0,3,8,11
11442,0,0,6,6,12
11444,0,1,9,25,35
11445,0,0,5,8,13
11446,1,1,3,31,36
11447,0,0,1,6,7
11448,0,0,5,15,20
11449,0,0,5,14,19
11450,0,1,4,10,15
11451,0,0,10,39,49
11452,0,0,0,6,6
11453,0,0,12,11,23
11454,0,0,8,9,17
11455,0,0,0,1,1
11457,2,2,11,35,50
11458,0,1,2,5,8
11459,1,1,10,23,35
11460,1,5,6,38,50
11461,0,0,5,8,13
11462,1,0,0,25,26
11463,0,0,5,8,13
11464,0,1,5,12,18
11465,0,0,11,24,35
11466,0,0,1,11,12
11467,0,0,5,17,22
11468,1,0,5,17,23
11469,0,1,4,14,19
11470,0,1,5,12,18
11471,0,1,7,11,19
11472,0,0,1,4,5
11473,0,2,14,26,42
11474,1,0,12,16,29
11475,0,0,3,5,8
11476,0,2,8,19,29
11477,0,4,1,10,15
11478,0,0,5,37,42
11479,0,1,14,25,40
11480,0,0,5,13,18
11481,1,1,13,35,50
11482,1,0,9,17,27
11483,0,0,6,5,11
11484,0,0,9,14,23
11485,0,0,2,5,7
11486,0,0,1,6,7
11487,0,0,0,4,4
11488,0,0,1,4,5
11489,0,0,8,14,22
11490,0,0,3,5,8
11491,1,0,12,34,47
11492,0,0,6,7,13
11493,0,0,5,34,39
11494,0,0,5,11,16
11495,0,0,5,6,11
11496,1,0,6,21,28
11498,0,0,6,9,15
11499,1,1,1,10,13
11500,0,1,4,33,38
11501,0,0,6,2,8
11502,0,0,3,2,5
11503,0,1,9,25,35
11504,0,2,4,22,28
11505,0,0,8,36,44
11506,1,0,7,42,50
11507,0,0,11,27,38
11508,0,0,14,18,32
11509,0,0,0,4,4
11510,0,0,12,38,50
11511,0,0,6,6,12
11512,0,0,8,21,29
11513,2,1,12,31,46
11514,0,0,9,41,50
11515,0,0,5,7,12
11516,0,3,5,38,46
11517,0,2,11,28,41
11518,4,0,2,12,18
11519,0,0,6,27,33
11520,0,0,1,9,10
11521,1,0,8,40,49
11522,1,0,11,18,30
11523,1,1,2,11,15
11524,1,0,8,26,35
11525,0,0,6,25,31
11526,0,1,3,3,7
11527,0,0,12,19,31
11528,1,0,6,16,23
11529,0,1,14,15,30
11530,0,1,14,34,49
11531,0,0,4,19,23
11532,1,0,15,29,45
11533,0,0,8,17,25
11534,0,0,3,9,12
11535,0,1,10,38,49
11536,0,0,15,21,36
11537,0,1,0,12,13
11538,1,0,8,20,29
11539,1,0,7,33,41
11540,0,1,12,19,32
11541,1,0,0,10,11
11543,0,2,8,40,50
11544,0,0,12,22,34
11545,0,0,3,7,10
11546,1,0,6,13,20
11547,0,1,13,36,50
11548,1,0,2,12,15
11549,1,0,5,27,33
11550,0,1,7,28,36
11551,0,0,2,12,14
11552,0,1,1,26,28
11553,0,0,16,34,50
11555,0,0,6,5,11
11556,0,1,2,46,49
11557,0,0,0,11,11
11558,0,0,18,20,38
11559,1,0,5,19,25
11560,0,0,12,36,48
11561,0,0,3,8,11
11562,0,0,1,8,9
11563,0,0,11,37,48
11564,1,0,7,24,32
11565,1,1,14,28,44
11566,0,2,9,22,33
11567,0,0,8,42,50
11568,0,1,0,10,11
11569,1,1,7,41,50
11570,0,0,5,34,39
11571,0,0,7,8,15
11572,0,0,7,9,16
11573,0,0,6,16,22
11574,0,0,12,23,35
11575,0,2,6,20,28
11576,0,0,2,16,18
11577,1,0,3,40,44
11578,0,0,10,40,50
11579,0,0,2,15,17
11580,1,0,12,14,27
11581,0,0,11,25,36
11582,0,0,2,11,13
11583,0,0,1,7,8
11584,0,1,3,11,15
11585,4,0,1,8,13
11586,1,1,10,37,49
11587,0,1,5,21,27
11588,0,1,15,18,34
11589,2,1,2,25,30
11590,1,0,4,18,23
11591,3,1,1,20,25
11592,0,0,1,7,8
11593,1,0,3,24,28
11594,1,1,7,18,27
11595,0,0,3,20,23
11596,1,0,5,17,23
11597,0,0,10,21,31
11598,0,1,10,34,45
11599,2,0,4,30,36
11600,1,0,4,20,25
11601,1,0,5,4,10
11603,0,0,5,10,15
11604,0,0,16,16,32
11605,8,5,6,31,50
11606,0,1,10,16,27
11607,0,2,0,15,17
11608,7,0,0,24,31
11609,1,0,6,21,28
11610,1,1,3,10,15
11611,0,0,3,20,23
11612,0,1,4,20,25
11613,0,0,5,19,24
11614,0,3,7,33,43
11615,1,0,12,5,18
11616,0,0,11,39,50
11617,1,1,14,34,50
11618,0,0,12,36,48
11619,1,0,3,17,21
11620,0,0,6,9,15
11621,0,0,13,19,32
11622,0,1,2,6,9
11623,0,1,7,40,48
11624,5,0,4,16,25
11625,0,0,9,29,38
11626,1,1,7,41,50
11627,0,0,10,26,36
11628,2,0,1,34,37
11629,4,0,4,42,50
11630,1,0,1,8,10
11631,0,0,7,21,28
11632,0,0,9,14,23
11633,0,0,1,11,12
11634,0,0,0,6,6
11635,0,1,2,7,10
11636,0,0,3,9,12
11637,0,0,5,15,20
11638,0,0,7,16,23
11639,0,0,1,8,9
11641,0,1,9,15,25
11642,0,0,6,2,8
11643,2,0,9,32,43
11644,0,0,1,7,8
11645,1,0,8,12,21
11646,0,1,6,43,50
11647,0,1,3,12,16
11648,0,3,5,38,46
11649,0,0,8,21,29
11650,1,0,7,42,50
11651,0,0,5,23,28
11652,0,0,0,18,18
11653,0,0,1,20,21
11654,1,0,4,20,25
11655,1,0,5,19,25
11656,0,0,2,15,17
11657,4,1,7,31,43
11658,0,0,2,19,21
11659,0,0,11,37,48
11660,0,1,13,19,33
11661,2,5,1,18,26
11662,0,1,4,25,30
11663,0,1,6,13,20
11665,1,0,6,29,36
11666,2,1,2,25,30
11667,0,0,11,34,45
11668,1,1,1,10,13
11669,0,0,7,8,15
11670,3,1,1,20,25
11671,0,1,4,20,25
11672,0,0,3,20,23
11673,0,0,0,6,6
11674,0,0,13,34,47
11675,0,0,3,9,12
11676,1,0,4,18,23
11677,0,1,1,26,28
11679,4,0,4,42,50
11681,0,1,2,7,10
11684,0,0,3,9,12
11685,0,1,2,7,10
11686,0,1,4,33,38
11687,0,1,6,27,34
11689,0,0,0,2,2
11690,0,0,1,15,16
11691,0,3,8,12,23
11692,0,0,5,5,10
11693,0,0,2,6,8
11694,0,0,0,2,2
11695,0,0,1,6,7
11696,0,0,2,3,5
11697,1,0,6,6,13
11698,0,0,3,19,22
11699,0,0,6,3,9
11700,0,1,7,11,19
11701,0,2,13,10,25
11702,0,0,11,11,22
11703,0,0,11,11,22
11704,0,0,11,11,22
11705,0,0,0,2,2
11706,0,1,3,8,12
11707,0,0,7,3,10
11708,0,0,12,30,42
11709,0,0,5,9,14
11710,1,0,6,6,13
11711,0,0,3,5,8
11712,0,0,5,6,11
11713,0,0,2,15,17
11714,0,0,1,2,3
11715,0,0,6,17,23
11716,0,0,7,16,23
11717,0,1,3,7,11
11718,0,0,4,4,8
11719,0,0,1,5,6
11721,0,1,4,3,8
11722,0,0,10,19,29
11723,0,0,7,16,23
11724,0,1,5,12,18
11725,0,0,7,4,11
11726,0,1,3,22,26
11727,0,0,4,9,13
11729,0,0,17,24,41
11730,0,1,6,8,15
11731,0,2,4,9,15
11732,0,0,4,7,11
11733,1,0,6,6,13
11734,0,0,1,4,5
11735,0,0,0,5,5
11736,0,0,1,4,5
11737,0,0,4,7,11
11738,0,1,3,22,26
11739,0,1,3,22,26
11740,3,0,1,2,6
11741,0,0,3,2,5
11742,0,0,4,5,9
11743,0,0,1,4,5
11744,0,0,12,35,47
11745,0,0,6,9,15
11746,0,0,1,4,5
11747,0,0,7,16,23
11748,0,0,15,21,36
11749,0,0,21,28,49
11750,0,0,4,4,8
11751,3,0,1,2,6
11752,0,0,7,16,23
11753,0,2,19,29,50
11754,0,0,11,11,22
11755,0,0,3,2,5
11756,0,0,4,6,10
11757,0,0,1,4,5
11758,0,0,11,11,22
11759,0,0,11,11,22
11760,0,0,5,6,11
11761,0,0,4,7,11
11762,0,1,6,17,24
11763,0,0,3,2,5
11764,0,0,4,7,11
11765,0,0,6,5,11
11766,0,0,3,2,5
11767,0,1,3,22,26
11768,0,0,11,34,45
11769,0,0,6,5,11
11770,0,0,11,11,22
11771,0,0,3,2,5
11772,0,1,3,22,26
11773,0,0,11,11,22
11774,0,0,11,11,22
11775,0,1,3,22,26
11776,0,0,6,5,11
11777,0,0,7,14,21
11778,0,0,3,8,11
11779,0,1,3,22,26
11780,0,0,0,9,9
11781,0,0,6,5,11
11782,0,0,9,11,20
11783,0,1,3,22,26
11784,0,1,3,22,26
11786,1,0,5,15,21
11787,0,2,13,10,25
11788,0,0,5,12,17
11789,0,0,7,21,28
11790,0,0,6,3,9
11791,0,1,6,28,35
11792,0,0,1,4,5
11793,0,0,3,18,21
11794,0,0,1,7,8
11795,0,0,1,4,5
11796,0,0,3,4,7
11797,0,1,5,4,10
11799,0,0,9,18,27
11800,0,3,6,30,39
11801,0,4,7,18,29
11802,0,0,8,6,14
11803,0,0,3,9,12
11804,0,0,9,17,26
11805,0,0,6,10,16
11806,1,1,16,31,49
11807,0,0,2,9,11
11808,0,0,7,12,19
11809,0,0,1,6,7
11810,0,0,7,1,8
11811,0,0,3,6,9
11812,0,1,12,27,40
11813,0,3,3,10,16
11814,0,1,6,17,24
11815,0,0,11,20,31
11816,0,0,2,2,4
11817,0,2,4,11,17
11818,0,0,3,6,9
11819,0,0,6,12,18
11820,0,0,5,12,17
11821,0,0,18,30,48
11822,0,0,4,11,15
11823,0,0,2,9,11
11825,0,0,3,3,6
11826,0,0,1,4,5
11828,0,0,7,5,12
11829,0,0,0,5,5
11830,0,0,2,3,5
11831,1,0,6,9,16
11832,0,0,11,20,31
11833,0,1,4,12,17
11834,0,0,0,7,7
11835,0,0,6,11,17
11836,0,0,2,8,10
11837,0,0,2,14,16
11838,0,0,2,8,10
11840,0,1,9,21,31
11841,0,0,3,17,20
11842,0,0,3,5,8
11843,0,0,2,16,18
11844,1,0,8,23,32
11845,1,0,5,6,12
11846,0,0,1,6,7
11847,0,0,3,5,8
11848,0,1,6,21,28
11849,0,0,2,13,15
11850,0,0,1,0,1
11851,0,0,3,8,11
11852,0,1,6,7,14
11853,0,1,7,21,29
11854,0,0,4,11,15
11855,0,3,12,27,42
11856,0,0,3,4,7
11857,0,0,4,8,12
11858,0,0,6,17,23
11859,0,0,18,30,48
11860,0,0,4,11,15
11861,0,0,2,13,15
11862,0,0,6,17,23
11863,0,1,6,7,14
11864,0,0,6,13,19
11865,0,0,2,14,16
11866,0,0,4,8,12
11867,1,1,16,31,49
11868,0,0,6,18,24
11869,0,0,1,6,7
11870,0,0,10,30,40
11871,0,4,7,18,29
11872,0,1,6,21,28
11873,0,0,6,17,23
11874,0,0,3,6,9
11875,0,1,6,7,14
11876,0,0,2,3,5
11877,0,0,6,13,19
11878,0,0,7,10,17
11879,0,1,3,8,12
11880,0,1,11,17,29
11881,0,0,0,6,6
11882,0,0,12,23,35
11883,0,1,12,18,31
11884,1,1,5,23,30
11885,0,0,9,12,21
11886,0,0,4,5,9
11887,0,0,14,36,50
11888,0,0,9,17,26
11889,0,0,5,3,8
11891,0,0,5,2,7
11892,0,0,3,18,21
11893,0,0,3,7,10
11894,0,3,12,27,42
11895,0,5,7,25,37
11896,0,0,4,15,19
11897,0,0,9,11,20
11898,0,0,0,8,8
11899,0,0,8,7,15
11900,0,0,2,5,7
11901,1,2,5,11,19
11902,0,2,7,18,27
11903,0,0,4,12,16
11904,0,0,8,20,28
11905,0,0,1,4,5
11906,0,0,7,13,20
11907,0,2,4,11,17
11908,0,0,2,5,7
11910,0,1,7,17,25
11911,0,0,3,4,7
11912,0,1,5,11,17
11913,0,0,5,10,15
11914,0,1,3,10,14
11915,0,0,14,21,35
11916,0,0,8,15,23
11917,0,1,4,7,12
11918,0,0,6,4,10
11919,0,0,6,7,13
11920,0,1,6,22,29
11922,0,1,8,19,28
11923,0,1,18,29,48
11924,0,0,4,8,12
11925,0,2,7,15,24
11926,0,0,8,4,12
11927,0,0,11,17,28
11928,0,0,1,4,5
11930,0,0,4,13,17
11931,0,0,4,3,7
11932,0,0,13,37,50
11933,0,0,3,13,16
11934,0,0,6,12,18
11935,0,0,4,10,14
11936,0,1,2,5,8
11937,0,0,1,3,4
11938,0,0,1,15,16
11939,0,0,2,10,12
11940,1,0,12,12,25
11941,0,0,4,13,17
11942,0,0,2,5,7
11943,0,1,9,22,32
11944,1,2,2,9,14
11945,0,0,1,2,3
11946,0,0,5,9,14
11947,0,0,1,1,2
11948,1,0,6,5,12
11949,0,1,4,1,6
11950,0,0,0,6,6
11951,0,0,6,31,37
11952,0,0,2,3,5
11953,0,0,8,28,36
11954,0,0,6,17,23
11955,0,0,6,13,19
11956,0,0,4,9,13
11957,0,0,6,12,18
11958,0,0,5,6,11
11960,0,0,5,12,17
11961,0,0,2,5,7
11962,0,1,6,11,18
11963,0,0,4,22,26
11964,0,0,8,6,14
11965,0,1,3,8,12
11966,2,1,1,6,10
11967,0,0,3,5,8
11968,0,0,1,7,8
11969,0,0,1,4,5
11970,1,1,10,35,47
11971,0,1,6,7,14
11972,0,0,3,10,13
11973,0,0,11,16,27
11974,0,0,11,15,26
11975,0,0,8,15,23
11976,0,0,11,34,45
11977,0,0,4,8,12
11978,0,0,4,10,14
11979,0,0,2,3,5
11980,0,0,1,4,5
11981,0,0,7,17,24
11982,1,2,2,9,14
11983,1,1,10,35,47
11984,0,0,6,17,23
11985,0,0,6,26,32
11986,0,1,6,7,14
11987,0,0,5,6,11
11988,0,0,5,9,14
11989,0,0,9,32,41
11990,0,0,12,23,35
11991,0,0,6,26,32
11992,0,0,4,10,14
11993,0,0,12,23,35
11994,0,0,11,34,45
11995,0,0,11,34,45
11996,0,1,6,7,14
11997,0,0,6,17,23
11998,0,1,2,10,13
11999,0,0,6,7,13
12000,0,2,10,19,31
12001,0,1,11,18,30
12002,0,0,9,27,36
12003,0,0,10,32,42
12004,0,0,6,10,16
12005,0,0,5,17,22
12006,0,0,4,11,15
12007,0,0,5,11,16
12008,0,0,7,12,19
12009,0,2,2,8,12
12010,0,0,7,3,10
12011,0,1,11,37,49
12012,0,0,2,1,3
12013,0,0,8,15,23
12014,0,0,3,18,21
12015,0,1,6,15,22
12016,0,0,9,9,18
12017,0,0,6,12,18
12018,0,1,2,6,9
12019,0,0,5,14,19
12020,0,0,11,18,29
12021,0,0,5,0,5
12022,0,0,11,17,28
12023,0,0,8,13,21
12024,0,0,2,8,10
12025,0,0,6,7,13
12026,0,1,6,20,27
12027,0,1,6,12,19
12028,0,1,8,22,31
12029,0,0,2,7,9
12030,0,1,0,5,6
12031,1,1,10,35,47
12032,1,0,5,8,14
12033,0,0,11,25,36
12034,0,1,6,9,16
12035,2,0,1,23,26
12036,1,0,2,32,35
12037,0,0,2,6,8
12038,0,0,2,3,5
12039,0,0,1,24,25
12041,0,0,6,3,9
12042,0,0,5,16,21
12043,0,0,5,16,21
12044,0,0,5,2,7
12045,0,0,5,11,16
12046,0,0,10,24,34
12047,1,1,10,35,47
12048,0,0,6,19,25
12049,0,0,4,11,15
12050,0,1,4,12,17
12051,0,1,0,5,6
12052,0,1,16,33,50
12053,0,0,1,24,25
12054,1,0,13,32,46
12055,0,0,5,2,7
12056,0,1,2,38,41
12057,6,0,8,30,44
12058,0,0,2,3,5
12059,1,0,10,25,36
12060,0,0,2,25,27
12061,0,1,10,30,41
12062,1,0,2,3,6
12063,1,1,7,18,27
12064,0,0,7,8,15
12065,0,1,6,12,19
12066,0,1,12,14,27
12067,0,0,7,17,24
12069,0,1,8,10,19
12070,0,0,7,9,16
12071,0,0,7,41,48
12072,1,0,2,4,7
12073,0,0,10,17,27
12074,0,1,6,27,34
12075,0,0,7,21,28
12076,0,0,5,9,14
12077,0,0,4,11,15
12078,0,0,2,3,5
12079,0,0,5,8,13
12080,0,0,6,5,11
12081,0,1,5,17,23
12082,0,1,8,10,19
12083,0,0,6,7,13
12084,0,0,11,39,50
12085,0,0,0,8,8
12086,0,0,6,11,17
12087,0,0,6,27,33
12088,0,5,1,3,9
12089,0,1,17,28,46
12090,0,0,2,14,16
12091,0,0,2,5,7
12092,0,1,10,16,27
12093,0,1,12,19,32
12094,0,0,5,12,17
12095,0,0,2,12,14
12096,0,1,10,16,27
12097,1,0,7,16,24
12098,0,0,2,3,5
12099,0,0,2,14,16
12100,3,0,2,12,17
12101,0,0,11,23,34
12102,0,0,3,4,7
12103,0,0,7,14,21
12104,0,1,2,8,11
12105,0,0,10,27,37
12106,0,5,7,25,37
12107,0,0,4,9,13
12108,0,0,4,15,19
12109,0,0,6,9,15
12110,0,0,2,4,6
12111,0,0,4,6,10
12112,0,0,7,15,22
12113,0,0,5,9,14
12114,1,1,8,21,31
12115,0,0,9,10,19
12116,0,0,7,18,25
12117,0,0,16,24,40
12118,1,1,13,18,33
12119,0,0,6,12,18
12120,0,1,12,12,25
12121,0,0,3,16,19
12122,0,0,11,23,34
12123,0,3,4,14,21
12124,0,0,6,15,21
12125,0,0,3,4,7
12126,0,0,6,5,11
12127,0,0,4,11,15
12129,0,1,0,5,6
12130,0,0,4,8,12
12131,0,0,2,11,13
12132,0,0,5,12,17
12133,0,0,13,33,46
12134,0,0,1,10,11
12135,0,1,4,28,33
12136,0,0,4,8,12
12137,0,0,4,16,20
12138,0,1,0,5,6
12139,0,0,4,11,15
12140,0,0,13,37,50
12141,1,0,2,4,7
12142,0,1,8,2,11
12143,0,0,1,12,13
12144,0,0,0,6,6
12145,0,2,2,17,21
12146,0,0,1,7,8
12147,0,0,0,5,5
12148,0,4,7,18,29
12149,0,0,0,4,4
12151,0,0,9,19,28
12152,0,1,7,9,17
12153,0,3,8,10,21
12154,0,0,3,2,5
12155,1,0,11,33,45
12156,0,0,11,25,36
12157,1,0,0,8,9
12158,0,0,3,6,9
12159,0,1,12,26,39
12160,0,0,8,9,17
12161,0,0,8,21,29
12162,0,0,10,25,35
12163,0,0,9,28,37
12164,0,0,6,9,15
12165,0,1,19,29,49
12166,0,0,5,15,20
12167,0,1,8,12,21
12168,0,0,2,13,15
12169,0,0,10,9,19
12170,2,0,11,16,29
12171,0,0,1,9,10
12172,0,0,3,10,13
12173,0,0,2,17,19
12174,0,1,6,10,17
12175,0,0,11,15,26
12176,1,0,1,10,12
12177,0,0,1,8,9
12178,0,0,0,3,3
12179,1,1,8,8,18
12180,0,2,0,6,8
12181,0,0,2,14,16
12182,0,0,3,6,9
12183,0,0,7,5,12
12184,0,0,2,9,11
12185,0,0,5,12,17
12186,0,0,4,13,17
12187,0,0,13,37,50
12188,0,0,5,2,7
12189,0,0,6,6,12
12190,0,0,2,1,3
12191,1,0,0,0,1
12192,0,0,2,7,9
12193,0,0,0,5,5
12195,0,0,18,30,48
12196,0,0,5,10,15
12197,0,0,6,17,23
12198,0,0,5,9,14
12200,0,0,3,6,9
12201,0,0,1,4,5
12202,0,0,4,25,29
12203,0,1,17,28,46
12204,0,0,2,8,10
12205,0,0,14,18,32
12206,0,1,9,31,41
12207,0,0,8,14,22
12208,0,0,10,20,30
12209,0,0,16,28,44
12210,0,0,3,20,23
12211,0,0,7,14,21
12212,0,0,1,8,9
12213,0,0,12,18,30
12214,0,0,11,28,39
12215,0,0,6,6,12
12216,0,0,18,30,48
12217,0,0,7,10,17
12218,0,0,3,4,7
12219,0,5,5,22,32
12220,0,0,6,10,16
12221,0,0,2,14,16
12222,0,1,5,6,12
12224,0,0,5,9,14
12225,0,0,1,4,5
12226,0,0,6,17,23
12227,0,0,10,19,29
12228,0,0,1,17,18
12229,0,2,2,17,21
12230,0,0,6,17,23
12231,0,0,3,6,9
12232,0,4,7,18,29
12233,0,1,5,9,15
12234,0,0,4,15,19
12235,0,0,11,23,34
12236,1,0,4,43,48
12237,0,0,2,3,5
12238,0,1,4,5,10
12239,0,0,4,15,19
12240,0,1,2,19,22
12241,0,0,10,20,30
12242,0,0,13,37,50
12243,0,0,2,3,5
12244,0,0,5,9,14
12246,0,0,5,6,11
12247,0,0,4,18,22
12248,0,4,12,19,35
12249,0,1,6,8,15
12250,0,0,8,42,50
12251,0,0,7,15,22
12252,0,0,1,9,10
12253,0,0,5,17,22
12254,1,2,8,25,36
12255,0,1,8,24,33
12256,0,0,3,3,6
12257,0,1,15,31,47
12258,0,0,7,10,17
12259,0,0,2,16,18
12260,0,0,3,11,14
12261,1,0,0,8,9
12262,0,1,11,16,28
12264,0,0,1,25,26
12265,1,0,5,6,12
12267,0,1,8,15,24
12268,0,0,13,37,50
12271,0,0,3,18,21
12272,0,0,2,3,5
12273,0,0,8,42,50
12274,0,1,4,11,16
12275,0,0,2,15,17
12276,0,0,11,34,45
12277,0,0,6,8,14
12278,0,0,2,15,17
12279,0,0,1,25,26
12280,1,0,5,8,14
12281,0,0,1,14,15
12282,0,0,11,34,45
12283,0,0,11,34,45
12284,0,3,5,16,24
12285,0,0,6,12,18
12286,0,0,8,8,16
12287,0,0,1,31,32
12288,0,0,6,12,18
12289,0,1,5,15,21
12291,0,0,8,10,18
12293,0,0,6,12,18
12294,0,0,3,8,11
12295,0,1,3,6,10
12296,0,0,11,12,23
12297,0,1,2,27,30
12299,0,1,9,33,43
12300,0,0,1,8,9
12301,0,3,2,9,14
12302,0,1,7,11,19
12303,0,0,3,5,8
12304,0,0,4,14,18
12305,0,0,10,15,25
12306,0,0,7,9,16
12308,0,0,8,14,22
12310,0,0,8,11,19
12311,0,0,7,0,7
12312,0,0,7,12,19
12313,0,0,4,12,16
12314,0,0,10,22,32
12315,0,0,3,1,4
12316,0,1,2,3,6
12317,0,1,9,10,20
12318,0,2,7,10,19
12319,0,0,2,13,15
12320,0,0,14,14,28
12321,0,0,3,8,11
12322,0,0,1,7,8
12323,0,0,6,9,15
12324,0,0,8,13,21
12325,0,1,4,1,6
12326,0,1,3,15,19
12327,0,0,2,1,3
12328,0,1,2,27,30
12329,0,0,1,10,11
12330,0,1,14,26,41
12331,0,0,6,19,25
12332,0,0,3,8,11
12333,0,0,3,5,8
12334,0,0,7,4,11
12335,0,2,4,5,11
12336,0,0,11,19,30
12337,0,2,3,8,13
12338,0,0,2,6,8
12339,0,0,2,5,7
12341,0,0,4,8,12
12342,0,0,5,5,10
12343,0,0,1,6,7
12344,0,0,9,7,16
12345,0,1,4,10,15
12346,0,9,7,18,34
12347,0,0,2,4,6
12348,0,0,5,7,12
12349,0,4,6,15,25
12350,0,0,0,11,11
12351,0,0,3,3,6
12352,1,0,1,16,18
12353,0,0,3,4,7
12354,0,0,17,25,42
12355,0,1,8,11,20
12356,0,0,3,0,3
12357,0,0,6,5,11
12358,0,0,7,18,25
12359,0,0,7,6,13
12360,0,3,7,18,28
12361,1,1,6,28,36
12362,0,0,3,8,11
12363,0,0,2,9,11
12364,0,0,12,13,25
12368,0,0,7,15,22
12370,0,1,1,6,8
12371,1,0,4,9,14
12372,0,0,6,12,18
12373,0,0,11,12,23
12374,0,0,14,19,33
12375,0,0,1,6,7
12376,0,0,11,20,31
12377,0,0,14,34,48
12378,0,0,14,19,33
12379,0,0,9,29,38
12380,2,0,0,5,7
12381,0,0,16,31,47
12382,0,0,3,5,8
12383,0,0,3,8,11
12384,0,1,5,15,21
12385,0,0,1,6,7
12386,0,1,7,17,25
12387,0,0,7,3,10
12389,0,1,9,33,43
12390,0,0,6,12,18
12391,0,1,5,15,21
12392,0,1,15,32,48
12393,0,0,18,30,48
12394,0,0,1,6,7
12395,0,9,7,18,34
12396,0,0,3,18,21
12397,0,0,3,8,11
12398,0,0,14,19,33
12399,2,1,6,39,48
12400,0,0,18,30,48
12401,0,0,7,3,10
12402,0,0,9,16,25
12403,0,1,7,17,25
12404,1,1,6,28,36
12405,0,2,4,5,11
12406,0,0,14,19,33
12407,2,1,6,39,48
12408,0,1,6,6,13
12409,0,0,1,8,9
12410,0,0,6,12,18
12411,0,1,1,3,5
12412,0,0,7,9,16
12413,0,0,3,8,11
12414,0,0,3,14,17
12415,0,0,11,12,23
12416,0,0,2,16,18
12417,0,0,3,8,11
12420,0,0,5,10,15
12421,0,0,1,8,9
12422,0,1,1,3,5
12423,0,1,5,9,15
12424,0,0,6,15,21
12425,0,0,7,9,16
12426,0,0,16,23,39
12427,0,0,10,20,30
12428,0,0,8,16,24
12429,0,0,5,18,23
12430,0,0,5,8,13
12431,0,0,1,12,13
12432,0,1,6,39,46
12433,0,0,9,7,16
12434,0,0,0,5,5
12435,0,1,1,7,9
12436,0,0,10,37,47
12437,0,0,0,5,5
12438,0,0,2,5,7
12439,0,1,7,11,19
12440,0,0,2,3,5
12441,0,0,2,8,10
12442,0,0,4,17,21
12443,0,0,2,3,5
12444,0,0,9,9,18
12445,0,0,5,20,25
12446,0,3,2,9,14
12447,0,0,3,3,6
12448,0,0,7,6,13
12449,0,1,3,22,26
12450,1,1,3,14,19
12451,0,0,4,1,5
12452,0,0,1,5,6
12453,0,0,4,12,16
12454,0,0,4,13,17
12455,0,0,10,20,30
12456,0,0,7,5,12
12457,0,0,4,8,12
12458,0,0,3,16,19
12459,0,0,0,5,5
12460,0,0,9,20,29
12462,0,3,7,18,28
12463,0,0,1,13,14
12464,0,0,12,11,23
12465,0,0,8,18,26
12466,0,0,7,20,27
12467,0,0,2,10,12
12468,0,0,3,6,9
12469,0,0,5,9,14
12470,0,0,5,12,17
12471,0,1,3,10,14
12472,0,0,4,1,5
12473,0,1,3,9,13
12474,0,0,6,9,15
12476,0,0,3,7,10
12477,0,1,1,20,22
12478,0,2,7,31,40
12479,0,0,5,21,26
12480,0,0,4,9,13
12481,1,0,8,10,19
12482,0,0,3,9,12
12483,0,0,9,18,27
12484,0,0,2,36,38
12485,0,0,5,6,11
12486,0,0,2,14,16
12487,0,0,5,6,11
12488,0,0,7,10,17
12490,0,0,4,8,12
12491,0,2,2,22,26
12492,0,0,6,18,24
12493,0,0,8,13,21
12494,0,0,4,9,13
12495,0,2,1,19,22
12496,0,1,8,7,16
12497,0,0,4,2,6
12498,0,1,6,21,28
12499,0,1,9,17,27
12500,0,0,3,15,18
12501,0,0,7,12,19
12502,0,0,8,3,11
12503,0,0,8,7,15
12504,0,0,10,13,23
12505,0,0,13,19,32
12506,0,1,6,6,13
12507,0,0,6,6,12
12508,0,0,3,5,8
12509,0,0,3,8,11
12510,0,0,3,8,11
12511,1,0,3,11,15
12512,0,0,11,12,23
12514,0,1,5,11,17
12515,0,0,4,21,25
12516,0,0,4,5,9
12517,1,3,5,5,14
12518,0,0,0,7,7
12520,0,1,1,9,11
12521,0,0,2,7,9
12522,0,0,1,4,5
12523,0,0,2,9,11
12524,0,1,2,13,16
12525,0,0,3,3,6
12526,0,1,9,3,13
12527,1,0,1,15,17
12528,0,1,13,21,35
12529,0,0,11,20,31
12530,0,0,5,1,6
12531,0,0,5,3,8
12532,0,0,3,8,11
12533,0,0,7,10,17
12534,0,0,10,17,27
12535,0,0,6,14,20
12536,0,0,2,16,18
12537,1,0,6,27,34
12538,0,0,5,6,11
12539,0,1,10,7,18
12540,0,0,2,6,8
12541,0,0,1,3,4
12542,0,0,10,24,34
12543,0,0,9,14,23
12544,0,0,3,7,10
12545,0,0,10,6,16
12546,0,2,11,13,26
12547,0,0,10,14,24
12548,0,0,2,8,10
12550,0,0,4,4,8
12551,1,1,9,38,49
12552,0,0,19,30,49
12553,0,0,9,9,18
12554,0,1,9,3,13
12555,0,0,6,16,22
12556,0,0,8,17,25
12557,0,0,3,10,13
12558,0,1,3,5,9
12559,0,0,7,10,17
12560,0,0,0,1,1
12562,0,0,1,11,12
12563,0,0,15,33,48
12565,0,0,0,5,5
12566,0,0,0,6,6
12567,0,0,5,15,20
12568,0,0,11,31,42
12570,0,0,9,23,32
12571,1,0,0,18,19
12572,0,0,3,14,17
12573,0,0,3,8,11
12574,0,2,4,11,17
12576,0,0,4,9,13
12577,0,0,0,13,13
12580,0,0,1,6,7
12581,0,0,3,24,27
12582,0,0,3,12,15
12583,0,0,2,8,10
12584,0,0,4,5,9
12585,0,1,6,7,14
12586,0,0,12,20,32
12587,0,0,2,3,5
12588,0,0,5,18,23
12589,0,0,5,8,13
12590,0,0,11,30,41
12591,0,0,1,7,8
12592,0,0,15,35,50
12593,0,0,11,27,38
12594,0,0,3,7,10
12595,0,0,11,39,50
12596,0,0,6,9,15
12597,0,2,13,26,41
12598,0,0,6,30,36
12599,0,0,8,28,36
12600,0,0,9,23,32
12601,0,1,5,22,28
12602,0,0,7,3,10
12603,0,0,2,5,7
12604,0,0,4,21,25
12605,0,0,0,6,6
12606,0,0,7,10,17
12607,0,0,1,6,7
12609,0,0,3,24,27
12610,1,0,0,18,19
12611,1,0,3,11,15
12612,0,0,1,6,7
12613,0,0,0,19,19
12614,0,2,4,29,35
12615,0,0,5,19,24
12616,0,0,1,7,8
12617,0,0,0,13,13
12618,0,0,7,3,10
12619,0,0,4,9,13
12620,0,0,12,19,31
12621,0,0,1,7,8
12622,0,0,4,14,18
12623,0,0,2,16,18
12624,0,2,4,14,20
12625,1,0,11,37,49
12626,0,0,9,12,21
12627,0,2,6,13,21
12628,0,0,3,17,20
12629,0,0,5,16,21
12630,0,0,15,25,40
12631,0,0,10,25,35
12632,0,0,0,6,6
12633,0,3,21,23,47
12634,0,0,16,23,39
12635,0,0,6,4,10
12636,1,0,12,21,34
12637,0,1,3,18,22
12638,0,0,1,22,23
12639,0,1,1,14,16
12640,0,0,7,23,30
12641,0,0,4,8,12
12642,0,1,13,22,36
12643,0,0,0,13,13
12644,0,0,2,5,7
12646,0,0,3,10,13
12647,0,1,12,35,48
12648,0,0,5,16,21
12649,0,0,3,9,12
12650,0,2,2,11,15
12652,0,0,2,4,6
12653,0,0,2,14,16
12654,0,0,4,14,18
12655,0,0,10,18,28
12656,0,0,1,7,8
12657,0,1,10,29,40
12659,0,0,7,4,11
12660,1,0,3,6,10
12661,0,0,1,6,7
12662,0,0,4,11,15
12663,0,0,10,8,18
12664,0,0,1,8,9
12665,0,0,10,7,17
12666,0,0,4,13,17
12667,0,0,18,15,33
12668,0,0,12,20,32
12669,0,1,18,28,47
12670,0,0,5,11,16
12671,0,1,7,31,39
12672,0,0,14,20,34
12673,0,0,0,5,5
12674,0,0,5,6,11
12675,0,0,8,12,20
12676,0,0,7,12,19
12677,0,0,14,28,42
12678,0,0,7,18,25
12679,0,0,5,9,14
12680,0,0,13,12,25
12681,0,1,2,14,17
12683,0,0,1,22,23
12684,0,3,11,36,50
12685,0,1,8,10,19
12686,0,0,1,4,5
12687,0,1,9,12,22
12688,0,0,7,19,26
12689,0,0,5,17,22
12690,0,0,4,11,15
12691,0,0,5,7,12
12692,0,0,8,7,15
12693,0,0,4,7,11
12694,0,0,0,1,1
12695,0,0,4,16,20
12696,0,0,2,3,5
12697,0,1,3,13,17
12698,0,0,2,10,12
12699,0,0,1,6,7
12700,0,1,4,20,25
12701,2,2,5,34,43
12702,0,0,6,7,13
12703,0,0,1,4,5
12704,0,1,11,8,20
12705,0,0,8,16,24
12706,0,0,10,15,25
12707,0,0,9,16,25
12708,0,0,13,36,49
12709,0,0,10,15,25
12710,0,0,3,6,9
12711,0,0,10,10,20
12712,0,0,6,20,26
12713,0,0,7,14,21
12714,0,0,3,8,11
12715,0,0,5,29,34
12716,0,0,0,5,5
12717,0,0,10,12,22
12718,0,2,3,6,11
12719,0,0,7,3,10
12720,0,2,5,12,19
12721,0,0,3,6,9
12722,1,0,10,17,28
12723,0,2,2,6,10
12724,0,0,15,24,39
12725,0,0,6,11,17
12727,0,0,6,11,17
12728,1,0,13,32,46
12729,0,0,11,15,26
12730,0,1,7,18,26
12731,0,0,7,10,17
12732,0,0,4,5,9
12733,0,0,3,24,27
12734,0,0,16,34,50
12735,0,0,4,4,8
12736,0,0,0,5,5
12737,0,0,16,17,33
12738,0,1,11,25,37
12739,0,0,2,9,11
12740,0,0,1,3,4
12741,0,0,11,11,22
12742,0,0,6,7,13
12743,0,0,2,13,15
12744,0,1,2,2,5
12745,0,2,2,22,26
12746,0,0,7,9,16
12747,0,0,5,12,17
12749,0,2,4,5,11
12750,0,0,1,15,16
12752,0,0,11,27,38
12753,0,3,4,29,36
12754,0,0,14,31,45
12755,0,0,11,22,33
12756,0,1,6,27,34
12757,0,0,11,30,41
12758,0,1,0,5,6
12759,0,1,1,14,16
12760,1,0,12,6,19
12761,0,0,16,26,42
12762,0,5,6,17,28
12763,0,0,11,39,50
12764,0,0,14,25,39
12765,0,3,9,38,50
12766,1,0,3,6,10
12767,0,0,10,24,34
12768,0,0,7,33,40
12769,1,0,6,17,24
12770,0,0,9,10,19
12771,0,1,3,24,28
12772,0,0,4,4,8
12773,1,0,1,5,7
12774,0,0,14,25,39
12775,1,0,9,34,44
12776,0,2,13,26,41
12777,0,0,2,14,16
12778,3,0,0,15,18
12779,0,0,9,13,22
12781,0,0,2,14,16
12782,0,0,7,9,16
12783,0,0,4,16,20
12784,0,0,2,14,16
12785,0,0,10,10,20
12786,3,1,1,15,20
12787,0,0,4,21,25
12788,0,0,5,10,15
12789,0,0,14,25,39
12790,0,1,13,31,45
12791,3,1,1,15,20
12792,0,0,0,4,4
12793,3,0,0,15,18
12794,0,0,0,13,13
12795,0,0,6,13,19
12796,0,0,0,13,13
12797,0,2,4,5,11
12798,0,0,1,8,9
12799,0,0,7,8,15
12800,3,0,4,11,18
12801,0,1,5,14,20
12802,0,1,7,11,19
12803,0,0,3,14,17
12804,0,0,12,27,39
12805,0,0,5,13,18
12806,0,0,9,38,47
12807,0,1,6,15,22
12808,0,0,7,35,42
12809,0,0,1,18,19
12810,0,0,0,2,2
12812,0,1,3,16,20
12813,0,1,6,39,46
12814,0,2,14,33,49
12815,0,0,5,19,24
12816,0,0,2,20,22
12817,0,0,9,5,14
12818,0,1,4,7,12
12819,0,0,1,9,10
12820,0,1,4,15,20
12821,0,0,8,10,18
12822,1,0,10,30,41
12823,0,2,13,21,36
12824,1,0,3,8,12
12825,0,0,1,10,11
12826,0,0,5,16,21
12827,1,1,8,17,27
12828,0,0,3,9,12
12829,0,0,3,6,9
12830,0,1,8,23,32
12831,0,0,5,18,23
12832,0,0,1,10,11
12833,0,0,4,8,12
12834,1,0,10,25,36
12835,0,0,4,2,6
12836,0,2,12,36,50
12837,0,0,4,11,15
12838,0,1,4,7,12
12839,0,0,1,16,17
12840,0,0,4,9,13
12842,0,0,1,7,8
12843,0,0,0,3,3
12844,0,1,7,40,48
12845,0,0,1,2,3
12846,0,0,3,7,10
12847,0,0,2,6,8
12848,0,2,5,19,26
12849,0,0,11,24,35
12850,0,2,17,26,45
12851,0,0,3,6,9
12852,0,0,6,24,30
12853,0,0,14,25,39
12854,1,0,5,15,21
12855,0,0,6,4,10
12856,0,0,0,7,7
12857,0,1,3,12,16
12858,0,0,0,2,2
12859,0,2,7,9,18
12860,0,0,9,14,23
12861,0,0,0,15,15
12862,0,0,3,4,7
12863,0,0,14,23,37
12864,0,1,11,9,21
12865,0,0,6,4,10
12866,0,0,1,8,9
12867,0,1,4,7,12
12868,0,0,5,12,17
12869,0,0,3,24,27
12870,0,1,3,3,7
12871,0,0,0,5,5
12872,0,0,11,19,30
12873,0,0,7,6,13
12874,0,1,5,6,12
12875,0,0,2,11,13
12876,0,0,9,18,27
12877,0,0,7,8,15
12878,0,0,3,3,6
12879,1,0,4,7,12
12881,0,0,1,12,13
12882,0,0,7,9,16
12883,0,1,10,12,23
12884,0,2,6,20,28
12885,0,2,1,10,13
12886,0,0,10,21,31
12887,0,1,7,9,17
12888,0,0,25,16,41
12889,0,0,8,28,36
12890,0,1,9,28,38
12891,0,0,9,11,20
12892,0,1,1,15,17
12893,0,1,2,8,11
12894,0,0,10,18,28
12895,0,2,10,36,48
12896,0,0,8,37,45
12897,0,0,7,14,21
12898,0,0,7,11,18
12899,0,1,5,15,21
12900,0,0,2,3,5
12901,0,0,7,12,19
12903,0,0,1,11,12
12904,0,0,5,8,13
12905,1,0,2,24,27
12906,0,0,3,8,11
12907,0,0,8,7,15
12908,0,0,5,16,21
12909,1,0,2,7,10
12910,0,0,8,9,17
12911,0,0,4,9,13
12912,0,0,5,15,20
12913,0,0,2,22,24
12914,0,0,4,2,6
12915,0,0,1,4,5
12916,0,0,3,24,27
12917,0,1,7,40,48
12918,0,0,20,17,37
12919,0,1,7,13,21
12920,0,1,5,17,23
12921,0,0,2,22,24
12922,0,1,2,8,11
12923,0,0,1,4,5
12924,0,1,5,15,21
12925,0,0,2,29,31
12926,0,0,2,24,26
12927,0,0,1,7,8
12928,0,0,4,9,13
12929,0,0,10,39,49
12930,0,0,13,26,39
12931,0,0,9,21,30
12932,0,0,6,13,19
12933,0,0,2,19,21
12934,0,0,4,9,13
12935,0,0,5,14,19
12936,0,1,3,17,21
12937,0,0,5,2,7
12938,0,0,6,23,29
12939,0,0,3,4,7
12940,1,0,3,29,33
12941,0,0,0,8,8
12942,0,0,7,11,18
12943,0,0,0,9,9
12944,0,0,6,16,22
12945,1,0,3,14,18
12946,0,0,7,16,23
12947,0,1,0,10,11
12949,0,0,2,6,8
12950,0,0,2,3,5
12951,0,0,6,18,24
12952,0,0,10,20,30
12953,0,0,1,13,14
12954,0,0,10,14,24
12955,0,1,14,16,31
12956,0,0,7,13,20
12957,0,0,1,4,5
12958,0,0,6,12,18
12959,0,0,6,5,11
12961,0,0,1,10,11
12962,0,0,0,13,13
12963,0,0,6,9,15
12964,0,0,7,15,22
12965,0,1,5,24,30
12966,0,0,2,6,8
12967,0,0,0,11,11
12968,0,0,3,8,11
12969,0,0,3,3,6
12970,0,1,9,8,18
12971,0,0,4,5,9
12972,0,0,3,3,6
12973,0,0,6,4,10
12974,0,0,11,16,27
12975,0,0,9,7,16
12976,0,1,3,21,25
12977,0,0,3,15,18
12978,0,0,10,32,42
12979,0,0,2,4,6
12981,0,0,4,7,11
12982,0,3,7,9,19
12983,0,1,3,5,9
12984,0,1,7,40,48
12985,0,0,0,6,6
12987,0,1,1,8,10
12988,0,0,3,6,9
12989,0,1,3,24,28
12990,1,0,0,13,14
12991,0,0,5,15,20
12992,0,0,8,16,24
12993,0,0,8,28,36
12994,0,0,3,4,7
12995,0,1,9,40,50
12996,0,0,1,30,31
12997,0,1,0,9,10
12998,1,2,8,30,41
12999,0,0,11,10,21
13000,0,1,1,8,10
13001,0,0,9,12,21
13002,0,0,1,11,12
13003,0,0,2,33,35
13004,1,0,16,26,43
13005,0,0,10,10,20
13006,0,0,3,4,7
13007,0,1,7,40,48
13008,0,1,11,25,37
13009,0,0,4,11,15
13010,1,0,3,29,33
13011,1,1,3,33,38
13012,0,0,6,13,19
13013,0,1,3,24,28
13014,0,0,13,26,39
13015,0,0,13,12,25
13016,0,3,7,9,19
13018,0,0,2,4,6
13019,0,0,9,29,38
13021,1,0,0,13,14
13022,0,0,4,9,13
13023,0,0,10,9,19
13024,0,0,3,11,14
13025,0,1,1,3,5
13026,0,1,3,5,9
13027,0,1,9,33,43
13028,0,0,6,7,13
13029,0,1,3,17,21
13030,0,0,8,16,24
13031,0,0,1,13,14
13032,0,0,1,8,9
13033,0,0,8,22,30
13034,0,0,3,31,34
13035,1,0,2,29,32
13036,0,1,8,14,23
13037,0,1,3,9,13
13038,0,0,5,19,24
13039,0,0,11,22,33
13040,0,0,11,12,23
13041,0,0,7,20,27
13042,0,0,8,15,23
13043,0,1,8,10,19
13044,1,0,3,15,19
13045,0,0,4,8,12
13046,1,1,2,9,13
13047,0,0,6,19,25
13049,0,0,2,13,15
13050,0,0,0,5,5
13051,0,1,1,20,22
13052,0,3,4,32,39
13053,0,0,6,4,10
13055,0,0,3,44,47
13056,0,0,5,20,25
13057,1,1,11,25,38
13058,0,1,2,6,9
13059,0,0,13,16,29
13060,0,0,9,17,26
13061,0,1,2,8,11
13062,1,0,9,19,29
13063,0,0,3,3,6
13064,0,1,2,22,25
13065,0,0,1,8,9
13066,0,0,5,2,7
13067,0,2,4,11,17
13068,0,0,0,10,10
13069,0,0,9,17,26
13070,0,1,1,12,14
13071,0,0,4,3,7
13072,0,0,8,12,20
13073,0,0,8,28,36
13074,0,0,3,15,18
13075,0,0,7,19,26
13076,0,0,5,8,13
13077,0,0,1,13,14
13078,1,0,1,8,10
13079,0,1,12,18,31
13080,0,0,0,6,6
13081,0,0,3,15,18
13082,0,1,4,10,15
13083,0,1,6,8,15
13084,0,0,14,33,47
13085,0,0,6,8,14
13086,0,0,1,15,16
13087,0,0,4,3,7
13088,0,0,14,28,42
13090,0,0,3,4,7
13091,0,0,7,13,20
13092,0,0,15,20,35
13093,0,1,0,4,5
13094,0,0,5,8,13
13095,0,0,8,24,32
13096,1,0,4,16,21
13097,0,0,1,15,16
13098,0,0,2,7,9
13099,0,0,5,8,13
13100,0,0,8,16,24
13101,0,0,7,1,8
13102,0,0,8,12,20
13103,0,1,12,12,25
13104,0,0,6,12,18
13105,0,1,3,10,14
13106,0,0,11,13,24
13107,0,0,7,4,11
13108,0,0,2,11,13
13109,0,0,4,9,13
13110,0,0,1,6,7
13111,0,0,5,7,12
13112,0,0,7,5,12
13113,0,0,0,7,7
13114,0,0,2,12,14
13115,0,0,3,5,8
13116,0,0,1,6,7
13117,0,0,3,13,16
13118,0,0,1,11,12
13119,0,0,5,18,23
13120,0,0,5,3,8
13121,0,0,4,6,10
13122,0,0,1,6,7
13123,0,0,0,3,3
13124,0,2,6,18,26
13125,1,1,3,19,24
13126,0,0,4,7,11
13127,0,0,4,24,28
13128,0,0,16,14,30
13129,0,0,1,4,5
13130,0,0,6,13,19
13131,0,0,5,4,9
13132,0,0,3,15,18
13133,1,0,7,29,37
13134,0,2,5,10,17
13135,0,0,4,17,21
13136,0,0,2,10,12
13137,0,0,4,19,23
13138,0,0,6,4,10
13139,0,0,4,4,8
13140,0,0,0,6,6
13141,0,0,1,8,9
13142,0,1,10,18,29
13143,0,0,3,7,10
13144,0,0,3,11,14
13145,0,0,7,17,24
13146,1,1,5,4,11
13147,0,0,9,7,16
13148,0,0,6,7,13
13150,0,1,1,17,19
13151,0,0,2,3,5
13152,0,0,13,20,33
13153,0,1,10,11,22
13154,0,0,7,9,16
13155,0,0,14,36,50
13156,0,0,8,6,14
13157,0,0,14,18,32
13158,0,0,4,2,6
13159,0,0,6,5,11
13160,0,0,1,6,7
13161,0,0,10,16,26
13162,0,0,4,10,14
13163,0,0,5,8,13
13164,0,0,5,15,20
13165,0,0,8,1,9
13166,0,0,11,8,19
13167,0,3,4,37,44
13168,0,0,5,8,13
13169,0,0,3,11,14
13170,0,0,5,19,24
13171,0,1,1,3,5
13172,0,1,8,11,20
13173,0,0,0,10,10
13174,0,0,2,24,26
13175,0,1,2,21,24
13176,0,5,12,33,50
13177,1,0,14,34,49
13178,2,1,7,17,27
13179,0,0,8,22,30
13180,0,0,0,6,6
13181,0,0,7,21,28
13182,1,0,9,40,50
13183,0,1,0,6,7
13184,2,0,7,14,23
13185,0,0,16,25,41
13186,3,1,8,24,36
13187,0,1,6,27,34
13188,0,0,10,27,37
13189,0,0,14,19,33
13190,0,0,11,12,23
13191,0,0,10,16,26
13192,0,1,9,6,16
13193,0,0,1,6,7
13194,1,0,12,16,29
13195,0,0,5,9,14
13196,0,0,9,21,30
13197,0,1,5,6,12
13198,0,0,9,19,28
13199,0,1,6,6,13
13200,0,0,6,22,28
13201,0,0,5,14,19
13202,0,0,4,17,21
13203,0,0,11,16,27
13204,0,2,12,25,39
13205,1,0,5,16,22
13206,0,0,12,38,50
13207,0,2,11,28,41
13208,0,0,10,10,20
13209,0,0,1,9,10
13210,0,2,10,29,41
13211,0,0,4,11,15
13212,0,0,2,0,2
13213,0,0,7,28,35
13214,0,1,4,25,30
13215,1,0,7,7,15
13216,0,0,11,27,38
13217,0,0,3,9,12
13218,0,2,9,27,38
13219,0,1,1,8,10
13220,0,1,3,10,14
13221,0,0,3,14,17
13222,0,0,1,7,8
13223,0,0,5,6,11
13224,0,0,6,7,13
13225,0,0,10,8,18
13226,0,0,16,32,48
13227,0,1,7,19,27
13228,0,0,7,19,26
13229,0,0,3,4,7
13230,0,0,5,14,19
13231,0,0,11,26,37
13232,0,3,10,34,47
13233,0,0,5,28,33
13234,0,1,8,6,15
13235,0,0,13,13,26
13236,0,0,0,7,7
13237,0,1,11,27,39
13238,0,1,1,14,16
13239,0,0,4,8,12
13240,1,0,7,14,22
13241,0,1,9,33,43
13242,0,0,11,18,29
13243,0,0,1,10,11
13244,0,0,0,10,10
13245,0,0,0,3,3
13246,0,0,8,19,27
13247,0,0,1,24,25
13248,0,0,2,15,17
13249,2,1,7,17,27
13250,0,1,6,18,25
13251,1,1,3,22,27
13252,0,0,4,11,15
13253,0,0,5,28,33
13254,0,1,4,25,30
13255,0,2,6,21,29
13256,0,0,2,19,21
13257,0,0,3,47,50
13258,0,0,14,19,33
13259,1,0,10,30,41
13260,0,0,4,9,13
13261,0,0,1,11,12
13262,0,1,8,36,45
13263,0,0,5,16,21
13264,0,0,13,32,45
13265,0,0,2,8,10
13266,0,0,2,28,30
13267,0,0,8,15,23
13268,0,1,0,4,5
13270,0,0,3,8,11
13271,1,1,6,28,36
13272,0,1,3,11,15
13273,0,1,0,10,11
13274,0,3,5,14,22
13275,0,0,3,12,15
13276,0,1,10,19,30
13277,0,0,2,1,3
13278,0,0,0,7,7
13279,0,0,4,6,10
13281,0,1,1,7,9
13282,0,0,4,29,33
13283,0,1,4,16,21
13284,1,0,7,28,36
13285,0,0,8,13,21
13286,0,0,6,12,18
13287,0,0,4,7,11
13288,0,0,2,9,11
13290,0,0,7,22,29
13291,0,0,4,5,9
13292,0,0,17,16,33
13293,0,0,8,14,22
13294,0,0,2,14,16
13295,0,1,4,12,17
13296,0,0,4,13,17
13297,0,0,2,6,8
13298,0,0,5,2,7
13299,0,0,9,22,31
13300,0,0,8,12,20
13301,1,0,0,18,19
13302,0,1,8,13,22
13303,0,0,0,4,4
13304,0,0,0,4,4
13305,0,0,6,28,34
13306,0,1,1,14,16
13307,0,0,7,20,27
13308,0,0,2,6,8
13309,0,0,5,9,14
13310,0,0,6,10,16
13311,0,0,2,7,9
13312,0,0,7,9,16
13313,0,0,6,14,20
13314,0,0,1,6,7
13315,0,1,10,14,25
13316,0,0,7,27,34
13317,0,0,3,12,15
13318,0,0,5,4,9
13319,1,0,0,9,10
13321,0,0,7,6,13
13322,0,1,14,30,45
13323,0,0,0,6,6
13324,0,0,3,12,15
13325,0,0,1,10,11
13326,0,0,9,19,28
13328,1,0,0,13,14
13329,0,0,0,1,1
13330,0,0,8,8,16
13331,0,0,8,16,24
13332,0,0,16,34,50
13333,0,0,9,37,46
13334,0,1,2,5,8
13335,0,0,16,13,29
13336,0,0,13,32,45
13337,1,0,4,14,19
13338,0,1,1,43,45
13339,0,0,6,19,25
13340,0,0,1,6,7
13341,0,0,6,13,19
13342,0,1,3,23,27
13343,0,0,13,21,34
13344,1,0,7,28,36
13345,0,0,3,15,18
13346,0,0,3,13,16
13347,0,3,2,17,22
13348,0,1,5,11,17
13351,0,0,4,6,10
13352,0,0,1,4,5
13353,0,0,12,23,35
13354,0,0,12,25,37
13355,1,1,8,28,38
13356,0,3,6,41,50
13357,0,0,4,9,13
13358,0,0,6,31,37
13359,0,0,2,48,50
13360,0,0,6,9,15
13361,0,0,7,13,20
13362,0,0,2,13,15
13363,1,0,0,10,11
13364,0,0,7,11,18
13365,0,0,8,8,16
13366,0,1,3,33,37
13367,1,0,0,9,10
13368,1,0,10,30,41
13369,1,0,0,18,19
13370,1,0,1,18,20
13371,0,0,7,9,16
13372,0,0,1,4,5
13373,0,0,2,35,37
13374,1,0,7,14,22
13375,0,0,1,12,13
13376,0,1,0,16,17
13377,0,0,2,48,50
13378,1,2,1,12,16
13379,0,0,1,4,5
13380,0,3,8,25,36
13381,0,1,2,5,8
13382,0,0,0,1,1
13383,0,0,1,12,13
13384,0,0,2,48,50
13385,1,0,0,13,14
13386,1,1,6,28,36
13387,0,0,3,14,17
13388,0,0,3,11,14
13390,0,1,1,18,20
13391,1,1,7,39,48
13392,0,1,2,24,27
13393,0,0,1,9,10
13394,0,0,3,17,20
13395,0,1,7,24,32
13396,0,0,11,20,31
13397,0,0,3,11,14
13398,0,0,5,14,19
13399,0,2,7,7,16
13400,0,0,0,6,6
13401,0,0,11,27,38
13402,0,1,3,17,21
13403,0,0,5,19,24
13404,0,0,9,34,43
13405,0,1,2,22,25
13406,0,1,2,17,20
13407,0,0,8,21,29
13408,0,0,14,33,47
13409,0,1,5,15,21
13410,0,1,3,16,20
13411,0,0,13,19,32
13414,0,1,5,37,43
13415,0,1,3,22,26
13416,1,0,3,22,26
13417,0,0,8,24,32
13418,0,0,0,8,8
13419,0,0,6,22,28
13420,0,1,5,12,18
13421,0,1,10,29,40
13422,0,0,2,2,4
13423,0,0,11,25,36
13424,0,0,6,10,16
13425,0,0,11,21,32
13426,0,0,1,6,7
13427,0,0,7,12,19
13428,0,0,0,13,13
13429,0,0,10,24,34
13430,0,0,7,5,12
13431,0,0,9,28,37
13432,0,0,5,45,50
13433,0,0,6,12,18
13434,0,0,8,18,26
13435,0,0,1,8,9
13436,0,0,6,11,17
13437,1,0,3,5,9
13438,1,0,6,15,22
13439,0,0,3,6,9
13440,0,0,8,11,19
13441,0,0,4,4,8
13442,0,0,6,7,13
13443,0,0,5,5,10
13444,0,1,11,32,44
13445,0,0,11,15,26
13446,0,0,5,4,9
13447,0,0,2,9,11
13448,0,0,12,24,36
13449,0,0,12,15,27
13450,0,1,4,15,20
13451,0,0,2,11,13
13452,0,1,12,19,32
13453,0,1,6,16,23
13454,0,0,13,31,44
13455,0,0,1,6,7
13456,1,0,2,19,22
13458,0,0,6,16,22
13459,0,0,4,3,7
13460,0,0,13,16,29
13461,0,0,7,12,19
13462,0,0,2,17,19
13463,0,2,3,17,22
13464,0,0,3,17,20
13465,0,0,1,5,6
13466,0,0,3,6,9
13467,0,0,5,2,7
13468,0,0,9,10,19
13469,0,1,11,13,25
13470,0,0,3,6,9
13471,0,1,7,16,24
13472,1,1,3,19,24
13473,0,0,1,8,9
13474,1,0,3,10,14
13475,0,0,1,4,5
13476,0,0,3,14,17
13477,0,0,4,10,14
13478,1,0,13,36,50
13479,1,0,6,25,32
13480,0,3,11,17,31
13481,0,0,5,1,6
13482,0,1,13,23,37
13483,0,0,5,7,12
13484,0,0,3,16,19
13485,0,4,2,18,24
13486,0,0,11,14,25
13487,0,0,4,9,13
13488,0,0,9,6,15
13489,0,0,2,8,10
13490,0,0,0,5,5
13491,0,0,2,14,16
13494,0,0,10,21,31
13495,0,0,1,6,7
13496,0,0,0,1,1
13497,0,0,3,7,10
13498,0,1,9,7,17
13499,0,0,13,32,45
13500,0,0,6,5,11
13501,0,0,3,2,5
13502,0,0,13,26,39
13503,0,0,0,10,10
13504,1,0,2,29,32
13505,0,0,1,8,9
13506,0,0,2,9,11
13508,0,0,0,2,2
13509,0,0,4,9,13
13511,0,0,1,31,32
13512,0,0,5,8,13
13513,2,2,8,28,40
13514,0,5,5,40,50
13515,0,0,1,9,10
13516,0,1,11,38,50
13517,0,0,12,13,25
13518,0,0,13,26,39
13519,1,0,6,43,50
13520,0,0,9,15,24
13521,0,0,2,16,18
13522,0,1,7,24,32
13523,0,0,10,20,30
13524,1,1,13,32,47
13525,0,0,16,34,50
13526,0,0,2,13,15
13527,1,0,11,31,43
13528,0,0,11,17,28
13529,1,0,3,22,26
13530,0,0,9,23,32
13531,0,0,10,25,35
13532,0,0,6,17,23
13533,0,0,0,6,6
13534,0,0,10,33,43
13535,0,0,5,15,20
13536,0,0,1,23,24
13537,0,1,14,34,49
13538,0,0,0,6,6
13539,0,0,13,32,45
13540,0,1,7,28,36
13541,0,0,5,23,28
13542,0,0,0,5,5
13543,0,0,2,15,17
13545,0,0,5,10,15
13546,0,0,16,26,42
13547,0,1,0,15,16
13549,0,1,7,20,28
13550,0,1,12,26,39
13551,0,0,5,5,10
13552,0,0,1,15,16
13553,0,0,5,8,13
13554,0,0,15,29,44
13555,1,0,3,22,26
13556,0,0,4,7,11
13557,0,0,0,16,16
13558,0,0,4,9,13
13559,0,1,11,36,48
13560,0,0,10,6,16
13561,0,1,4,25,30
13562,0,0,16,34,50
13563,0,2,0,22,24
13564,2,0,9,26,37
13565,0,0,6,13,19
13566,0,1,7,17,25
13567,2,0,0,5,7
13568,1,0,7,23,31
13569,0,0,5,23,28
13570,0,0,6,5,11
13572,0,0,5,8,13
13573,0,1,5,17,23
13574,0,0,0,5,5
13575,0,0,4,3,7
13576,0,0,0,9,9
13577,1,1,3,33,38
13578,0,0,0,10,10
13579,1,3,2,17,23
13580,0,0,12,15,27
13581,1,0,10,31,42
13582,0,0,3,16,19
13583,0,0,5,10,15
13584,0,0,4,24,28
13585,0,0,0,5,5
13586,0,0,0,9,9
13588,0,1,5,15,21
13589,0,0,9,23,32
13590,0,0,0,1,1
13591,0,0,1,5,6
13592,0,1,7,17,25
13593,0,0,4,9,13
13594,2,2,1,24,29
13595,0,0,17,33,50
13597,1,0,8,26,35
13598,0,0,2,25,27
13599,1,1,13,33,48
13600,2,2,1,24,29
13601,0,0,2,25,27
13602,2,2,1,24,29
13603,0,0,4,10,14
13604,0,0,2,7,9
13605,0,0,5,12,17
13606,0,0,7,13,20
13607,0,0,0,6,6
13608,0,0,5,15,20
13609,0,0,17,27,44
13610,0,0,11,18,29
13611,0,0,11,26,37
13612,0,0,3,10,13
13613,2,0,5,9,16
13614,1,0,6,8,15
13615,0,0,17,27,44
13616,1,0,1,8,10
13617,0,0,3,5,8
13618,0,1,0,19,20
13619,0,0,5,8,13
13620,0,0,4,12,16
13621,0,0,2,10,12
13622,0,0,6,12,18
13623,0,0,7,7,14
13624,0,0,4,5,9
13625,0,0,6,22,28
13626,0,1,0,10,11
13627,0,0,3,5,8
13628,0,0,5,22,27
13629,3,1,8,23,35
13630,0,0,2,14,16
13631,0,0,3,10,13
13632,0,0,3,16,19
13633,0,1,9,24,34
13634,0,0,2,5,7
13635,0,0,5,4,9
13636,0,0,4,8,12
13637,0,0,0,4,4
13638,0,1,13,25,39
13639,0,0,3,11,14
13640,0,0,4,6,10
13641,0,1,4,12,17
13642,0,0,5,10,15
13643,0,0,2,7,9
13644,0,0,6,21,27
13645,0,0,5,11,16
13647,0,4,10,4,18
13648,0,1,4,21,26
13649,0,0,2,1,3
13650,0,0,3,8,11
13651,0,0,3,5,8
13652,0,0,7,10,17
13653,0,0,3,16,19
13654,0,0,5,10,15
13655,0,1,2,11,14
13656,0,1,9,17,27
13657,1,0,6,7,14
13658,0,2,7,22,31
13659,0,0,2,7,9
13660,0,0,4,4,8
13661,0,0,12,16,28
13662,0,0,0,5,5
13663,0,0,3,5,8
13664,0,0,2,6,8
13665,0,0,7,13,20
13669,0,3,2,12,17
13670,0,0,2,4,6
13671,0,0,1,4,5
13672,0,0,2,2,4
13673,0,0,6,10,16
13674,0,0,4,16,20
13675,0,0,12,21,33
13676,2,0,1,9,12
13677,0,3,4,9,16
13678,0,0,5,11,16
13679,0,0,9,21,30
13680,0,0,8,7,15
13681,1,0,0,9,10
13682,0,0,3,11,14
13683,0,0,6,5,11
13684,1,0,1,4,6
13685,2,1,2,10,15
13686,2,2,1,24,29
13687,0,0,4,8,12
13688,2,1,10,17,30
13689,0,0,7,9,16
13690,0,0,0,8,8
13691,0,1,13,23,37
13692,0,1,16,31,48
13693,0,0,19,31,50
13694,1,0,9,26,36
13695,0,0,14,34,48
13696,0,0,9,29,38
13697,0,3,4,9,16
13698,0,0,3,6,9
13699,0,0,10,35,45
13700,0,0,17,27,44
13701,0,0,2,8,10
13702,1,0,1,4,6
13703,0,0,11,11,22
13704,0,0,5,6,11
13706,0,0,8,12,20
13707,0,0,14,26,40
13708,0,0,5,10,15
13709,2,2,1,24,29
13710,0,0,4,8,12
13711,2,1,2,10,15
13712,0,0,6,5,11
13713,2,0,1,9,12
13714,0,1,1,18,20
13715,0,0,0,12,12
13716,0,0,11,11,22
13717,0,1,13,23,37
13718,0,0,11,26,37
13719,0,0,6,5,11
13720,0,0,2,7,9
13721,0,0,5,6,11
13722,0,0,6,6,12
13723,1,0,11,32,44
13724,0,0,4,7,11
13725,0,0,5,15,20
13726,0,0,10,35,45
13727,0,0,7,13,20
13728,0,0,11,26,37
13729,0,0,9,29,38
13730,0,1,1,9,11
13731,1,0,0,9,10
13732,2,1,2,10,15
13733,0,0,11,11,22
13734,2,2,1,24,29
13735,0,0,5,11,16
13736,1,0,1,4,6
13737,0,0,5,10,15
13738,0,0,7,22,29
13739,0,0,7,5,12
13740,0,0,2,7,9
13741,0,0,0,3,3
13742,3,0,1,12,16
13743,0,0,10,27,37
13744,0,0,10,17,27
13745,0,0,4,12,16
13746,0,0,7,13,20
13747,0,0,7,11,18
13748,0,0,4,24,28
13749,0,0,1,3,4
13750,0,0,4,17,21
13751,0,1,5,17,23
13752,0,0,2,1,3
13753,0,0,2,6,8
13754,0,0,8,15,23
13755,0,1,7,16,24
13756,0,3,1,22,26
13757,0,1,6,22,29
13758,0,0,10,18,28
13759,2,0,5,9,16
13760,0,0,0,5,5
13761,0,1,1,7,9
13762,0,0,1,4,5
13763,0,0,6,18,24
13764,0,1,8,15,24
13765,0,1,18,31,50
13766,0,0,1,2,3
13767,0,0,5,14,19
13768,0,0,7,7,14
13769,0,0,10,11,21
13770,0,1,12,14,27
13771,0,0,5,4,9
13772,0,0,6,12,18
13773,0,1,5,13,19
13774,0,0,4,9,13
13775,0,0,4,9,13
13776,0,1,2,15,18
13777,0,0,8,20,28
13779,0,0,5,24,29
13780,0,0,1,4,5
13781,0,0,4,0,4
13782,0,0,8,18,26
13783,1,0,3,34,38
13784,0,0,2,1,3
13786,0,0,6,21,27
13787,0,0,3,14,17
13788,0,0,6,13,19
13789,0,0,5,12,17
13790,1,0,0,9,10
13791,0,1,8,20,29
13792,0,0,10,26,36
13793,0,0,8,14,22
13794,0,0,6,1,7
13795,0,0,6,10,16
13796,1,0,6,33,40
13797,0,0,2,13,15
13798,0,0,6,12,18
13799,0,1,6,23,30
13800,0,3,4,9,16
13801,0,0,2,11,13
13802,0,2,6,26,34
13803,0,0,11,24,35
13804,0,0,9,38,47
13805,0,0,4,16,20
13806,0,0,4,6,10
13807,0,0,1,11,12
13808,0,1,4,7,12
13809,0,0,2,3,5
13810,0,0,4,8,12
13811,0,0,3,15,18
13812,0,0,2,7,9
13813,0,0,4,6,10
13814,0,0,8,19,27
13815,0,0,4,4,8
13816,0,0,6,5,11
13817,0,1,2,11,14
13818,0,0,3,5,8
13819,0,0,9,16,25
13820,0,1,0,12,13
13821,0,0,3,14,17
13823,0,0,1,6,7
13824,0,1,2,10,13
13825,0,0,12,8,20
13826,0,0,9,21,30
13827,0,2,6,17,25
13828,0,0,7,5,12
13829,0,0,7,10,17
13830,1,0,2,20,23
13831,0,0,5,15,20
13832,0,0,1,16,17
13833,0,0,6,12,18
13834,0,0,11,12,23
13835,0,1,13,28,42
13836,0,2,9,26,37
13837,0,0,6,13,19
13838,0,1,2,26,29
13839,0,0,5,36,41
13840,0,0,8,19,27
13841,0,0,5,10,15
13842,0,1,0,10,11
13843,0,0,10,11,21
13844,0,0,5,8,13
13845,0,1,4,12,17
13846,0,0,7,12,19
13847,0,0,6,10,16
13848,0,0,2,16,18
13849,0,0,4,14,18
13850,0,0,3,5,8
13851,0,0,1,6,7
13852,0,0,12,7,19
13854,0,0,3,6,9
13855,1,0,4,36,41
13856,0,0,5,16,21
13857,0,0,6,9,15
13858,0,0,3,6,9
13859,0,0,7,31,38
13860,0,0,6,15,21
13861,0,0,1,2,3
13862,0,1,7,14,22
13863,1,1,9,27,38
13864,0,0,4,9,13
13865,1,1,8,19,29
13866,0,0,3,4,7
13867,0,0,6,12,18
13868,0,0,7,13,20
13869,3,0,0,6,9
13870,0,0,7,22,29
13871,0,0,5,7,12
13872,0,3,10,19,32
13873,0,0,6,13,19
13874,0,15,6,24,45
13875,0,0,2,6,8
13876,0,2,9,15,26
13877,0,0,10,23,33
13878,0,1,2,9,12
13879,0,0,1,4,5
13880,0,0,1,0,1
13881,0,0,3,8,11
13882,0,0,1,9,10
13883,0,0,5,17,22
13884,0,0,3,7,10
13885,0,0,0,7,7
13886,0,1,1,5,7
13887,0,1,8,22,31
13888,0,0,11,7,18
13889,0,0,2,4,6
13890,0,0,4,14,18
13891,0,0,7,5,12
13893,0,0,3,12,15
13894,0,0,7,9,16
13895,0,0,4,8,12
13896,0,0,0,14,14
13897,0,0,13,30,43
13898,0,0,2,5,7
13899,0,0,2,5,7
13900,0,0,4,16,20
13901,0,0,3,1,4
13902,0,0,2,6,8
13903,0,1,3,13,17
13904,0,1,8,12,21
13905,1,0,19,30,50
13906,0,0,1,4,5
13907,3,0,1,12,16
13908,0,0,7,17,24
13909,0,0,4,14,18
13910,0,1,5,2,8
13911,0,0,2,4,6
13912,0,0,5,1,6
13913,0,2,0,15,17
13914,0,0,2,7,9
13915,0,0,12,17,29
13916,0,0,9,26,35
13917,0,1,8,9,18
13918,0,1,7,26,34
13919,0,0,7,19,26
13920,0,2,10,25,37
13921,0,0,9,14,23
13922,0,0,10,12,22
13923,0,0,1,9,10
13924,0,0,6,15,21
13925,0,0,4,4,8
13926,0,0,5,10,15
13927,0,2,3,13,18
13928,0,1,4,10,15
13929,0,0,3,7,10
13930,4,0,3,14,21
13932,0,0,8,5,13
13933,0,0,8,18,26
13934,0,1,3,17,21
13935,0,0,11,26,37
13936,0,0,4,1,5
13937,0,1,3,11,15
13938,0,0,4,10,14
13939,0,3,2,12,17
13941,0,0,0,4,4
13943,0,0,6,16,22
13944,2,1,2,10,15
13945,0,3,3,4,10
13946,1,0,3,11,15
13947,0,0,2,7,9
13948,0,0,7,10,17
13949,0,0,2,25,27
13950,0,0,10,27,37
13951,0,4,2,15,21
13952,0,0,11,34,45
13953,0,0,5,6,11
13954,0,0,5,14,19
13955,0,0,8,11,19
13956,0,0,2,7,9
13957,0,0,5,15,20
13958,1,1,14,25,41
13959,0,0,8,18,26
13960,0,0,7,7,14
13961,0,0,8,17,25
13962,0,0,6,7,13
13963,0,1,13,27,41
13964,0,0,13,34,47
13965,0,0,8,21,29
13966,0,0,10,23,33
13967,0,0,12,16,28
13968,0,0,12,22,34
13969,0,0,4,23,27
13970,0,0,0,12,12
13971,0,0,6,15,21
13972,0,0,3,7,10
13973,1,0,15,21,37
13974,0,1,0,14,15
13975,0,0,7,11,18
13976,0,1,8,41,50
13977,0,0,4,6,10
13978,1,0,5,5,11
13979,0,0,3,6,9
13980,0,0,6,24,30
13982,0,0,6,8,14
13983,0,0,1,17,18
13984,0,8,9,33,50
13985,0,0,9,31,40
13986,1,0,19,30,50
13987,0,0,12,7,19
13988,0,0,12,28,40
13989,0,0,5,12,17
13990,0,0,1,19,20
13991,0,0,17,27,44
13992,0,0,14,36,50
13993,0,1,1,5,7
13994,0,2,3,17,22
13995,1,1,10,32,44
13996,0,0,8,6,14
13997,2,2,0,15,19
13998,1,1,7,11,20
13999,0,1,12,23,36
14001,0,1,4,9,14
14002,0,1,18,31,50
14003,2,1,1,27,31
14004,0,3,4,9,16
14005,0,0,10,18,28
14006,0,0,10,11,21
14007,0,0,1,2,3
14008,0,0,6,5,11
14009,0,0,4,0,4
14010,0,0,2,3,5
14011,1,0,4,17,22
14012,0,2,9,15,26
14013,0,0,5,1,6
14014,0,1,7,36,44
14015,3,0,1,12,16
14016,2,1,2,10,15
14017,0,0,4,8,12
14018,0,0,10,12,22
14019,0,0,13,12,25
14020,0,2,3,21,26
14021,0,0,5,34,39
14022,1,0,5,5,11
14023,0,0,17,32,49
14024,0,0,1,9,10
14025,0,0,11,26,37
14026,0,0,2,25,27
14027,2,2,0,15,19
14028,0,2,3,29,34
14029,1,0,4,17,22
14030,0,0,14,23,37
14031,0,1,7,36,44
14032,0,0,5,6,11
14034,0,0,1,9,10
14035,0,0,11,26,37
14036,1,0,0,9,10
14037,0,0,2,3,5
14038,0,1,7,36,44
14039,0,2,3,17,22
14041,2,1,2,10,15
14042,0,0,5,10,15
14043,3,0,1,12,16
14045,0,0,6,3,9
14046,0,2,3,16,21
14047,0,0,5,6,11
14048,0,0,1,7,8
14049,0,0,7,9,16
14050,0,0,7,13,20
14051,0,2,11,20,33
14052,0,0,3,10,13
14053,0,0,2,7,9
14054,0,0,4,16,20
14055,0,0,6,19,25
14057,0,2,9,17,28
14058,0,0,2,0,2
14059,0,0,14,32,46
14060,0,0,5,8,13
14061,1,0,6,12,19
14062,0,0,11,18,29
14063,0,1,19,29,49
14064,0,0,3,0,3
14065,0,0,3,9,12
14066,0,0,11,20,31
14067,0,0,1,0,1
14068,0,0,13,31,44
14069,0,0,2,7,9
14070,0,0,1,10,11
14071,0,1,1,15,17
14072,0,0,4,6,10
14074,0,0,8,18,26
14075,0,0,10,19,29
14076,0,0,3,16,19
14077,0,0,10,40,50
14078,0,1,9,22,32
14079,1,0,9,33,43
14080,0,0,1,8,9
14081,0,0,11,13,24
14082,0,1,9,13,23
14083,0,1,9,31,41
14084,0,0,8,16,24
14085,0,0,0,6,6
14086,0,0,5,13,18
14087,0,0,8,26,34
14088,0,0,8,12,20
14089,0,0,1,4,5
14090,0,0,12,25,37
14091,0,1,21,28,50
14092,0,0,2,14,16
14093,0,0,5,2,7
14094,0,1,6,13,20
14095,0,0,5,7,12
14096,0,0,2,17,19
14097,1,0,1,4,6
14098,0,1,2,7,10
14099,0,0,11,18,29
14100,0,0,1,5,6
14101,0,0,0,5,5
14102,0,0,1,4,5
14103,0,0,3,3,6
14104,0,0,1,4,5
14105,0,0,8,16,24
14106,0,1,0,6,7
14107,0,0,12,16,28
14108,0,0,9,16,25
14109,0,0,2,1,3
14111,2,0,6,20,28
14112,0,0,4,4,8
14113,0,0,3,10,13
14114,0,0,3,6,9
14115,0,0,1,5,6
14116,0,2,9,39,50
14117,1,0,8,24,33
14118,0,1,4,11,16
14119,0,0,4,16,20
14120,0,0,4,12,16
14121,0,0,8,11,19
14122,0,3,11,21,35
14123,0,0,2,0,2
14124,0,1,0,6,7
14125,1,1,5,24,31
14126,0,0,6,7,13
14127,0,0,16,33,49
14128,0,0,6,13,19
14129,0,1,11,17,29
14130,0,0,5,5,10
14131,0,0,4,21,25
14132,0,0,6,5,11
14133,0,0,8,13,21
14134,1,1,10,24,36
14135,0,1,1,9,11
14136,0,0,4,34,38
14137,0,0,10,20,30
14138,1,1,12,26,40
14139,0,0,2,14,16
14140,0,0,8,20,28
14141,0,0,3,8,11
14142,0,0,4,12,16
14143,0,0,5,18,23
14144,0,0,8,12,20
14145,0,0,6,22,28
14146,0,0,10,23,33
14147,0,0,3,12,15
14148,0,0,3,10,13
14149,0,0,12,21,33
14150,0,0,2,12,14
14151,0,0,10,14,24
14152,0,1,14,26,41
14153,0,0,8,19,27
14154,0,0,2,5,7
14155,1,1,15,31,48
14156,0,0,5,12,17
14157,0,2,6,15,23
14158,0,0,3,11,14
14159,0,0,6,6,12
14160,0,0,2,19,21
14161,0,1,5,7,13
14162,0,0,3,8,11
14163,0,0,3,4,7
14164,0,0,1,4,5
14165,0,0,12,29,41
14167,0,0,3,2,5
14168,0,0,7,24,31
14169,1,0,1,23,25
14170,0,0,1,17,18
14171,0,1,5,10,16
14172,0,0,7,15,22
14173,0,0,5,18,23
14174,1,1,6,22,30
14175,1,0,7,31,39
14176,0,0,15,21,36
14177,0,0,5,9,14
14178,0,0,9,29,38
14179,0,0,0,4,4
14181,0,0,5,10,15
14182,0,0,3,11,14
14183,0,0,4,11,15
14184,0,1,10,37,48
14185,0,2,1,18,21
14187,0,0,4,10,14
14188,0,0,3,12,15
14189,0,0,1,4,5
14190,0,0,6,15,21
14191,0,0,3,6,9
14192,0,0,2,5,7
14193,0,0,3,10,13
14195,0,0,2,6,8
14196,0,0,13,18,31
14197,0,0,2,10,12
14198,0,0,5,20,25
14199,0,0,5,9,14
14200,0,0,9,21,30
14201,0,0,11,19,30
14204,0,0,4,7,11
14205,0,0,0,12,12
14206,0,2,7,24,33
14207,0,1,6,11,18
14208,0,0,2,4,6
14209,0,0,1,8,9
14211,0,0,10,15,25
14212,0,0,2,6,8
14213,0,0,9,10,19
14214,0,0,5,12,17
14215,0,0,1,15,16
14216,0,0,0,5,5
14217,0,0,11,25,36
14218,0,0,7,16,23
14219,1,0,1,4,6
14220,0,0,15,22,37
14221,0,0,5,8,13
14222,0,1,13,28,42
14223,0,0,2,4,6
14224,0,0,7,7,14
14225,0,0,10,12,22
14226,3,2,6,39,50
14227,3,0,1,12,16
14228,2,2,1,24,29
14229,0,1,15,29,45
14231,0,0,9,41,50
14232,0,0,5,17,22
14233,0,0,5,15,20
14234,0,0,14,26,40
14235,0,0,0,12,12
14236,1,0,3,5,9
14237,0,0,6,22,28
14238,0,0,4,14,18
14239,1,1,10,38,50
14241,0,0,5,8,13
14242,0,0,9,24,33
14243,0,0,4,6,10
14244,0,1,6,27,34
14245,0,0,2,11,13
14246,0,0,9,21,30
14247,0,0,11,16,27
14248,0,0,11,18,29
14249,0,2,3,17,22
14250,0,0,4,8,12
14251,0,0,10,35,45
14252,0,0,9,41,50
14254,0,0,12,24,36
14255,1,3,6,28,38
14256,0,0,6,9,15
14257,0,1,2,11,14
14259,0,0,5,1,6
14260,0,0,5,19,24
14261,0,2,7,34,43
14262,0,0,11,38,49
14263,0,3,3,22,28
14264,0,0,14,34,48
14265,1,0,6,25,32
14266,0,0,14,15,29
14267,0,0,11,17,28
14269,0,0,10,40,50
14270,0,0,9,18,27
14271,0,0,8,14,22
14272,1,0,6,15,22
14273,0,1,13,36,50
14274,1,0,11,30,42
14275,0,0,0,6,6
14276,0,0,7,13,20
14277,1,1,5,24,31
14278,0,0,2,10,12
14279,0,0,17,23,40
14280,0,0,16,29,45
14281,1,0,10,39,50
14282,0,0,10,10,20
14283,4,0,7,39,50
14284,0,0,11,25,36
14285,0,1,11,13,25
14286,0,0,3,4,7
14287,0,0,6,2,8
14288,1,0,9,10,20
14290,0,0,0,5,5
14291,0,2,3,16,21
14292,0,1,11,32,44
14293,0,0,8,18,26
14294,0,0,9,14,23
14295,2,2,1,24,29
14296,0,2,7,24,33
14297,0,0,2,7,9
14298,0,0,7,7,14
14299,0,0,1,15,16
14300,0,2,3,17,22
14301,0,0,5,8,13
14302,0,0,1,4,5
14303,3,0,1,12,16
14304,1,0,1,4,6
14305,0,0,0,5,5
14306,0,0,2,10,12
14307,0,0,10,12,22
14308,0,0,0,9,9
14309,0,1,8,28,37
14310,0,1,13,28,42
14311,2,0,6,20,28
14312,0,1,0,9,10
14313,1,1,10,38,50
14314,1,3,11,33,48
14315,0,0,5,19,24
14316,0,1,1,6,8
14318,0,0,4,16,20
14319,0,0,7,16,23
14320,0,0,2,7,9
14321,0,0,0,5,5
14322,1,0,6,15,22
14324,2,2,1,24,29
14325,0,2,3,17,22
14326,0,0,10,35,45
14327,3,2,6,39,50
14328,1,0,1,4,6
14329,0,0,7,13,20
14331,0,0,5,12,17
14332,0,0,3,30,33
14333,0,1,5,18,24
14334,1,0,5,11,17
14335,0,0,5,28,33
14336,0,0,7,15,22
14337,0,2,7,15,24
14338,1,0,6,8,15
14339,0,1,6,16,23
14340,0,0,0,5,5
14341,0,0,11,22,33
14342,0,0,0,10,10
14343,0,0,4,10,14
14344,1,1,4,13,19
14345,0,0,7,16,23
14346,0,0,0,7,7
14347,0,0,9,20,29
14348,0,0,6,13,19
14349,0,0,3,15,18
14350,0,0,5,18,23
14351,0,0,6,10,16
14352,0,1,14,26,41
14353,0,0,9,16,25
14354,0,0,7,12,19
14355,0,0,0,10,10
14356,0,0,8,22,30
14357,0,0,6,18,24
14358,0,2,6,42,50
14359,0,0,9,8,17
14360,2,0,2,42,46
14361,0,0,2,9,11
14362,0,0,4,14,18
14363,0,0,9,6,15
14364,0,0,4,9,13
14365,0,0,4,23,27
14366,0,0,7,6,13
14367,0,0,6,6,12
14368,0,0,6,11,17
14369,0,0,9,16,25
14370,0,0,5,22,27
14371,0,1,8,30,39
14372,0,0,0,13,13
14373,0,0,7,10,17
14374,0,0,6,6,12
14375,1,0,7,18,26
14376,0,0,3,24,27
14377,0,0,7,9,16
14378,0,0,0,13,13
14379,0,0,2,27,29
14380,0,0,14,26,40
14381,0,0,5,7,12
14382,1,0,1,10,12
14383,0,0,6,8,14
14384,1,0,3,13,17
14385,0,0,2,3,5
14386,0,0,5,7,12
14387,0,0,4,9,13
14388,0,0,0,5,5
14389,0,0,1,5,6
14391,0,0,10,12,22
14392,0,2,4,22,28
14393,1,1,7,25,34
14394,1,0,2,25,28
14395,0,0,1,4,5
14396,0,0,11,17,28
14397,0,0,3,13,16
14398,0,0,6,11,17
14399,0,1,4,8,13
14400,0,1,5,12,18
14402,0,0,2,5,7
14403,0,0,4,7,11
14404,1,0,9,22,32
14405,0,0,0,5,5
14406,0,0,8,17,25
14407,0,0,5,10,15
14408,0,0,5,9,14
14409,0,0,5,4,9
14410,0,1,3,8,12
14411,0,0,6,21,27
14412,0,0,0,7,7
14413,0,0,7,7,14
14414,0,1,1,16,18
14415,0,0,3,14,17
14416,0,2,4,32,38
14417,0,0,4,2,6
14418,1,0,8,16,25
14419,0,0,3,9,12
14420,0,0,1,19,20
14421,0,0,7,8,15
14422,0,1,2,11,14
14424,0,0,16,17,33
14425,0,0,0,10,10
14426,0,0,4,3,7
14427,0,0,7,11,18
14428,0,0,13,14,27
14429,0,1,7,11,19
14430,1,0,6,10,17
14431,0,0,5,7,12
14432,0,2,3,16,21
14433,0,1,8,9,18
14434,0,0,15,35,50
14435,0,0,6,44,50
14436,0,0,4,16,20
14437,0,1,16,33,50
14438,0,0,9,10,19
14439,0,0,8,11,19
14440,0,0,5,13,18
14441,0,0,10,23,33
14442,0,0,9,20,29
14443,0,0,5,8,13
14444,0,2,3,16,21
14445,0,0,3,12,15
14446,0,1,9,17,27
14447,0,1,4,36,41
14448,2,0,9,30,41
14449,0,2,4,16,22
14450,0,0,12,38,50
14451,0,0,6,23,29
14452,0,1,13,27,41
14453,0,0,4,9,13
14455,0,4,4,32,40
14456,0,0,10,18,28
14457,0,0,6,16,22
14458,0,0,1,5,6
14459,0,0,14,33,47
14460,0,0,10,32,42
14461,0,1,8,30,39
14462,0,0,6,12,18
14463,0,0,3,8,11
14464,0,0,14,16,30
14465,1,0,11,30,42
14466,0,0,4,7,11
14467,0,0,6,15,21
14468,0,0,7,24,31
14469,0,0,13,23,36
14470,0,0,15,32,47
14471,0,1,4,2,7
14472,1,1,10,37,49
14473,0,0,11,26,37
14474,1,0,4,17,22
14475,0,0,0,3,3
14476,0,0,4,14,18
14477,0,0,4,7,11
14478,0,0,8,13,21
14479,0,0,12,18,30
14480,0,0,6,44,50
14481,0,0,7,13,20
14482,0,0,10,30,40
14483,0,0,8,8,16
14485,0,0,8,12,20
14486,1,1,0,23,25
14487,0,0,18,29,47
14488,0,0,4,21,25
14489,0,0,11,11,22
14490,0,0,3,9,12
14491,0,0,5,5,10
14492,0,0,15,35,50
14493,3,1,1,25,30
14494,0,0,6,11,17
14495,0,0,7,10,17
14496,2,0,0,6,8
14497,0,0,4,9,13
14498,0,0,1,6,7
14499,1,0,0,11,12
14500,0,0,18,28,46
14501,0,0,4,16,20
14502,0,4,4,32,40
14503,1,2,2,15,20
14504,1,1,5,25,32
14505,0,2,4,16,22
14506,0,0,0,12,12
14507,0,0,6,16,22
14508,0,0,11,11,22
14509,1,0,11,30,42
14511,1,0,4,17,22
14512,0,0,15,35,50
14513,0,0,4,9,13
14514,0,0,11,11,22
14515,0,0,6,20,26
14516,0,0,8,11,19
14517,0,0,4,13,17
14518,0,0,5,15,20
14519,0,0,4,5,9
14520,0,0,4,16,20
14521,0,0,8,25,33
14522,0,0,7,24,31
14523,0,1,6,17,24
14524,0,0,10,20,30
14525,0,1,5,23,29
14527,0,0,10,34,44
14528,0,0,3,11,14
14529,0,0,6,27,33
14530,0,0,3,11,14
14531,0,1,5,4,10
14532,0,0,7,16,23
14533,0,0,2,7,9
14534,0,0,2,3,5
14535,0,0,2,7,9
14536,0,0,7,8,15
14537,0,1,9,31,41
14538,0,0,4,9,13
14539,0,0,9,28,37
14540,0,2,1,13,16
14541,0,2,6,42,50
14542,0,0,5,15,20
14543,0,1,3,17,21
14544,0,0,3,5,8
14545,0,0,11,13,24
14546,0,1,7,23,31
14547,0,0,11,36,47
14548,0,0,12,16,28
14549,0,0,4,9,13
14550,0,0,10,15,25
14551,0,0,3,16,19
14552,0,0,9,25,34
14553,0,0,4,7,11
14555,0,0,5,9,14
14556,0,0,4,7,11
14558,0,0,1,2,3
14559,0,0,4,8,12
14560,0,0,5,34,39
14561,0,0,8,15,23
14563,0,0,1,4,5
14564,0,0,5,8,13
14565,0,0,3,10,13
14566,0,0,4,11,15
14567,1,0,5,31,37
14568,0,0,9,21,30
14569,0,0,0,5,5
14570,0,0,4,5,9
14571,0,0,7,17,24
14572,0,1,4,15,20
14573,0,0,4,1,5
14574,0,0,1,9,10
14575,0,1,4,43,48
14576,0,0,3,10,13
14577,0,0,13,29,42
14578,0,2,1,3,6
14579,0,0,6,8,14
14580,0,0,13,10,23
14581,0,0,4,9,13
14582,0,0,5,10,15
14583,0,0,4,11,15
14584,0,1,6,11,18
14585,0,0,12,20,32
14586,0,0,8,23,31
14587,0,0,12,19,31
14588,0,0,7,4,11
14589,0,0,7,20,27
14590,0,0,1,12,13
14592,0,0,3,10,13
14594,0,0,5,1,6
14595,1,0,4,12,17
14596,0,0,6,23,29
14597,0,0,12,35,47
14598,0,0,19,30,49
14599,0,0,15,21,36
14600,1,0,7,15,23
14601,0,0,9,32,41
14602,0,0,9,17,26
14603,2,0,6,25,33
14604,0,0,1,2,3
14605,0,0,4,10,14
14606,0,0,15,32,47
14607,0,0,13,23,36
14608,0,0,9,25,34
14609,0,0,4,16,20
14611,0,0,6,11,17
14612,0,0,8,23,31
14613,0,1,15,22,38
14614,0,0,5,20,25
14615,0,0,12,26,38
14616,0,0,12,15,27
14617,1,0,6,15,22
14618,0,1,0,11,12
14619,0,1,10,30,41
14620,0,0,8,11,19
14621,0,0,6,17,23
14622,0,0,8,6,14
14623,0,0,9,13,22
14624,1,0,6,5,12
14625,1,0,7,27,35
14626,0,0,1,3,4
14627,2,1,11,29,43
14628,0,0,16,32,48
14629,0,0,8,19,27
14630,0,0,9,9,18
14631,0,0,5,22,27
14632,0,0,7,14,21
14633,0,0,7,13,20
14634,0,0,0,5,5
14635,0,0,0,5,5
14636,0,1,4,43,48
14637,1,0,4,12,17
14638,0,0,5,15,20
14639,0,0,5,1,6
14640,0,0,12,20,32
14642,1,0,6,5,12
14643,0,0,5,13,18
14644,0,0,5,21,26
14645,0,0,0,14,14
14646,0,0,0,5,5
14647,0,1,4,43,48
14648,1,1,7,25,34
14649,0,0,7,16,23
14650,0,0,0,5,5
14651,1,1,7,25,34
14652,1,0,6,15,22
14653,0,0,13,37,50
14654,0,0,3,5,8
14655,0,0,7,5,12
14656,0,0,13,25,38
14657,0,0,14,31,45
14658,0,1,6,14,21
14659,0,2,5,21,28
14660,0,1,11,14,26
14661,1,1,6,31,39
14662,0,2,7,24,33
14663,0,0,3,10,13
14664,0,0,5,15,20
14665,0,0,8,9,17
14666,0,0,7,20,27
14667,0,0,7,13,20
14668,0,0,6,14,20
14669,0,0,3,22,25
14670,0,0,2,3,5
14671,0,0,5,14,19
14672,1,0,6,12,19
14673,0,0,4,6,10
14674,0,0,4,19,23
14675,0,0,4,26,30
14676,0,0,5,19,24
14677,0,0,6,15,21
14678,0,0,4,11,15
14679,0,0,4,5,9
14680,0,1,6,29,36
14681,0,0,7,15,22
14683,0,0,6,17,23
14684,0,0,4,10,14
14685,0,0,0,9,9
14686,1,0,8,40,49
14687,0,0,0,1,1
14689,0,0,6,7,13
14690,0,0,11,5,16
14691,0,0,13,27,40
14692,0,2,10,18,30
14693,0,2,6,42,50
14694,0,0,5,9,14
14695,0,0,12,38,50
14696,0,0,8,18,26
14697,0,0,4,8,12
14698,0,0,6,12,18
14699,0,0,2,9,11
14700,0,0,8,18,26
14701,0,0,2,7,9
14702,0,0,8,11,19
14704,0,3,9,15,27
14705,0,0,0,8,8
14706,0,0,6,23,29
14707,0,1,9,10,20
14708,0,1,10,25,36
14709,0,0,4,33,37
14710,0,0,5,15,20
14711,0,0,7,17,24
14712,0,0,4,22,26
14713,0,0,5,15,20
14714,0,0,9,4,13
14715,1,0,1,8,10
14716,0,1,11,13,25
14717,0,0,3,2,5
14718,0,0,6,14,20
14719,0,0,2,13,15
14720,0,0,8,18,26
14721,0,0,7,16,23
14722,0,0,7,27,34
14724,0,0,9,7,16
14725,0,0,4,8,12
14726,0,0,3,6,9
14727,0,0,10,13,23
14728,0,0,10,11,21
14729,1,0,7,13,21
14730,0,0,12,18,30
14731,0,0,6,22,28
14733,0,0,1,16,17
14734,0,1,6,18,25
14735,0,0,1,0,1
14736,0,0,11,18,29
14737,0,0,9,18,27
14738,0,0,8,13,21
14739,0,0,2,14,16
14740,0,0,12,22,34
14741,0,0,4,7,11
14742,1,0,1,4,6
14744,0,0,3,15,18
14745,0,0,2,8,10
14746,0,1,6,14,21
14747,0,0,4,1,5
14748,0,0,4,10,14
14749,0,0,4,6,10
14750,0,0,10,15,25
14751,0,0,1,8,9
14752,0,0,3,13,16
14753,0,0,8,7,15
14754,0,0,7,5,12
14756,0,0,5,8,13
14757,0,1,4,29,34
14759,0,0,3,22,25
14760,2,2,4,25,33
14762,1,0,5,29,35
14763,0,0,2,11,13
14764,0,0,14,32,46
14765,0,0,5,14,19
14766,0,0,4,2,6
14767,0,0,0,6,6
14768,0,0,3,11,14
14769,0,0,23,24,47
14770,1,0,14,21,36
14771,0,0,7,14,21
14772,0,0,10,14,24
14773,0,0,5,16,21
14774,0,0,4,3,7
14775,0,0,6,16,22
14776,1,1,6,33,41
14777,0,0,2,4,6
14778,0,1,2,16,19
14779,0,0,13,37,50
14780,0,0,6,5,11
14781,0,0,0,2,2
14782,0,0,15,22,37
14783,0,0,14,6,20
14785,0,0,0,15,15
14786,0,0,0,4,4
14787,0,1,5,20,26
14788,0,0,9,26,35
14789,0,0,8,4,12
14790,0,0,6,9,15
14791,0,0,12,20,32
14792,0,0,15,28,43
14793,0,0,10,13,23
14794,0,0,11,9,20
14796,0,0,6,6,12
14797,0,0,3,3,6
14798,0,0,7,10,17
14799,1,0,8,14,23
14800,0,0,4,16,20
14801,0,3,5,22,30
14802,0,0,3,7,10
14803,0,0,10,10,20
14804,0,0,3,3,6
14805,0,0,1,3,4
14806,1,1,15,33,50
14807,0,0,3,10,13
14808,0,0,2,9,11
14809,0,0,6,9,15
14810,1,0,1,9,11
14811,0,0,4,6,10
14812,0,0,10,11,21
14813,0,0,3,6,9
14814,0,1,2,17,20
14815,0,0,2,0,2
14816,0,0,5,10,15
14817,0,0,13,15,28
14818,0,0,3,10,13
14819,0,0,5,13,18
14820,0,0,12,36,48
14821,0,0,18,32,50
14822,1,0,4,14,19
14823,0,0,14,31,45
14824,0,0,3,12,15
14825,0,0,4,26,30
14826,0,0,11,19,30
14827,0,0,10,29,39
14828,0,3,8,39,50
14829,0,0,5,3,8
14830,0,0,12,25,37
14831,0,0,5,12,17
14832,0,0,4,7,11
14833,0,0,5,6,11
14834,0,0,4,6,10
14835,0,0,7,20,27
14836,0,0,4,3,7
14838,0,0,6,13,19
14839,1,0,8,23,32
14840,0,1,9,37,47
14841,0,0,8,25,33
14842,0,0,1,8,9
14843,0,0,12,32,44
14845,0,0,13,27,40
14846,0,1,6,27,34
14847,0,0,9,26,35
14848,0,0,7,11,18
14849,0,0,5,5,10
14850,0,0,17,33,50
14851,0,1,15,33,49
14852,0,0,14,24,38
14853,0,0,7,26,33
14854,0,0,9,20,29
14855,0,0,7,14,21
14857,0,0,8,12,20
14858,0,0,14,22,36
14859,0,0,5,17,22
14860,1,0,13,30,44
14861,0,0,5,10,15
14862,0,0,10,11,21
14863,0,2,5,19,26
14864,0,2,13,35,50
14865,0,1,1,17,19
14866,0,0,11,18,29
14867,0,0,8,24,32
14868,0,1,0,14,15
14869,0,1,0,2,3
14870,0,0,7,17,24
14871,0,0,5,16,21
14872,0,0,13,18,31
14874,0,0,8,8,16
14875,0,0,3,9,12
14876,1,1,9,21,32
14877,0,0,4,8,12
14878,1,0,13,35,49
14879,0,1,12,35,48
14880,0,0,10,7,17
14881,2,2,7,39,50
14882,0,0,16,32,48
14883,0,1,9,26,36
14884,1,1,15,33,50
14885,0,0,7,10,17
14886,0,0,9,28,37
14887,0,0,6,9,15
14888,0,1,5,44,50
14889,0,0,4,8,12
14890,0,1,7,29,37
14891,1,0,7,28,36
14892,0,0,4,4,8
14893,0,0,3,10,13
14894,0,0,13,25,38
14895,0,0,6,9,15
14896,1,0,6,13,20
14897,0,0,3,6,9
14898,0,0,7,9,16
14899,0,0,15,34,49
14900,0,0,7,24,31
14901,0,0,12,6,18
14902,0,0,9,23,32
14903,0,0,9,36,45
14904,0,0,15,18,33
14905,0,2,13,17,32
14906,0,0,8,16,24
14907,0,1,9,7,17
14908,0,0,10,16,26
14910,0,0,1,11,12
14911,0,0,1,7,8
14912,0,0,0,6,6
14913,0,0,14,26,40
14914,0,1,8,20,29
14915,0,1,9,13,23
14916,0,0,4,12,16
14917,0,0,10,37,47
14918,0,0,3,11,14
14919,1,0,9,20,30
14920,0,0,1,9,10
14921,0,0,3,5,8
14922,0,0,5,10,15
14923,0,0,7,11,18
14924,0,0,15,19,34
14925,0,0,5,10,15
14926,0,0,2,14,16
14927,0,0,2,8,10
14928,1,0,12,28,41
14929,0,0,7,23,30
14930,1,1,4,27,33
14931,0,0,8,19,27
14932,1,0,3,29,33
14933,0,0,13,18,31
14934,0,1,4,10,15
14936,0,0,1,3,4
14938,0,0,7,11,18
14939,0,1,5,28,34
14940,0,0,13,15,28
14941,0,2,7,24,33
14942,1,0,1,4,6
14943,0,0,3,22,25
14944,0,2,4,16,22
14945,0,0,11,11,22
14946,0,0,1,8,9
14947,0,0,5,10,15
14948,0,3,5,22,30
14949,0,0,12,20,32
14950,0,0,16,29,45
14951,0,0,11,38,49
14952,1,1,9,28,39
14953,2,1,3,21,27
14954,1,1,15,33,50
14955,0,0,8,24,32
14956,2,0,5,19,26
14957,0,0,1,5,6
14958,0,0,9,20,29
14959,0,0,4,11,15
14960,0,0,7,19,26
14961,1,1,4,27,33
14962,0,0,11,11,22
14963,0,2,4,16,22
14964,0,0,7,20,27
14965,1,1,7,25,34
14966,1,1,7,25,34
14967,0,0,11,11,22
14968,1,0,1,4,6
14969,1,1,4,27,33
14970,0,0,5,10,15
14971,0,1,5,28,34
14972,0,0,11,30,41
14973,0,0,5,30,35
14974,1,1,13,33,48
14975,0,0,5,8,13
14976,0,0,3,9,12
14977,0,1,3,25,29
14978,0,0,8,9,17
14979,0,0,5,5,10
14980,0,0,3,3,6
14981,0,0,4,15,19
14982,0,1,8,41,50
14983,0,0,18,17,35
14984,0,0,1,10,11
14985,0,0,12,27,39
14986,0,0,3,8,11
14987,0,0,9,24,33
14988,0,0,7,7,14
14989,0,1,7,5,13
14990,0,0,10,35,45
14991,0,0,4,8,12
14992,1,0,7,10,18
14995,0,0,7,22,29
14996,0,1,13,29,43
14997,0,0,2,14,16
14998,0,1,7,19,27
14999,0,0,1,3,4
15000,0,0,4,0,4
15002,0,1,6,7,14
15003,0,0,1,3,4
15004,0,0,2,5,7
15005,0,1,10,24,35
15006,0,0,4,5,9
15007,0,0,0,5,5
15008,0,2,4,12,18
15009,0,0,0,5,5
15010,2,0,1,24,27
15011,1,7,4,28,40
15012,0,0,8,3,11
15013,2,1,4,18,25
15014,0,5,2,9,16
15015,2,1,4,18,25
15016,0,0,4,7,11
15017,1,7,4,28,40
15018,0,1,6,7,14
15019,2,0,1,24,27
15020,6,0,2,21,29
15021,0,0,4,13,17
15022,0,0,3,10,13
15023,0,0,2,8,10
15024,0,0,4,10,14
15025,0,0,13,30,43
15026,0,1,1,4,6
15027,0,1,8,28,37
15028,0,1,5,33,39
15029,0,1,22,23,46
15030,0,0,1,16,17
15031,0,0,6,19,25
15032,0,1,8,5,14
15033,0,0,4,13,17
15034,0,0,1,1,2
15035,0,0,0,5,5
15036,0,0,3,9,12
15037,0,1,6,6,13
15038,0,0,5,14,19
15039,0,1,5,12,18
15040,0,0,1,5,6
15041,0,0,2,8,10
15042,0,0,0,5,5
15043,0,0,6,7,13
15044,0,1,5,12,18
15045,0,0,9,16,25
15046,0,5,2,9,16
15047,0,0,5,15,20
15048,0,6,18,26,50
15049,0,1,1,9,11
15050,0,0,2,7,9
15051,0,0,1,6,7
15052,0,0,10,19,29
15053,0,0,4,11,15
15054,0,0,6,24,30
15055,0,3,1,18,22
15056,0,0,4,5,9
15057,0,2,9,11,22
15058,0,2,10,23,35
15060,1,1,3,13,18
15061,1,0,5,16,22
15062,0,0,5,13,18
15063,0,4,8,16,28
15064,0,0,1,9,10
15065,0,0,11,15,26
15066,0,0,3,11,14
15067,0,2,5,9,16
15068,1,0,11,5,17
15069,0,0,5,13,18
15071,0,0,5,15,20
15072,0,0,2,9,11
15073,0,0,2,8,10
15074,0,0,6,11,17
15075,0,0,1,11,12
15076,0,0,4,11,15
15078,0,0,6,7,13
15079,0,0,3,8,11
15080,0,1,0,6,7
15081,0,0,3,3,6
15082,0,0,7,9,16
15083,0,0,3,2,5
15084,0,0,3,8,11
15085,1,0,3,20,24
15086,0,0,1,4,5
15087,0,0,4,9,13
15088,0,1,2,12,15
15089,0,0,0,15,15
15090,0,0,3,6,9
15091,0,0,4,3,7
15092,0,0,2,7,9
15093,0,0,2,5,7
15094,0,0,3,5,8
15095,0,0,10,16,26
15096,0,0,11,9,20
15097,0,5,1,4,10
15098,0,0,11,33,44
15099,0,0,7,17,24
15100,0,0,2,5,7
15102,0,0,0,5,5
15103,2,4,12,32,50
15104,2,2,1,18,23
15105,0,1,12,20,33
15106,0,2,21,20,43
15107,0,0,1,6,7
15108,0,0,3,16,19
15109,0,0,3,9,12
15110,0,0,2,3,5
15111,0,0,5,10,15
15112,0,0,4,9,13
15113,0,0,5,9,14
15114,2,0,6,11,19
15115,1,0,5,6,12
15116,0,0,3,12,15
15117,0,1,3,7,11
15118,0,0,5,13,18
15119,0,0,3,6,9
15120,0,0,1,5,6
15121,0,0,2,3,5
15122,0,0,7,9,16
15123,0,0,2,3,5
15124,0,1,6,20,27
15125,0,0,4,11,15
15126,0,1,5,16,22
15127,0,0,0,3,3
15128,0,0,2,10,12
15129,0,0,6,5,11
15130,0,0,3,21,24
15131,0,0,7,9,16
15132,0,0,0,5,5
15134,1,0,0,2,3
15135,0,0,3,8,11
15136,0,0,4,8,12
15137,6,0,2,21,29
15138,0,0,0,1,1
15139,0,0,5,25,30
15140,0,3,10,19,32
15141,0,0,6,2,8
15142,0,0,0,1,1
15143,0,0,15,22,37
15144,1,0,4,10,15
15145,0,0,1,7,8
15146,1,0,10,12,23
15147,0,0,0,3,3
15148,0,0,3,10,13
15149,0,0,5,8,13
15150,0,0,17,29,46
15151,0,1,13,35,49
15153,0,0,4,10,14
15154,0,1,14,35,50
15155,0,0,8,6,14
15156,0,1,2,12,15
15157,0,1,8,17,26
15158,0,0,0,6,6
15159,0,2,8,10,20
15160,0,0,6,5,11
15161,0,0,2,6,8
15162,1,0,8,25,34
15163,0,0,8,14,22
15164,0,0,2,10,12
15166,0,0,9,18,27
15167,0,0,2,3,5
15168,3,0,12,26,41
15169,4,0,4,21,29
15170,1,0,9,39,49
15171,1,0,10,12,23
15172,1,0,13,36,50
15173,1,0,17,29,47
15174,1,0,10,32,43
15175,1,0,4,10,15
15176,0,0,6,9,15
15177,0,0,7,9,16
15178,0,1,5,12,18
15179,0,0,6,14,20
15180,5,0,2,24,31
15181,0,1,8,17,26
15182,0,0,10,7,17
15183,0,1,2,12,15
15184,0,0,3,7,10
15185,0,0,9,32,41
15186,0,4,3,18,25
15187,0,1,6,29,36
15188,0,0,4,17,21
15189,0,0,2,5,7
15190,1,2,18,29,50
15191,0,0,7,16,23
15192,0,0,0,5,5
15193,0,0,4,13,17
15194,0,0,4,7,11
15195,0,1,4,4,9
15196,0,0,6,6,12
15197,0,0,13,34,47
15198,0,0,3,29,32
15199,0,2,10,23,35
15200,0,1,13,35,49
15201,0,0,6,5,11
15202,1,1,6,23,31
15203,0,0,9,15,24
15205,0,0,3,10,13
15206,0,1,14,35,50
15207,2,0,6,11,19
15209,0,0,5,9,14
15210,0,0,2,10,12
15211,0,1,12,18,31
15212,0,0,11,17,28
15213,0,0,4,9,13
15214,0,0,3,29,32
15215,5,0,2,24,31
15216,1,0,17,24,42
15217,0,0,0,5,5
15218,0,0,1,4,5
15219,1,0,8,25,34
15220,0,0,3,10,13
15221,0,1,13,35,49
15222,0,0,4,13,17
15223,2,0,6,11,19
15224,0,0,6,6,12
15225,0,0,4,9,13
15226,1,0,13,36,50
15227,0,0,5,8,13
15228,0,0,6,19,25
15229,4,0,4,21,29
15230,0,0,3,29,32
15231,2,2,1,18,23
15232,2,4,12,32,50
15233,0,1,8,28,37
15234,0,0,5,9,14
15235,0,0,3,4,7
15236,1,0,17,24,42
15237,3,0,12,26,41
15238,0,1,6,29,36
15239,0,0,13,34,47
15240,0,1,5,33,39
15241,0,0,3,6,9
15242,1,0,13,36,50
15243,0,0,11,17,28
15244,4,0,4,21,29
15245,0,0,9,15,24
15246,0,0,2,6,8
15247,0,1,22,23,46
15248,0,0,8,14,22
15249,0,0,2,3,5
15250,0,4,3,18,25
15251,1,1,6,23,31
15252,0,0,17,29,46
15253,0,1,8,5,14
15254,0,0,0,5,5
15255,0,1,14,35,50
15256,0,0,4,5,9
15257,0,0,15,22,37
15258,1,0,11,5,17
15259,0,2,8,10,20
15260,0,0,2,6,8
15261,0,0,4,13,17
15262,0,0,0,6,6
15263,0,0,5,15,20
15264,0,2,9,11,22
15265,2,0,6,11,19
15266,0,0,4,9,13
15267,1,2,18,29,50
15268,6,0,2,21,29
15269,0,0,2,10,12
15271,0,1,12,18,31
15272,0,0,12,22,34
15274,6,0,2,21,29
15275,0,0,2,11,13
15276,0,1,4,8,13
15277,0,1,10,13,24
15278,0,0,3,13,16
15279,0,1,5,33,39
15280,0,0,16,34,50
15281,0,0,1,16,17
15282,4,2,10,34,50
15283,0,0,2,2,4
15284,0,1,1,21,23
15285,0,1,14,16,31
15286,0,0,4,10,14
15287,1,0,5,18,24
15288,0,1,4,15,20
15289,0,0,5,6,11
15290,0,0,4,16,20
15291,0,0,6,14,20
15292,0,0,7,10,17
15293,0,0,3,6,9
15294,0,0,6,15,21
15295,0,0,14,27,41
15296,0,0,8,16,24
15297,0,1,5,18,24
15298,0,1,6,21,28
15299,0,0,7,17,24
15300,0,0,2,16,18
15301,0,0,6,22,28
15302,0,0,13,16,29
15303,0,0,5,8,13
15304,0,0,8,16,24
15305,0,0,5,8,13
15306,0,0,6,7,13
15307,1,0,9,40,50
15309,0,0,19,31,50
15310,0,0,3,4,7
15311,0,0,2,6,8
15312,0,0,4,12,16
15313,0,0,9,11,20
15314,0,0,9,14,23
15315,0,0,2,11,13
15316,0,0,0,5,5
15317,0,0,3,4,7
15318,0,1,11,35,47
15319,0,0,4,5,9
15320,0,0,1,10,11
15322,0,1,15,33,49
15323,1,0,1,8,10
15324,0,2,1,10,13
15325,0,2,8,18,28
15326,0,0,1,5,6
15327,0,0,5,12,17
15328,0,2,1,12,15
15329,0,0,7,14,21
15330,0,1,15,29,45
15331,0,1,6,12,19
15332,0,0,4,9,13
15333,0,1,14,20,35
15334,0,1,7,17,25
15335,0,0,3,4,7
15336,2,0,9,22,33
15337,0,0,2,3,5
15338,0,0,6,7,13
15339,0,0,4,2,6
15340,0,0,6,7,13
15342,0,0,2,14,16
15343,0,1,6,14,21
15344,0,0,5,11,16
15345,2,0,8,26,36
15346,0,0,7,7,14
15347,1,0,0,4,5
15348,0,0,0,7,7
15349,0,0,2,5,7
15350,0,0,1,5,6
15351,0,0,6,18,24
15352,0,0,7,1,8
15353,0,1,11,31,43
15354,0,0,9,33,42
15355,0,1,7,5,13
15356,0,0,8,10,18
15357,0,0,6,11,17
15358,0,0,16,29,45
15359,0,1,6,2,9
15360,0,0,9,19,28
15361,0,0,1,5,6
15362,0,0,0,20,20
15363,0,0,9,23,32
15364,0,0,7,13,20
15365,0,0,5,5,10
15366,0,0,1,4,5
15367,0,0,10,17,27
15368,0,0,4,3,7
15369,0,0,10,40,50
15370,0,0,6,12,18
15371,0,0,4,13,17
15372,0,0,8,13,21
15373,0,1,10,18,29
15374,1,1,8,37,47
15375,0,0,1,8,9
15376,0,1,13,19,33
15377,0,0,18,29,47
15378,0,0,1,5,6
15379,0,0,7,11,18
15380,0,0,8,17,25
15381,2,1,15,31,49
15382,0,0,4,16,20
15383,0,2,7,12,21
15384,0,0,5,6,11
15385,0,1,9,34,44
15386,0,0,4,4,8
15387,0,0,5,16,21
15388,0,2,2,6,10
15389,0,0,14,35,49
15390,0,0,5,6,11
15391,0,0,2,9,11
15392,0,1,8,17,26
15393,0,0,2,6,8
15394,0,1,0,12,13
15395,0,0,4,9,13
15396,0,2,8,10,20
15397,0,0,11,11,22
15398,0,0,0,4,4
15399,0,0,6,10,16
15400,0,0,0,13,13
15401,0,0,4,5,9
15402,0,1,3,28,32
15403,0,0,8,5,13
15404,0,0,9,13,22
15405,0,0,2,7,9
15406,0,0,1,4,5
15407,0,0,1,4,5
15408,0,0,9,10,19
15409,0,1,2,13,16
15410,0,2,11,16,29
15411,0,0,14,33,47
15412,2,0,2,19,23
15413,0,0,10,24,34
15414,0,0,3,3,6
15415,0,1,2,6,9
15416,0,0,1,1,2
15417,0,0,2,7,9
15418,0,0,2,6,8
15419,0,0,5,19,24
15420,0,0,13,37,50
15421,0,1,4,3,8
15422,0,3,11,26,40
15423,0,1,3,18,22
15424,0,0,2,1,3
15425,0,0,2,4,6
15426,0,1,10,15,26
15427,0,0,7,14,21
15428,0,0,8,9,17
15429,0,7,4,39,50
15430,0,0,1,5,6
15431,0,3,8,20,31
15432,0,0,6,26,32
15433,0,2,3,3,8
15434,0,1,5,10,16
15435,0,0,0,6,6
15436,0,0,3,5,8
15437,0,0,4,5,9
15438,0,0,5,17,22
15439,0,1,10,14,25
15440,0,0,6,10,16
15441,0,0,2,15,17
15442,0,0,1,4,5
15443,0,0,6,7,13
15444,0,0,7,9,16
15445,0,0,4,13,17
15446,0,0,12,16,28
15447,0,0,1,6,7
15449,0,0,7,16,23
15450,0,0,3,15,18
15451,0,0,9,9,18
15452,0,1,7,13,21
15453,0,0,9,13,22
15454,0,0,11,9,20
15455,0,0,5,9,14
15456,0,2,3,10,15
15457,0,0,4,16,20
15458,0,0,7,12,19
15459,0,1,3,12,16
15460,1,1,11,20,33
15461,0,0,6,20,26
15463,0,1,3,17,21
15464,0,0,6,19,25
15465,0,0,8,24,32
15466,1,0,3,11,15
15467,1,1,7,18,27
15468,1,5,5,9,20
15469,0,0,9,32,41
15470,0,0,9,9,18
15471,0,0,3,8,11
15472,0,0,3,10,13
15473,0,1,6,11,18
15474,0,0,5,11,16
15475,0,0,2,3,5
15476,0,0,2,8,10
15477,0,1,7,22,30
15478,0,0,8,8,16
15479,0,0,14,12,26
15481,1,0,2,10,13
15482,0,0,5,10,15
15483,0,0,17,27,44
15484,10,0,7,30,47
15485,0,0,1,5,6
15486,0,0,3,5,8
15487,0,1,4,45,50
15488,0,1,5,8,14
15489,1,0,7,13,21
15490,0,0,0,1,1
15491,0,0,5,3,8
15492,0,0,3,10,13
15493,0,0,3,6,9
15494,0,1,8,20,29
15495,1,0,5,29,35
15496,0,0,5,4,9
15497,0,0,3,1,4
15498,0,0,14,17,31
15499,0,0,5,4,9
15500,0,3,5,16,24
15502,0,1,6,14,21
15503,1,1,4,7,13
15504,0,0,4,10,14
15505,0,0,1,9,10
15506,0,0,5,5,10
15507,0,1,6,15,22
15508,0,1,9,11,21
15509,0,0,6,19,25
15510,0,0,4,7,11
15511,0,0,3,5,8
15512,0,0,2,5,7
15513,0,0,7,10,17
15514,0,0,3,4,7
15515,0,3,8,17,28
15516,0,1,5,14,20
15517,1,0,1,29,31
15518,0,0,2,19,21
15519,1,1,2,15,19
15520,1,2,8,22,33
15521,0,1,10,21,32
15522,0,0,1,12,13
15523,0,0,1,8,9
15524,0,0,3,1,4
15525,0,0,3,10,13
15526,0,0,3,0,3
15527,0,0,5,29,34
15529,0,1,6,38,45
15530,0,0,8,9,17
15531,0,0,3,2,5
15532,0,0,9,35,44
15533,0,0,3,2,5
15535,0,1,12,22,35
15536,0,0,3,11,14
15537,0,1,14,25,40
15538,0,0,6,9,15
15540,0,0,2,0,2
15541,0,3,19,28,50
15542,0,0,3,11,14
15545,0,0,3,7,10
15546,0,0,1,0,1
15547,2,1,4,24,31
15548,1,0,14,19,34
15549,0,0,11,38,49
15550,0,0,1,16,17
15551,1,0,4,10,15
15552,0,2,10,23,35
15553,0,0,12,22,34
15554,0,0,10,24,34
15555,0,1,4,8,13
15556,0,1,11,38,50
15557,0,1,2,18,21
15558,0,4,3,32,39
15559,0,0,5,9,14
15560,0,0,4,15,19
15561,0,1,4,10,15
15562,2,5,6,37,50
15563,1,0,3,6,10
15564,0,0,9,23,32
15565,0,0,4,21,25
15566,0,0,12,27,39
15567,6,0,2,21,29
15568,0,0,5,24,29
15569,0,0,5,25,30
15570,0,0,1,11,12
15571,0,0,10,40,50
15572,0,0,7,15,22
15573,0,0,9,31,40
15574,0,0,11,37,48
15575,0,0,10,24,34
15576,0,0,7,19,26
15577,0,0,13,21,34
15578,0,0,1,16,17
15579,0,3,9,31,43
15580,1,0,14,35,50
15581,1,0,17,29,47
15582,0,0,10,28,38
15583,0,0,3,6,9
15584,1,1,6,23,31
15585,0,0,15,25,40
15586,0,0,9,15,24
15587,0,0,11,38,49
15588,1,0,1,9,11
15589,0,1,8,14,23
15590,0,0,8,19,27
15591,1,0,4,10,15
15592,0,2,8,30,40
15593,0,0,8,13,21
15594,1,0,4,16,21
15595,0,0,9,11,20
15596,0,0,11,20,31
15597,0,1,3,5,9
15598,0,0,17,27,44
15599,0,0,15,8,23
15600,1,0,13,24,38
15601,0,0,4,29,33
15602,0,0,0,12,12
15603,0,1,11,38,50
15604,1,0,5,12,18
15605,1,0,14,19,34
15606,0,2,10,31,43
15608,0,0,8,14,22
15609,0,0,15,23,38
15610,0,0,7,8,15
15611,0,0,5,6,11
15612,0,0,8,17,25
15613,0,0,8,16,24
15614,2,0,8,17,27
15615,0,0,7,7,14
15616,0,0,1,4,5
15617,2,1,4,24,31
15618,0,0,8,11,19
15619,0,0,0,1,1
15620,1,0,4,14,19
15621,0,0,1,20,21
15622,0,0,10,39,49
15623,0,0,12,27,39
15624,0,0,8,10,18
15625,0,0,11,34,45
15626,2,0,2,19,23
15627,0,0,8,9,17
15628,0,1,12,20,33
15629,0,0,6,7,13
15630,0,3,5,7,15
15631,0,0,4,19,23
15632,0,0,4,12,16
15633,2,2,3,30,37
15635,0,0,15,27,42
15636,0,0,10,16,26
15637,0,0,6,10,16
15638,0,0,3,9,12
15639,0,1,6,13,20
15640,0,1,12,18,31
15641,0,1,2,18,21
15642,0,4,3,18,25
15643,3,0,12,26,41
15644,0,1,14,16,31
15645,0,0,4,16,20
15646,0,1,4,10,15
15647,0,0,2,3,5
15648,4,0,4,28,36
15649,0,0,2,12,14
15650,0,0,3,27,30
15651,0,2,10,23,35
15652,0,0,14,33,47
15653,0,7,4,39,50
15654,2,1,15,31,49
15655,0,0,6,26,32
15656,0,1,8,17,26
15657,0,0,9,23,32
15658,0,2,14,20,36
15659,0,0,5,29,34
15660,0,0,5,9,14
15661,0,0,8,11,19
15662,0,1,4,8,13
15663,0,3,6,12,21
15664,0,0,9,31,40
15665,0,0,9,11,20
15666,0,3,0,15,18
15667,0,0,21,29,50
15668,0,0,4,28,32
15669,0,0,10,28,38
15670,0,0,7,15,22
15671,1,2,10,35,48
15672,0,0,4,16,20
15673,0,0,3,27,30
15674,0,2,14,20,36
15675,0,0,8,11,19
15677,1,0,5,29,35
15678,0,7,4,39,50
15679,0,0,8,16,24
15680,0,0,14,36,50
15681,0,2,14,20,36
15682,0,0,7,17,24
15684,0,0,3,11,14
15685,0,0,0,20,20
15686,0,0,5,8,13
15687,0,0,0,20,20
15688,0,2,14,20,36
15689,1,0,3,6,10
15690,0,0,7,17,24
15691,0,0,5,9,14
15692,0,3,6,20,29
15693,0,0,0,4,4
15694,0,0,8,16,24
15695,0,1,14,14,29
15696,0,0,14,36,50
15697,3,0,12,26,41
15698,0,1,5,33,39
15699,0,3,6,20,29
15700,0,4,3,18,25
15701,0,0,1,16,17
15702,0,0,9,15,24
15703,1,1,6,23,31
15704,0,0,2,3,5
15705,0,0,0,20,20
15706,1,5,5,9,20
15707,0,1,12,18,31
15708,1,0,4,14,19
15709,0,2,8,10,20
15710,0,0,0,6,6
15711,0,0,2,6,8
15712,6,0,2,21,29
15714,1,1,8,40,50
15715,0,0,0,6,6
15716,0,0,3,10,13
15718,0,0,8,22,30
15719,0,1,2,26,29
15720,0,3,21,23,47
15721,0,0,13,34,47
15722,0,0,6,13,19
15723,0,0,0,18,18
15724,0,0,7,19,26
15725,0,0,8,7,15
15726,0,0,2,3,5
15727,0,0,1,6,7
15728,0,0,11,22,33
15730,0,0,10,24,34
15731,0,0,16,29,45
15732,0,0,3,23,26
15733,3,0,1,15,19
15734,0,1,12,24,37
15735,0,0,17,29,46
15736,0,0,0,1,1
15737,0,0,0,6,6
15738,0,0,3,4,7
15740,0,0,4,7,11
15741,0,0,13,18,31
15742,0,0,1,14,15
15743,0,0,2,4,6
15744,0,0,1,13,14
15745,0,1,2,15,18
15746,0,1,5,9,15
15747,0,0,9,15,24
15748,0,0,10,33,43
15749,0,0,2,4,6
15750,0,1,10,24,35
15751,0,0,12,18,30
15753,0,0,8,20,28
15754,0,0,6,12,18
15755,0,0,0,4,4
15756,0,0,1,5,6
15757,0,0,7,5,12
15758,0,0,13,21,34
15759,0,0,9,10,19
15761,0,2,7,21,30
15762,0,1,5,12,18
15763,0,0,0,18,18
15764,0,0,12,20,32
15765,0,0,3,4,7
15766,0,0,2,15,17
15767,0,0,1,13,14
15768,0,1,6,27,34
15769,0,0,4,9,13
15770,0,2,4,29,35
15771,0,0,8,10,18
15772,1,0,5,12,18
15773,0,0,5,13,18
15774,0,1,5,30,36
15775,0,0,11,16,27
15776,0,0,4,9,13
15777,0,0,0,5,5
15778,0,0,7,18,25
15779,0,0,0,5,5
15780,2,0,21,27,50
15781,0,0,6,13,19
15782,0,0,1,11,12
15783,0,1,3,11,15
15784,0,1,1,17,19
15785,0,0,10,18,28
15786,0,0,9,17,26
15788,0,2,8,27,37
15789,0,1,4,11,16
15790,0,0,7,15,22
15791,0,0,17,20,37
15792,2,5,6,37,50
15793,0,0,2,14,16
15794,0,0,6,13,19
15795,1,0,3,6,10
15796,0,0,14,26,40
15797,2,1,4,24,31
15798,0,1,17,19,37
15799,0,0,6,5,11
15800,0,0,9,41,50
15801,0,0,8,18,26
15802,0,0,5,8,13
15803,1,2,7,29,39
15804,0,0,1,6,7
15805,0,1,2,22,25
15807,0,0,7,9,16
15808,0,0,2,5,7
15809,0,0,4,6,10
15810,0,0,1,8,9
15811,0,0,3,0,3
15812,0,0,9,16,25
15813,0,0,6,43,49
15814,0,0,5,22,27
15816,0,0,3,20,23
15817,0,0,4,6,10
15818,0,0,7,10,17
15819,0,0,14,13,27
15820,0,0,9,21,30
15821,0,2,10,31,43
15822,0,0,6,17,23
15823,0,1,7,13,21
15824,0,0,12,27,39
15825,0,0,4,12,16
15826,0,1,3,4,8
15827,0,0,6,5,11
15828,0,0,2,14,16
15829,0,0,3,3,6
15830,0,1,6,6,13
15831,0,0,4,7,11
15832,0,0,4,3,7
15833,0,0,5,10,15
15834,0,2,10,32,44
15835,0,5,4,15,24
15836,0,0,6,4,10
15837,1,0,2,7,10
15838,0,1,5,7,13
15839,0,2,20,28,50
15840,1,0,12,22,35
15841,0,0,6,12,18
15842,0,0,6,7,13
15843,0,1,7,16,24
15844,0,0,4,20,24
15845,0,0,5,8,13
15846,0,0,12,11,23
15847,0,0,6,14,20
15848,0,0,8,10,18
15849,0,0,13,15,28
15850,0,0,7,13,20
15851,0,0,6,17,23
15852,0,0,8,8,16
15853,0,0,12,23,35
15854,1,2,1,18,22
15855,0,0,5,4,9
15856,3,0,1,14,18
15857,0,0,3,2,5
15858,0,0,3,9,12
15859,0,0,5,22,27
15860,0,0,6,3,9
15861,0,2,11,33,46
15862,0,0,3,11,14
15863,0,0,6,10,16
15864,0,0,15,21,36
15865,0,0,3,9,12
15866,0,0,2,9,11
15867,0,0,8,10,18
15870,0,0,9,9,18
15871,0,0,10,11,21
15872,0,0,3,10,13
15873,0,1,5,7,13
15874,0,0,2,10,12
15875,1,0,9,14,24
15876,0,1,4,13,18
15877,0,0,2,3,5
15878,0,0,0,10,10
15879,0,0,7,17,24
15880,0,9,2,20,31
15881,0,1,9,20,30
15882,0,0,4,4,8
15883,0,0,7,12,19
15884,0,0,2,7,9
15885,0,0,0,6,6
15886,0,0,8,9,17
15887,0,0,2,10,12
15888,0,0,1,10,11
15890,1,0,9,11,21
15891,0,1,13,35,49
15892,0,0,3,10,13
15895,0,0,3,4,7
15896,0,0,1,1,2
15897,0,0,0,4,4
15898,0,4,3,32,39
15899,1,5,5,9,20
15900,1,1,8,40,50
15901,0,2,21,20,43
15902,4,0,0,15,19
15903,0,0,5,9,14
15904,0,0,8,11,19
15905,0,0,13,30,43
15906,0,0,17,21,38
15907,0,0,8,17,25
15908,1,1,7,41,50
15909,0,1,15,34,50
15910,1,1,3,6,11
15911,0,0,10,18,28
15912,0,0,15,27,42
15913,0,0,6,3,9
15914,0,0,5,16,21
15915,1,1,8,40,50
15916,0,1,10,23,34
15917,0,1,8,17,26
15918,0,1,14,27,42
15919,0,0,10,26,36
15920,0,1,12,21,34
15921,0,0,15,33,48
15922,1,1,17,23,42
15923,0,0,5,3,8
15924,0,0,7,42,49
15925,0,0,6,19,25
15926,0,0,14,34,48
15927,0,0,2,9,11
15928,0,0,2,25,27
15929,0,0,12,18,30
15930,0,0,5,11,16
15931,0,0,4,12,16
15932,1,0,14,35,50
15933,0,0,7,17,24
15934,0,0,14,18,32
15935,0,0,15,34,49
15936,0,0,12,11,23
15937,0,1,17,29,47
15938,0,0,13,19,32
15939,1,0,9,11,21
15940,0,0,3,6,9
15941,1,0,6,29,36
15942,0,0,19,27,46
15943,0,0,8,29,37
15945,0,0,5,21,26
15946,3,1,4,36,44
15947,0,0,4,10,14
15948,2,1,14,31,48
15949,0,1,7,18,26
15950,0,0,5,7,12
15951,0,0,7,8,15
15952,0,0,13,13,26
15953,0,0,3,4,7
15954,0,0,9,33,42
15955,0,0,20,28,48
15956,0,0,12,38,50
15957,0,0,3,6,9
15958,0,0,3,5,8
15959,0,0,5,26,31
15960,0,0,6,21,27
15961,0,1,8,19,28
15962,0,0,6,11,17
15963,0,1,1,13,15
15964,0,0,5,18,23
15965,0,0,3,7,10
15966,1,0,13,20,34
15967,0,1,4,41,46
15968,1,2,1,26,30
15969,0,0,9,9,18
15970,0,2,11,21,34
15972,0,2,5,28,35
15973,0,0,3,5,8
15974,0,0,9,14,23
15975,0,0,4,3,7
15976,0,2,14,20,36
15977,0,0,9,18,27
15978,1,0,17,27,45
15979,3,1,3,17,24
15980,0,0,1,9,10
15981,1,1,7,18,27
15982,0,3,7,24,34
15984,0,0,16,28,44
15986,0,0,4,28,32
15987,0,0,6,5,11
15988,0,1,13,35,49
15989,4,0,4,21,29
15990,2,1,4,24,31
15991,0,0,0,5,5
15992,0,0,3,10,13
15993,0,0,12,27,39
15994,4,0,0,15,19
15995,0,0,11,39,50
15996,0,0,7,13,20
15997,0,0,5,9,14
15998,0,0,0,10,10
15999,0,0,1,10,11
16001,0,0,7,9,16
16002,4,2,11,33,50
16004,0,0,9,28,37
16005,2,0,5,26,33
16006,0,0,1,6,7
16007,0,1,8,40,49
16008,0,0,10,13,23
16010,0,0,9,14,23
16012,2,1,14,31,48
16013,0,0,7,13,20
16014,0,0,16,28,44
16015,0,0,3,36,39
16016,0,0,4,28,32
16017,0,0,3,10,13
16018,0,1,13,35,49
16019,1,0,17,27,45
16020,4,0,0,15,19
16021,0,2,14,20,36
16022,4,0,4,21,29
16023,1,0,3,6,10
16024,0,0,0,4,4
16025,0,0,5,9,14
16026,0,0,16,28,44
16027,0,0,17,29,46
16028,4,0,4,21,29
16029,1,5,5,9,20
16030,0,2,10,27,39
16031,0,0,12,22,34
16033,0,1,1,37,39
16034,0,0,0,5,5
16035,3,0,4,13,20
16036,0,0,10,13,23
16037,0,0,0,7,7
16038,0,0,11,25,36
16039,0,0,8,38,46
16040,0,0,16,33,49
16041,0,0,7,24,31
16042,0,0,0,8,8
16043,0,0,17,22,39
16044,0,1,9,13,23
16045,1,0,9,40,50
16046,0,0,5,11,16
16047,0,0,15,19,34
16048,0,1,13,20,34
16049,0,0,12,15,27
16051,0,0,1,1,2
16052,0,0,4,3,7
16053,0,0,7,16,23
16054,0,1,13,36,50
16055,0,0,1,20,21
16056,0,0,11,20,31
16057,0,1,5,11,17
16058,0,2,7,5,14
16059,0,1,14,20,35
16060,0,0,1,15,16
16061,1,0,9,11,21
16062,0,0,5,6,11
16063,0,0,7,14,21
16064,0,1,8,16,25
16065,0,1,3,10,14
16066,0,0,8,42,50
16067,0,0,8,17,25
16068,0,0,12,22,34
16069,1,0,14,19,34
16070,0,0,6,17,23
16071,0,0,5,15,20
16072,0,0,7,19,26
16073,0,0,1,17,18
16074,0,0,2,10,12
16075,0,0,8,19,27
16076,0,0,10,26,36
16077,0,0,1,8,9
16078,1,3,19,27,50
16079,1,0,10,25,36
16080,0,1,9,13,23
16081,0,0,3,5,8
16082,0,0,4,4,8
16083,0,0,10,17,27
16085,0,0,6,15,21
16086,0,1,17,32,50
16087,0,1,11,14,26
16088,0,0,8,12,20
16089,0,0,2,4,6
16090,0,0,12,12,24
16091,0,0,4,7,11
16092,0,0,3,3,6
16093,0,0,4,14,18
16094,0,3,7,25,35
16095,0,0,6,13,19
16096,0,0,1,8,9
16097,0,0,14,35,49
16098,0,0,8,12,20
16099,0,0,2,2,4
16100,0,1,1,17,19
16101,0,0,6,21,27
16102,0,1,6,9,16
16103,0,0,3,11,14
16104,0,0,3,25,28
16105,0,0,3,7,10
16106,0,0,5,20,25
16107,0,0,14,36,50
16108,0,0,10,15,25
16109,0,2,8,17,27
16110,0,0,2,6,8
16111,0,0,0,7,7
16112,0,0,3,11,14
16113,1,1,9,38,49
16114,0,0,5,9,14
16115,1,0,3,8,12
16116,0,0,0,27,27
16117,0,0,8,10,18
16118,0,0,12,29,41
16119,0,1,6,5,12
16120,0,0,10,9,19
16121,0,1,8,13,22
16122,0,0,5,6,11
16123,0,2,4,12,18
16124,0,0,10,11,21
16125,0,3,4,13,20
16126,0,0,10,11,21
16127,0,0,2,7,9
16128,0,0,12,20,32
16129,0,0,3,9,12
16130,0,0,3,9,12
16131,0,0,10,10,20
16132,0,0,2,8,10
16133,0,0,6,6,12
16134,0,0,10,11,21
16135,0,0,17,17,34
16136,0,0,11,39,50
16137,0,0,12,14,26
16138,0,1,3,4,8
16139,0,0,6,9,15
16141,1,0,6,20,27
16142,0,0,10,22,32
16143,0,0,9,14,23
16144,0,0,0,6,6
16145,0,0,3,12,15
16146,0,5,5,24,34
16147,0,0,8,11,19
16148,1,0,5,12,18
16149,0,0,3,4,7
16150,0,1,11,19,31
16151,0,0,1,4,5
16152,0,0,4,17,21
16153,0,0,0,7,7
16154,0,0,5,9,14
16155,0,0,9,13,22
16156,0,0,1,9,10
16157,0,0,1,7,8
16158,0,0,5,3,8
16160,0,1,4,11,16
16161,1,0,9,25,35
16163,0,0,1,8,9
16164,2,1,3,24,30
16165,0,0,0,5,5
16166,0,2,9,11,22
16167,0,2,7,11,20
16168,0,1,8,28,37
16169,2,5,6,37,50
16170,0,0,1,10,11
16171,0,4,3,32,39
16173,0,2,10,27,39
16174,0,0,6,17,23
16175,0,0,10,14,24
16176,0,0,13,15,28
16177,0,0,10,30,40
16178,0,0,6,15,21
16179,0,0,13,27,40
16180,0,0,20,26,46
16181,0,1,14,34,49
16182,0,0,5,25,30
16183,0,0,7,18,25
16184,0,0,15,19,34
16185,0,1,6,15,22
16186,0,0,8,27,35
16187,0,0,10,22,32
16188,7,1,3,20,31
16189,0,0,7,7,14
16190,0,0,9,41,50
16191,0,1,8,6,15
16192,0,0,0,5,5
16193,0,0,7,16,23
16194,0,0,5,15,20
16195,0,0,21,27,48
16196,0,1,6,6,13
16197,0,0,3,13,16
16198,0,0,6,7,13
16199,0,0,13,28,41
16200,2,1,11,34,48
16201,0,0,0,5,5
16202,0,0,13,35,48
16203,0,0,7,32,39
16204,0,0,10,20,30
16205,0,0,1,6,7
16206,0,0,5,15,20
16207,0,0,8,24,32
16208,0,0,14,25,39
16209,0,0,5,3,8
16210,0,0,1,0,1
16211,0,1,3,9,13
16212,0,0,8,8,16
16213,0,0,1,1,2
16214,0,0,1,10,11
16215,0,0,0,4,4
16216,0,0,0,4,4
16217,0,0,5,23,28
16218,1,0,11,22,34
16219,1,0,6,8,15
16220,1,0,11,22,34
16221,0,0,0,4,4
16222,1,0,11,22,34
16223,0,0,0,4,4
16224,0,0,11,13,24
16225,0,0,7,9,16
16226,0,0,8,11,19
16227,0,0,7,12,19
16228,0,1,5,2,8
16230,0,0,3,2,5
16231,0,1,3,11,15
16232,0,0,1,14,15
16233,0,1,2,18,21
16234,2,0,5,28,35
16235,0,0,5,0,5
16236,0,0,12,18,30
16237,0,0,11,16,27
16238,0,0,8,11,19
16239,1,0,11,28,40
16240,0,0,1,12,13
16241,0,1,15,34,50
16242,0,0,3,6,9
16243,0,0,3,0,3
16244,0,0,6,7,13
16245,0,1,1,10,12
16246,0,0,6,15,21
16247,0,0,4,7,11
16248,0,1,4,15,20
16249,0,0,2,2,4
16250,0,1,3,6,10
16251,1,0,10,17,28
16252,0,0,4,6,10
16253,0,0,10,18,28
16254,0,1,6,4,11
16255,0,1,3,13,17
16256,0,1,3,11,15
16257,0,0,8,6,14
16258,0,0,7,6,13
16259,0,1,2,8,11
16260,0,0,6,7,13
16261,0,0,3,3,6
16262,0,0,1,6,7
16263,0,0,6,7,13
16264,0,0,7,9,16
16265,0,0,1,16,17
16266,0,0,4,4,8
16267,0,0,3,2,5
16268,0,0,1,8,9
16269,0,1,2,12,15
16270,0,0,7,18,25
16271,0,1,5,12,18
16272,0,0,8,2,10
16273,0,0,7,12,19
16274,0,0,2,4,6
16275,0,0,1,7,8
16276,0,0,5,33,38
16277,0,0,7,4,11
16278,2,2,12,31,47
16279,0,1,1,8,10
16280,0,1,8,14,23
16281,0,0,16,15,31
16282,2,0,7,16,25
16283,0,1,15,34,50
16284,0,1,5,2,8
16285,0,0,5,10,15
16286,0,0,11,27,38
16287,0,0,6,11,17
16288,0,0,8,11,19
16289,0,0,13,37,50
16290,0,0,4,46,50
16291,0,0,8,2,10
16292,0,1,8,14,23
16293,0,0,11,13,24
16294,0,1,1,8,10
16295,0,0,8,11,19
16296,0,0,3,6,9
16297,0,0,4,46,50
16298,2,0,7,16,25
16299,0,0,1,7,8
16300,0,0,4,46,50
16301,0,0,1,12,13
16302,0,1,4,15,20
16303,0,0,16,15,31
16304,0,0,5,10,15
16305,0,0,5,33,38
16306,0,0,3,6,9
16307,0,0,7,4,11
16308,4,0,3,23,30
16309,0,0,5,33,38
16310,0,1,1,8,10
16311,2,0,7,16,25
16312,0,0,8,21,29
16313,1,0,13,24,38
16314,0,0,0,6,6
16315,0,1,11,28,40
16316,0,0,6,2,8
16317,0,0,16,25,41
16318,0,1,3,11,15
16319,0,0,2,4,6
16320,0,0,3,3,6
16321,0,0,14,17,31
16322,0,1,10,24,35
16323,0,1,8,25,34
16324,0,2,3,4,9
16325,1,0,13,36,50
16326,0,2,11,24,37
16327,0,0,10,15,25
16328,0,0,4,15,19
16329,0,0,7,18,25
16330,0,0,5,7,12
16332,0,0,4,11,15
16333,1,1,8,40,50
16334,0,0,7,6,13
16335,0,0,10,13,23
16336,0,1,21,27,49
16337,0,0,0,11,11
16338,0,0,15,24,39
16339,0,0,5,0,5
16340,0,0,6,4,10
16341,0,2,9,6,17
16342,0,0,8,19,27
16343,0,0,3,7,10
16344,0,1,11,24,36
16345,0,1,10,8,19
16346,0,0,9,6,15
16347,0,0,2,2,4
16348,0,2,0,13,15
16349,0,0,14,22,36
16350,0,0,11,9,20
16351,0,0,10,11,21
16352,0,0,5,15,20
16353,0,0,3,6,9
16354,0,0,11,4,15
16355,0,0,3,12,15
16356,0,0,8,8,16
16357,0,0,7,10,17
16358,0,1,11,18,30
16359,0,1,4,15,20
16360,0,0,6,2,8
16361,0,0,4,9,13
16362,0,0,1,4,5
16363,0,0,11,27,38
16364,0,0,8,15,23
16365,0,0,3,2,5
16366,0,0,6,11,17
16367,0,0,2,4,6
16368,0,0,4,17,21
16369,0,0,13,32,45
16370,0,0,3,1,4
16371,0,0,0,5,5
16372,0,0,1,22,23
16373,0,0,16,25,41
16374,0,0,1,6,7
16375,0,0,9,8,17
16376,0,1,7,3,11
16377,0,0,5,12,17
16378,0,0,5,2,7
16379,0,0,6,9,15
16380,0,0,6,10,16
16381,0,0,6,9,15
16382,0,1,11,27,39
16383,0,1,9,12,22
16384,0,1,2,9,12
16385,0,0,3,4,7
16386,0,1,3,2,6
16388,0,0,6,11,17
16389,0,0,3,6,9
16390,0,0,9,20,29
16391,0,1,7,10,18
16392,0,0,15,28,43
16393,0,0,18,15,33
16394,0,1,20,26,47
16395,0,0,9,10,19
16396,0,0,19,12,31
16397,0,0,9,19,28
16398,0,0,8,21,29
16399,0,0,3,19,22
16400,0,1,11,25,37
16401,0,1,2,7,10
16402,0,0,5,9,14
16403,0,0,6,16,22
16404,0,0,10,11,21
16405,0,1,6,19,26
16406,0,0,7,4,11
16407,0,0,8,11,19
16408,0,1,1,8,10
16409,0,1,2,23,26
16410,0,0,6,5,11
16411,0,0,3,1,4
16413,0,0,2,5,7
16414,0,0,6,14,20
16415,0,0,6,18,24
16416,0,0,11,25,36
16417,0,0,4,1,5
16418,0,0,14,24,38
16419,0,0,7,4,11
16420,0,0,5,4,9
16423,0,0,7,9,16
16424,0,0,6,11,17
16425,0,1,12,13,26
16426,0,1,2,3,6
16427,0,0,6,3,9
16428,0,0,6,2,8
16429,0,0,5,4,9
16431,0,0,4,17,21
16432,0,0,3,6,9
16433,0,0,7,21,28
16434,1,0,0,18,19
16435,0,0,12,18,30
16436,0,1,3,11,15
16437,0,1,15,34,50
16438,0,0,5,10,15
16439,0,0,2,4,6
16440,1,0,13,24,38
16441,1,0,2,5,8
16442,0,0,14,16,30
16443,0,0,1,5,6
16444,0,0,10,31,41
16445,0,0,12,20,32
16446,0,0,10,16,26
16447,0,0,7,18,25
16448,1,6,10,31,48
16449,0,0,4,28,32
16450,0,0,17,33,50
16451,0,0,7,15,22
16452,0,1,21,27,49
16453,0,0,2,4,6
16454,0,0,6,10,16
16455,0,0,6,38,44
16456,0,0,10,20,30
16457,0,1,10,9,20
16458,0,0,0,6,6
16459,0,0,7,9,16
16460,0,0,5,14,19
16461,0,0,8,8,16
16462,0,0,16,22,38
16463,0,0,17,28,45
16464,0,2,7,3,12
16465,0,0,9,30,39
16466,0,0,16,26,42
16468,0,0,16,20,36
16469,0,0,5,7,12
16470,0,0,1,17,18
16471,1,1,6,18,26
16472,0,0,6,1,7
16473,0,0,6,19,25
16474,0,0,9,24,33
16475,0,1,18,31,50
16476,0,1,13,30,44
16477,0,0,11,12,23
16478,1,0,8,40,49
16479,0,0,1,9,10
16480,0,1,15,34,50
16481,0,0,4,17,21
16482,0,0,12,22,34
16483,0,0,0,11,11
16484,0,1,2,7,10
16486,3,1,7,39,50
16487,0,1,2,23,26
16488,0,0,16,15,31
16489,0,0,12,18,30
16490,0,0,14,16,30
16491,0,1,1,8,10
16492,1,0,0,18,19
16493,0,0,8,15,23
16494,1,0,2,5,8
16495,0,0,3,6,9
16496,1,0,8,40,49
16497,0,0,2,4,6
16498,1,0,8,30,39
16499,0,0,6,10,16
16500,1,0,8,34,43
16501,0,0,14,16,30
16502,0,1,18,31,50
16503,0,0,12,28,40
16504,1,0,4,14,19
16505,3,1,7,39,50
16506,0,1,4,15,20
16507,0,0,1,5,6
16508,0,0,16,15,31
16509,0,0,10,31,41
16510,3,1,7,39,50
16511,0,0,10,31,41
16512,0,0,3,6,9
16513,0,0,0,11,11
16514,0,1,1,8,10
16515,3,1,7,39,50
16516,0,0,7,4,11
16518,0,0,8,11,19
16519,0,0,0,4,4
16520,0,0,8,5,13
16521,0,0,4,5,9
16522,1,0,13,24,38
16523,0,0,4,17,21
16525,0,0,11,21,32
16526,0,1,15,33,49
16527,0,0,15,34,49
16529,0,0,8,11,19
16530,0,0,2,11,13
16531,0,0,17,23,40
16532,0,0,3,17,20
16533,0,0,8,12,20
16535,0,0,2,5,7
16536,0,2,5,8,15
16537,0,0,13,21,34
16538,0,0,8,15,23
16539,0,0,15,33,48
16540,0,0,14,28,42
16541,0,0,7,18,25
16542,0,0,14,18,32
16543,2,0,12,24,38
16544,0,0,11,19,30
16545,0,0,7,17,24
16546,0,0,11,15,26
16547,0,0,4,15,19
16548,0,0,7,17,24
16549,0,0,9,9,18
16550,0,0,6,3,9
16551,0,0,3,3,6
16552,0,0,3,4,7
16553,0,0,3,3,6
16554,0,0,2,21,23
16555,0,0,5,9,14
16556,0,0,1,4,5
16557,0,0,5,9,14
16558,0,0,5,8,13
16559,0,0,4,6,10
16560,0,0,7,1,8
16561,0,0,11,25,36
16562,0,1,4,5,10
16563,0,0,3,8,11
16564,0,0,7,12,19
16565,0,0,19,30,49
16566,0,0,7,18,25
16567,0,1,10,11,22
16568,0,0,8,14,22
16569,0,1,3,16,20
16570,0,0,5,7,12
16571,0,0,8,15,23
16572,0,0,4,4,8
16573,0,0,7,6,13
16574,0,0,6,8,14
16575,0,0,6,9,15
16576,0,1,8,14,23
16577,0,0,1,4,5
16578,0,0,8,2,10
16579,0,0,5,9,14
16580,0,0,8,20,28
16581,0,1,9,20,30
16582,0,1,12,13,26
16583,0,0,8,7,15
16584,0,0,4,17,21
16585,0,1,9,15,25
16586,0,0,4,5,9
16587,0,0,4,1,5
16588,0,0,6,2,8
16589,0,0,9,10,19
16591,0,0,1,4,5
16592,0,1,9,7,17
16593,0,1,9,23,33
16594,0,0,11,18,29
16595,0,0,5,5,10
16596,0,0,6,1,7
16597,1,0,13,24,38
16598,4,0,6,10,20
16599,0,0,7,20,27
16600,0,0,5,15,20
16601,0,0,7,2,9
16602,0,0,14,26,40
16603,0,0,7,5,12
16604,0,0,2,10,12
16605,0,0,11,8,19
16606,0,0,7,3,10
16607,0,0,7,14,21
16608,0,2,4,17,23
16609,0,0,3,8,11
16610,0,0,9,13,22
16611,0,0,4,5,9
16612,0,0,8,6,14
16614,0,0,3,4,7
16615,0,0,11,11,22
16616,1,2,4,6,13
16617,0,0,8,14,22
16618,0,0,11,25,36
16620,0,0,2,6,8
16621,0,0,7,7,14
16622,0,0,2,4,6
16623,0,0,3,6,9
16624,0,0,14,16,30
16625,0,0,0,4,4
16626,0,0,17,24,41
16627,0,0,4,27,31
16628,0,0,9,16,25
16629,0,2,14,32,48
16630,0,1,10,31,42
16631,0,0,5,16,21
16632,0,0,18,32,50
16633,0,0,13,18,31
16634,0,0,8,17,25
16635,0,1,18,31,50
16636,0,0,11,37,48
16637,1,0,16,31,48
16638,0,0,15,35,50
16639,0,0,13,17,30
16640,0,0,7,15,22
16642,0,1,14,27,42
16643,0,0,17,30,47
16644,0,0,8,9,17
16645,0,0,11,22,33
16646,1,1,13,12,27
16647,0,0,4,8,12
16648,0,0,2,10,12
16649,0,1,17,32,50
16650,0,0,2,10,12
16651,0,1,4,41,46
16652,0,0,9,25,34
16653,0,0,7,9,16
16654,0,0,6,7,13
16655,0,1,10,9,20
16656,0,0,5,10,15
16657,0,0,9,19,28
16658,0,0,8,11,19
16659,0,0,14,16,30
16660,0,1,10,20,31
16661,0,0,0,4,4
16662,0,0,0,9,9
16664,0,0,1,0,1
16665,0,0,2,10,12
16667,0,1,5,24,30
16668,0,0,8,11,19
16669,1,0,2,8,11
16670,0,0,1,11,12
16671,0,0,3,6,9
16672,0,0,14,16,30
16673,0,1,18,31,50
16674,0,0,4,27,31
16675,0,0,6,13,19
16678,0,0,3,7,10
16679,0,0,5,10,15
16680,0,0,3,6,9
16681,0,0,11,37,48
16682,0,0,0,4,4
16683,0,0,4,30,34
16684,0,0,11,13,24
16685,0,0,8,11,19
16686,0,0,0,6,6
16687,0,0,9,14,23
16688,0,0,3,4,7
16689,0,0,0,5,5
16690,0,0,4,1,5
16691,0,0,11,24,35
16692,0,0,3,3,6
16693,0,1,5,12,18
16694,0,0,9,13,22
16695,0,0,8,11,19
16696,1,0,1,11,13
16697,0,0,5,10,15
16698,0,2,6,41,49
16699,0,1,10,18,29
16700,0,0,11,15,26
16701,0,1,3,22,26
16702,0,0,1,14,15
16703,0,1,12,28,41
16704,0,0,3,11,14
16705,0,0,3,9,12
16706,0,0,6,12,18
16707,0,0,8,15,23
16708,0,0,2,10,12
16709,0,0,7,5,12
16710,0,0,6,6,12
16711,0,1,5,14,20
16712,0,1,15,27,43
16713,0,1,6,8,15
16714,0,0,1,5,6
16715,0,0,7,6,13
16716,0,0,3,5,8
16717,0,0,5,5,10
16718,1,2,2,27,32
16719,0,0,6,13,19
16720,0,0,9,11,20
16721,0,0,8,13,21
16723,0,0,9,17,26
16724,0,0,8,12,20
16725,1,0,5,5,11
16726,0,0,11,8,19
16727,1,0,13,19,33
16728,0,1,11,33,45
16729,0,1,14,26,41
16730,0,0,5,7,12
16731,0,0,8,16,24
16732,0,0,8,9,17
16733,0,1,5,24,30
16734,0,0,8,7,15
16735,0,0,6,9,15
16736,0,0,12,26,38
16737,0,0,8,2,10
16738,0,1,5,12,18
16739,0,0,5,16,21
16740,0,0,9,9,18
16741,1,0,6,12,19
16742,0,0,9,19,28
16743,0,0,12,17,29
16744,0,0,5,8,13
16745,0,0,9,15,24
16746,0,0,6,12,18
16747,0,0,1,2,3
16748,0,0,5,11,16
16749,0,0,8,6,14
16750,0,0,17,28,45
16751,0,1,11,35,47
16754,0,0,3,4,7
16755,0,0,7,7,14
16756,1,0,7,11,19
16757,0,1,4,10,15
16758,1,0,12,15,28
16759,0,0,12,30,42
16760,0,1,10,31,42
16761,0,0,11,33,44
16762,0,0,12,34,46
16763,0,0,6,23,29
16764,1,0,6,8,15
16765,0,0,5,8,13
16766,0,1,5,12,18
16767,0,0,7,7,14
16768,0,0,4,8,12
16769,0,1,14,26,41
16770,0,1,10,12,23
16771,0,0,5,8,13
16772,0,2,7,33,42
16773,0,0,8,16,24
16774,0,0,2,20,22
16775,0,0,6,10,16
16776,1,0,2,31,34
16777,0,0,11,13,24
16778,0,3,10,10,23
16779,0,0,0,6,6
16780,0,0,2,12,14
16781,0,0,8,11,19
16782,0,1,7,6,14
16783,0,0,10,14,24
16784,0,0,8,11,19
16785,1,0,2,31,34
16786,1,0,6,3,10
16787,0,1,4,10,15
16788,0,3,10,10,23
16789,0,0,7,12,19
16790,2,1,6,16,25
16791,0,0,0,4,4
16792,0,0,2,24,26
16793,0,0,7,21,28
16794,0,0,8,42,50
16795,0,0,19,31,50
16797,0,0,0,6,6
16798,0,0,5,7,12
16799,0,1,15,31,47
16800,1,0,13,36,50
16801,0,2,11,24,37
16802,0,0,4,14,18
16804,0,0,10,30,40
16805,0,0,4,14,18
16806,1,1,6,25,33
16807,0,0,5,7,12
16808,0,0,12,17,29
16809,0,0,10,39,49
16810,0,0,13,32,45
16811,0,0,6,3,9
16812,0,1,6,10,17
16813,0,0,13,19,32
16814,0,0,10,6,16
16815,0,3,3,5,11
16816,0,2,5,8,15
16817,1,0,11,22,34
16818,0,0,8,42,50
16819,0,0,7,5,12
16820,1,0,2,13,16
16821,0,0,1,8,9
16822,0,0,6,2,8
16823,0,1,12,22,35
16824,0,0,6,14,20
16825,0,0,5,8,13
16826,0,0,9,26,35
16827,0,1,4,15,20
16828,2,1,6,16,25
16829,0,0,4,17,21
16830,0,0,3,4,7
16831,0,0,7,9,16
16832,0,1,10,8,19
16833,0,1,2,7,10
16834,0,0,11,25,36
16835,0,0,0,4,4
16836,0,0,7,4,11
16837,0,0,7,12,19
16838,0,1,9,15,25
16839,0,0,10,7,17
16840,0,0,10,13,23
16841,0,3,8,23,34
16842,1,0,9,10,20
16843,0,0,8,27,35
16844,0,1,12,20,33
16845,0,0,7,26,33
16846,0,0,13,31,44
16847,0,0,4,17,21
16848,0,0,0,3,3
16849,1,0,9,12,22
16850,0,0,9,12,21
16851,1,0,14,18,33
16852,1,0,5,24,30
16853,0,0,6,3,9
16854,0,1,6,20,27
16855,0,0,6,5,11
16856,0,0,17,27,44
16857,0,2,12,32,46
16858,0,1,2,7,10
16859,0,0,11,37,48
16860,1,0,11,22,34
16861,0,0,8,42,50
16862,0,0,0,4,4
16863,0,0,3,8,11
16864,1,0,11,22,34
16866,0,1,12,22,35
16867,0,1,4,15,20
16868,0,0,15,13,28
16869,0,0,11,37,48
16870,0,0,0,4,4
16871,0,0,7,4,11
16872,0,0,7,2,9
16873,0,0,7,16,23
16874,0,0,6,7,13
16875,0,1,5,2,8
16876,0,0,0,4,4
16877,0,0,8,11,19
16878,0,0,7,5,12
16879,0,0,8,21,29
16880,0,0,0,9,9
16881,0,0,0,4,4
16882,0,0,6,19,25
16883,0,0,7,11,18
16884,0,0,4,16,20
16885,0,1,3,7,11
16886,3,1,2,26,32
16887,0,0,11,21,32
16888,0,0,2,20,22
16889,0,0,18,28,46
16890,1,0,0,9,10
16891,0,0,8,10,18
16892,0,0,6,8,14
16893,0,0,1,7,8
16894,0,1,18,24,43
16895,1,2,5,15,23
16896,0,0,2,19,21
16897,0,0,5,1,6
16898,0,0,2,6,8
16899,0,0,6,26,32
16900,0,0,15,15,30
16901,0,0,8,18,26
16902,0,0,10,9,19
16903,0,0,17,33,50
16904,0,0,0,4,4
16905,1,0,17,27,45
16906,0,0,17,18,35
16907,0,0,5,10,15
16908,0,1,9,12,22
16909,0,1,8,18,27
16910,0,0,7,26,33
16911,0,0,6,11,17
16912,0,0,11,17,28
16913,0,0,7,7,14
16914,0,0,18,32,50
16915,0,0,3,21,24
16916,0,0,10,37,47
16917,0,1,13,25,39
16918,0,1,12,32,45
16919,0,0,2,4,6
16920,0,1,4,19,24
16921,0,0,0,39,39
16922,0,0,10,18,28
16923,0,0,10,6,16
16924,0,0,2,14,16
16925,0,1,7,19,27
16926,0,1,11,19,31
16927,0,0,11,9,20
16928,0,1,3,6,10
16929,0,0,6,8,14
16930,0,0,6,12,18
16931,0,1,6,12,19
16932,0,0,6,7,13
16933,0,0,13,17,30
16934,0,0,9,20,29
16935,0,0,11,23,34
16936,0,0,7,11,18
16937,0,1,16,26,43
16938,0,0,2,4,6
16939,0,0,7,1,8
16940,0,2,12,30,44
16941,0,0,4,6,10
16943,0,1,10,11,22
16944,0,0,2,3,5
16945,0,0,3,4,7
16946,0,0,6,3,9
16947,0,1,12,22,35
16948,0,1,11,22,34
16949,0,1,11,14,26
16950,0,1,5,22,28
16951,1,2,12,35,50
16952,0,2,8,16,26
16953,0,0,14,21,35
16954,0,0,10,10,20
16955,0,0,5,8,13
16956,0,1,10,8,19
16957,0,1,5,8,14
16958,0,1,7,35,43
16959,0,0,2,0,2
16960,0,0,10,16,26
16961,0,0,4,6,10
16962,0,1,10,25,36
16963,0,0,4,2,6
16965,0,0,3,7,10
16966,0,1,14,17,32
16967,0,1,17,10,28
16968,0,0,4,6,10
16969,0,0,5,4,9
16970,0,0,3,4,7
16971,0,0,8,4,12
16972,0,0,12,12,24
16973,0,1,7,2,10
16974,0,0,6,7,13
16975,0,0,8,9,17
16976,1,0,11,24,36
16977,0,0,9,13,22
16978,0,0,7,27,34
16979,0,0,3,0,3
16980,0,0,8,15,23
16982,0,0,8,27,35
16983,0,0,6,9,15
16984,0,0,8,4,12
16985,0,0,4,6,10
16986,0,0,6,11,17
16987,0,0,13,26,39
16988,0,0,3,4,7
16989,0,0,7,8,15
16990,0,0,13,17,30
16991,0,0,6,11,17
16992,0,1,8,14,23
16993,0,0,15,20,35
16994,0,0,5,9,14
16995,0,0,4,8,12
16996,0,0,10,17,27
16997,0,0,5,1,6
16998,0,0,3,0,3
16999,0,0,4,8,12
17001,0,0,7,7,14
17002,0,0,9,4,13
17003,0,0,17,19,36
17004,0,0,1,2,3
17005,0,0,5,6,11
17006,1,0,5,44,50
17007,0,0,4,6,10
17008,0,1,7,14,22
17009,0,0,6,4,10
17010,0,0,2,1,3
17012,0,1,8,20,29
17013,0,0,10,18,28
17014,1,2,7,18,28
17015,0,1,6,10,17
17016,0,1,12,26,39
17017,0,0,1,5,6
17018,0,0,9,7,16
17019,0,0,8,17,25
17020,0,0,6,5,11
17021,1,0,11,9,21
17022,0,0,5,7,12
17023,0,0,12,23,35
17024,0,0,9,12,21
17025,0,0,8,2,10
17026,0,0,10,25,35
17027,4,1,13,30,48
17028,0,0,2,18,20
17029,0,0,6,4,10
17031,0,0,5,13,18
17032,0,0,8,15,23
17033,0,0,3,4,7
17034,0,0,8,11,19
17035,0,0,4,2,6
17036,0,0,8,21,29
17037,0,0,12,18,30
17038,0,0,8,37,45
17039,0,0,3,3,6
17040,0,0,14,16,30
17041,0,0,6,11,17
17042,0,1,4,29,34
17043,0,0,0,4,4
17044,0,0,16,34,50
17045,0,0,4,7,11
17046,0,0,7,18,25
17047,0,0,13,37,50
17048,1,0,11,35,47
17049,0,0,7,11,18
17050,0,0,8,11,19
17051,0,0,7,6,13
17052,0,0,0,6,6
17053,0,0,14,33,47
17054,0,0,8,5,13
17055,0,0,0,6,6
17056,0,0,9,19,28
17057,0,1,2,21,24
17058,0,0,4,15,19
17059,0,0,6,26,32
17060,0,0,5,19,24
17061,0,0,7,14,21
17062,0,0,5,12,17
17063,0,0,9,11,20
17064,0,0,3,2,5
17065,0,0,2,23,25
17066,0,2,9,33,44
17067,0,0,7,20,27
17068,0,0,17,26,43
17069,0,0,8,9,17
17070,0,0,17,31,48
17071,0,0,8,41,49
17072,1,0,0,11,12
17073,1,0,19,18,38
17074,1,0,11,30,42
17075,0,0,14,34,48
17076,0,1,13,36,50
17077,0,0,9,24,33
17078,0,0,10,13,23
17079,0,2,9,27,38
17080,0,1,7,25,33
17081,0,0,7,12,19
17082,0,0,5,11,16
17083,0,0,1,5,6
17084,0,1,8,14,23
17085,0,0,6,11,17
17086,0,0,15,35,50
17087,0,0,10,24,34
17088,0,1,9,23,33
17089,0,0,8,7,15
17090,0,0,7,10,17
17091,0,3,8,34,45
17092,0,0,2,6,8
17093,0,0,14,32,46
17094,0,0,4,11,15
17095,0,1,11,18,30
17096,0,0,4,14,18
17097,0,0,7,32,39
17098,0,0,8,12,20
17099,0,0,5,23,28
17100,0,1,7,6,14
17101,0,0,3,8,11
17102,0,0,7,16,23
17103,0,0,3,19,22
17104,0,3,10,19,32
17106,0,0,5,9,14
17107,0,1,5,2,8
17108,0,0,8,15,23
17109,0,0,4,46,50
17110,3,1,7,39,50
17111,0,0,2,4,6
17112,0,0,8,11,19
17113,0,0,12,18,30
17114,0,0,8,2,10
17115,0,0,14,16,30
17116,0,1,4,29,34
17117,0,0,0,4,4
17118,0,1,8,14,23
17119,0,0,2,1,3
17120,0,1,15,33,49
17121,0,1,2,7,10
17122,0,1,4,16,21
17123,0,0,0,1,1
17124,0,0,8,11,19
17125,0,0,4,46,50
17126,0,1,0,30,31
17127,0,0,5,19,24
17128,0,0,11,39,50
17129,0,0,14,16,30
17130,1,1,15,33,50
17131,0,1,11,18,30
17132,1,0,11,30,42
17133,3,1,2,26,32
17134,0,0,1,7,8
17135,0,0,4,46,50
17136,3,1,7,39,50
17137,0,0,1,5,6
17138,0,1,12,22,35
17139,3,1,7,39,50
17140,0,0,2,19,21
17141,0,3,10,19,32
17142,0,0,0,4,4
17143,3,1,7,39,50
17144,0,0,1,4,5
17145,0,0,9,6,15
17146,0,0,7,19,26
17147,0,0,5,33,38
17148,0,0,1,6,7
17149,0,0,12,33,45
17150,1,2,7,29,39
17151,0,0,14,17,31
17152,0,0,11,21,32
17153,1,0,8,4,13
17154,0,0,4,16,20
17155,1,0,7,3,11
17156,0,0,8,23,31
17157,0,0,14,14,28
17158,2,0,9,18,29
17159,0,0,9,20,29
17160,0,0,6,21,27
17161,0,0,9,8,17
17162,0,0,11,11,22
17163,0,2,3,12,17
17164,0,0,7,12,19
17165,0,0,4,4,8
17166,0,0,5,2,7
17167,0,0,7,22,29
17168,1,0,6,28,35
17169,0,0,0,11,11
17170,0,1,11,14,26
17171,0,0,7,17,24
17172,0,0,5,10,15
17173,1,0,0,18,19
17174,0,2,2,33,37
17175,0,0,1,6,7
17176,0,0,6,6,12
17177,3,0,4,39,46
17178,0,0,16,16,32
17179,0,0,1,2,3
17180,0,1,3,8,12
17181,0,1,7,9,17
17182,1,0,11,15,27
17183,0,0,14,30,44
17184,0,0,2,4,6
17185,0,0,7,9,16
17187,0,0,2,19,21
17188,0,0,2,11,13
17189,0,0,4,3,7
17190,1,2,12,35,50
17191,0,0,0,24,24
17192,0,0,1,4,5
17193,0,0,11,24,35
17194,0,0,14,26,40
17195,0,3,4,25,32
17196,0,0,10,10,20
17197,0,1,14,33,48
17198,0,0,16,34,50
17199,0,0,1,6,7
17200,0,0,6,4,10
17201,0,0,0,3,3
17202,0,0,9,20,29
17203,0,0,1,4,5
17204,1,0,10,8,19
17205,0,0,17,33,50
17206,0,1,9,9,19
17207,0,0,7,6,13
17208,0,0,2,7,9
17209,1,0,5,7,13
17212,0,1,2,17,20
17213,0,0,8,23,31
17214,0,0,5,28,33
17215,0,0,16,34,50
17216,0,0,10,37,47
17217,0,1,16,27,44
17218,0,0,2,9,11
17219,0,2,2,33,37
17220,0,1,6,10,17
17221,0,0,10,8,18
17223,1,0,0,18,19
17225,0,0,5,33,38
17226,0,0,2,19,21
17227,0,0,5,33,38
17229,2,1,6,16,25
17230,0,0,8,11,19
17231,0,2,19,29,50
17232,0,1,1,13,15
17233,0,0,7,12,19
17234,0,0,0,1,1
17235,0,0,9,11,20
17236,0,0,4,24,28
17237,1,1,5,5,12
17238,1,0,13,36,50
17239,0,0,3,17,20
17240,0,0,4,17,21
17241,0,0,16,34,50
17242,0,0,13,31,44
17243,0,0,11,27,38
17245,0,0,6,14,20
17246,0,0,10,23,33
17247,1,0,4,7,12
17248,0,0,5,7,12
17250,0,0,10,24,34
17251,0,0,15,25,40
17252,0,0,14,26,40
17253,1,0,1,4,6
17254,0,2,11,37,50
17255,0,1,9,9,19
17256,0,0,1,10,11
17257,0,0,5,16,21
17258,0,0,8,21,29
17259,0,1,9,29,39
17260,0,0,7,7,14
17261,0,0,10,11,21
17262,0,0,15,8,23
17263,0,1,18,29,48
17264,0,0,12,11,23
17265,0,0,2,6,8
17266,0,0,5,5,10
17267,0,0,12,26,38
17268,0,0,7,6,13
17269,0,1,5,19,25
17270,0,0,7,12,19
17271,0,2,5,9,16
17272,0,0,12,5,17
17273,0,0,8,14,22
17274,0,1,9,15,25
17275,0,0,10,11,21
17276,0,0,4,10,14
17277,0,0,6,4,10
17278,0,0,3,4,7
17279,0,1,13,22,36
17280,0,0,3,12,15
17281,0,0,17,31,48
17282,0,1,2,12,15
17283,0,0,14,24,38
17284,0,0,8,15,23
17285,0,0,9,27,36
17286,0,0,11,8,19
17287,0,0,8,21,29
17288,1,0,9,4,14
17289,0,1,5,23,29
17290,0,0,13,5,18
17291,2,0,5,23,30
17292,2,2,12,31,47
17294,0,0,5,8,13
17295,0,0,4,7,11
17296,0,0,8,4,12
17297,0,0,6,27,33
17298,0,1,11,30,42
17299,0,0,15,29,44
17300,0,0,6,4,10
17301,0,0,6,2,8
17302,0,2,7,13,22
17303,0,0,5,2,7
17304,0,0,8,0,8
17305,0,0,8,27,35
17306,0,0,4,11,15
17307,0,0,13,32,45
17308,2,1,6,16,25
17309,0,0,0,7,7
17310,0,0,4,4,8
17311,0,0,8,11,19
17313,0,0,9,18,27
17315,1,0,11,22,34
17316,0,1,1,8,10
17317,1,0,4,22,27
17318,0,0,7,12,19
17319,0,0,12,18,30
17320,0,1,4,3,8
17321,0,3,4,20,27
17322,0,0,1,21,22
17323,0,0,15,35,50
17324,0,0,11,27,38
17325,0,0,5,22,27
17326,0,0,11,33,44
17327,0,0,2,9,11
17328,1,1,5,5,12
17329,0,0,8,13,21
17330,0,0,19,30,49
17331,0,1,9,28,38
17332,1,0,4,7,12
17333,0,0,13,32,45
17334,2,0,12,34,48
17335,0,0,4,10,14
17336,0,0,13,16,29
17337,0,0,2,22,24
17338,0,1,5,10,16
17339,0,0,7,5,12
17340,0,0,5,17,22
17341,0,0,4,25,29
17342,0,0,2,5,7
17343,0,1,10,15,26
17344,0,1,7,41,49
17345,0,1,6,18,25
17346,0,2,19,29,50
17347,0,0,8,27,35
17348,0,0,11,25,36
17349,0,0,12,18,30
17350,0,0,11,21,32
17351,0,0,3,4,7
17352,0,0,4,15,19
17353,0,0,8,15,23
17354,0,0,5,13,18
17355,0,0,11,6,17
17356,0,0,16,27,43
17357,0,0,9,12,21
17358,0,0,11,19,30
17359,0,0,9,12,21
17360,0,1,10,5,16
17361,0,0,6,8,14
17362,1,0,8,28,37
17363,1,0,12,22,35
17364,0,0,7,21,28
17365,0,0,16,18,34
17366,1,0,11,7,19
17367,0,3,10,10,23
17368,0,0,5,11,16
17369,0,0,14,22,36
17370,0,1,18,29,48
17371,0,0,8,11,19
17372,0,1,1,8,10
17374,0,0,4,17,21
17375,0,1,5,19,25
17376,1,0,11,22,34
17377,0,0,7,3,10
17378,0,0,1,21,22
17379,0,1,0,16,17
17380,0,0,8,11,19
17381,1,1,4,44,50
17382,1,0,4,22,27
17383,0,2,4,42,48
17384,0,0,8,18,26
17385,1,0,11,22,34
17386,0,3,10,10,23
17387,0,1,1,8,10
17388,0,0,5,10,15
17389,0,0,2,12,14
17390,0,4,18,28,50
17391,0,0,6,15,21
17392,0,2,14,33,49
17393,1,0,2,27,30
17394,0,0,5,17,22
17395,0,0,3,15,18
17396,0,2,2,11,15
17397,0,1,0,25,26
17398,2,1,3,42,48
17399,0,3,3,43,49
17400,1,0,11,22,34
17401,0,3,2,13,18
17402,1,4,7,27,39
17403,0,2,2,14,18
17404,0,1,5,9,15
17405,0,0,20,30,50
17406,0,0,3,23,26
17407,0,0,6,12,18
17408,0,2,11,36,49
17409,1,1,7,16,25
17410,3,0,1,17,21
17411,1,2,9,32,44
17412,0,0,6,27,33
17413,0,0,9,16,25
17414,0,0,0,6,6
17415,0,0,0,1,1
17416,0,2,0,9,11
17417,0,0,0,7,7
17418,0,2,0,1,3
17419,0,0,5,2,7
17420,0,0,9,20,29
17421,0,0,4,16,20
17422,1,0,6,11,18
17423,0,1,12,29,42
17424,0,0,1,18,19
17425,0,0,15,30,45
17426,1,2,9,32,44
17427,0,1,12,18,31
17428,1,0,2,27,30
17429,0,0,3,9,12
17430,0,1,10,35,46
17431,0,1,3,10,14
17432,0,4,18,28,50
17433,0,0,3,23,26
17434,0,0,6,27,33
17435,3,0,1,12,16
17436,0,0,6,12,18
17437,1,0,11,22,34
17438,0,0,9,20,29
17439,0,0,5,2,7
17440,0,2,0,1,3
17441,0,1,10,35,46
17442,0,1,3,10,14
17443,0,1,0,25,26
17444,0,0,20,30,50
17445,1,4,7,27,39
17446,1,4,7,33,45
17447,0,0,20,30,50
17448,0,2,14,33,49
17449,1,0,11,22,34
17450,3,0,1,12,16
17451,0,1,10,35,46
17452,0,1,3,10,14
17453,1,4,7,33,45
17454,0,0,6,27,33
17455,0,0,20,30,50
17456,0,2,11,36,49
17457,0,0,9,20,29
17458,0,0,9,16,25
17459,0,0,5,2,7
17460,0,0,6,12,18
17461,0,2,0,1,3
17462,0,0,3,13,16
17463,2,2,8,34,46
17464,0,0,6,7,13
17465,0,0,4,9,13
17466,0,0,4,8,12
17467,0,0,5,16,21
17468,0,0,5,18,23
17469,1,1,10,36,48
17470,0,0,8,20,28
17471,0,0,1,5,6
17472,1,0,2,2,5
17473,0,0,0,12,12
17474,0,2,2,12,16
17476,0,0,7,11,18
17477,4,6,1,13,24
17478,0,0,0,4,4
17479,0,0,14,26,40
17480,0,0,8,13,21
17481,0,1,8,17,26
17482,0,0,3,9,12
17483,0,0,5,10,15
17484,0,2,2,6,10
17485,0,0,17,22,39
17486,0,1,5,17,23
17487,0,0,6,13,19
17488,0,2,6,21,29
17489,0,0,3,13,16
17490,0,0,7,10,17
17491,0,3,3,14,20
17492,0,4,3,19,26
17493,0,0,1,6,7
17494,0,0,4,8,12
17495,0,0,9,7,16
17496,0,0,14,18,32
17497,0,0,0,12,12
17498,0,1,22,27,50
17499,0,0,8,22,30
17501,1,2,3,7,13
17502,0,0,4,8,12
17503,0,1,3,14,18
17504,0,0,5,11,16
17505,1,0,0,7,8
17506,0,0,5,5,10
17507,0,0,3,9,12
17508,0,1,9,16,26
17509,0,0,9,5,14
17510,0,0,5,8,13
17511,0,1,13,20,34
17512,0,0,5,19,24
17513,0,2,1,6,9
17514,0,1,1,13,15
17515,0,1,2,14,17
17516,0,0,5,12,17
17517,0,1,2,6,9
17518,0,0,3,12,15
17519,0,0,6,10,16
17520,0,0,1,10,11
17521,0,0,6,7,13
17522,4,1,1,20,26
17524,0,0,3,4,7
17525,0,0,3,7,10
17526,0,0,2,8,10
17527,0,0,9,8,17
17528,0,2,15,33,50
17529,0,1,9,19,29
17530,0,0,5,10,15
17531,0,0,7,8,15
17532,0,1,2,17,20
17533,0,0,2,12,14
17534,0,0,0,6,6
17535,0,1,4,15,20
17537,0,0,7,16,23
17538,0,0,5,0,5
17539,0,0,5,7,12
17540,0,0,8,15,23
17541,0,0,6,10,16
17542,0,0,9,17,26
17543,0,0,13,35,48
17545,0,0,7,5,12
17546,0,0,5,6,11
17547,0,0,6,7,13
17548,0,2,3,10,15
17549,0,0,8,22,30
17550,0,0,12,17,29
17551,0,0,1,5,6
17552,0,0,4,5,9
17553,0,0,3,16,19
17554,0,1,6,7,14
17556,0,0,1,5,6
17557,2,0,1,8,11
17558,0,0,4,17,21
17559,3,1,8,23,35
17560,4,1,4,41,50
17561,0,0,5,13,18
17562,0,0,5,8,13
17563,0,0,8,15,23
17564,0,0,8,9,17
17565,0,1,11,38,50
17566,0,0,2,14,16
17568,0,0,2,14,16
17569,1,0,1,9,11
17570,0,2,6,10,18
17571,0,1,1,10,12
17572,0,0,5,7,12
17573,0,1,10,18,29
17574,0,0,2,4,6
17575,0,0,3,14,17
17576,0,0,1,5,6
17577,0,1,10,9,20
17578,0,0,4,18,22
17579,0,0,8,20,28
17580,0,3,4,37,44
17581,0,0,4,22,26
17582,0,0,1,6,7
17583,0,0,5,13,18
17584,0,2,2,17,21
17585,0,0,5,4,9
17586,0,0,5,9,14
17587,0,0,7,27,34
17588,0,0,3,7,10
17589,0,0,2,5,7
17590,0,1,8,9,18
17591,0,0,8,16,24
17592,0,0,1,4,5
17593,1,1,3,15,20
17594,0,0,6,18,24
17595,0,0,1,5,6
17596,0,0,6,10,16
17597,0,1,3,11,15
17598,3,1,5,39,48
17599,0,0,11,16,27
17600,0,0,2,3,5
17601,0,0,3,3,6
17602,1,0,6,13,20
17603,0,0,8,18,26
17604,0,1,2,26,29
17605,0,0,3,13,16
17606,0,0,2,6,8
17607,0,0,7,16,23
17608,0,0,1,12,13
17609,0,0,6,3,9
17610,0,0,1,8,9
17611,0,0,1,2,3
17612,1,0,3,22,26
17613,0,0,6,12,18
17614,0,1,7,5,13
17615,0,0,7,12,19
17616,0,0,2,6,8
17617,0,0,5,12,17
17618,0,0,3,7,10
17619,0,0,8,15,23
17620,0,0,2,3,5
17621,0,0,7,4,11
17622,0,1,0,6,7
17623,0,1,9,11,21
17624,0,0,2,6,8
17625,0,0,3,11,14
17626,1,2,5,42,50
17627,0,0,4,19,23
17628,0,0,4,7,11
17629,0,0,1,4,5
17630,0,0,3,8,11
17631,0,0,9,13,22
17632,0,1,2,24,27
17633,0,0,3,21,24
17634,0,1,3,11,15
17635,0,0,3,9,12
17636,0,5,3,10,18
17637,0,1,3,12,16
17638,0,0,0,12,12
17640,0,0,1,13,14
17641,0,0,5,9,14
17642,0,0,5,10,15
17643,6,1,1,16,24
17644,0,0,12,17,29
17645,1,0,7,12,20
17648,0,1,5,24,30
17649,0,0,3,32,35
17650,0,0,3,4,7
17651,0,2,6,5,13
17652,0,2,5,6,13
17653,0,0,2,10,12
17654,0,0,11,10,21
17655,2,0,0,6,8
17656,1,0,0,5,6
17658,0,0,0,5,5
17659,0,0,4,4,8
17660,1,0,2,5,8
17661,1,0,0,4,5
17663,0,0,2,6,8
17664,1,2,3,6,12
17665,0,1,4,15,20
17666,0,1,1,4,6
17668,0,1,0,1,2
17669,0,0,0,5,5
17670,0,0,7,14,21
17671,0,0,0,6,6
17672,0,0,2,7,9
17673,0,0,4,3,7
17674,0,3,4,8,15
17676,1,4,9,23,37
17677,1,1,4,13,19
17678,0,0,1,10,11
17679,0,0,11,21,32
17680,0,2,14,33,49
17681,0,0,3,11,14
17682,0,2,9,14,25
17684,1,1,10,36,48
17686,0,3,5,11,19
17687,0,0,8,23,31
17688,0,1,6,11,18
17689,0,0,1,12,13
17690,0,0,3,10,13
17691,0,0,3,11,14
17692,0,0,3,7,10
17693,1,0,1,20,22
17694,0,3,8,6,17
17695,0,0,6,22,28
17696,0,0,4,30,34
17697,0,1,5,9,15
17698,0,0,4,9,13
17699,0,0,3,17,20
17700,0,4,5,11,20
17701,2,1,8,39,50
17702,0,0,1,4,5
17703,0,0,5,1,6
17704,1,0,2,2,5
17705,0,0,0,7,7
17706,2,0,3,10,15
17708,0,1,10,35,46
17709,0,0,2,5,7
17710,2,2,8,34,46
17712,0,1,10,19,30
17713,0,1,10,29,40
17714,0,0,6,20,26
17715,0,0,0,7,7
17716,0,0,5,5,10
17717,2,0,2,40,44
17718,0,0,6,19,25
17719,1,5,13,25,44
17720,0,2,2,12,16
17721,0,3,0,17,20
17722,0,0,6,12,18
17724,0,2,2,7,11
17725,0,0,5,2,7
17727,0,0,8,9,17
17728,0,2,0,3,5
17729,0,2,0,23,25
17730,0,2,2,18,22
17731,0,3,0,12,15
17732,1,1,1,5,8
17733,0,0,3,3,6
17735,0,1,11,17,29
17736,0,0,11,31,42
17737,0,0,8,19,27
17738,0,0,13,36,49
17739,0,0,6,1,7
17740,0,0,11,21,32
17741,0,0,15,30,45
17742,0,0,9,29,38
17743,0,0,3,11,14
17744,0,0,1,10,11
17745,0,0,12,15,27
17746,0,0,11,15,26
17747,0,0,7,10,17
17748,0,0,23,27,50
17749,0,0,10,8,18
17750,0,0,3,3,6
17751,0,0,5,11,16
17752,3,2,3,14,22
17753,0,0,10,24,34
17754,0,0,2,15,17
17755,0,0,5,7,12
17756,0,0,0,7,7
17757,0,0,12,8,20
17758,0,0,3,17,20
17759,0,0,9,22,31
17760,0,0,5,16,21
17761,0,0,5,1,6
17762,0,0,2,5,7
17763,0,4,5,11,20
17764,0,0,3,7,10
17765,0,0,8,12,20
17766,0,1,4,22,27
17767,0,0,1,6,7
17768,2,1,10,17,30
17769,0,0,7,28,35
17770,0,1,0,36,37
17771,0,0,8,20,28
17772,0,2,6,10,18
17773,0,0,7,12,19
17774,0,1,0,10,11
17775,1,1,9,30,41
17776,0,1,1,10,12
17777,0,3,3,17,23
17778,0,1,4,23,28
17779,0,0,0,7,7
17780,0,0,9,16,25
17781,0,0,2,8,10
17782,0,1,10,35,46
17783,0,0,1,7,8
17784,0,0,9,20,29
17785,0,0,0,9,9
17787,3,4,4,29,40
17788,0,3,12,32,47
17789,1,4,9,23,37
17790,0,0,7,26,33
17791,0,0,3,5,8
17792,1,2,4,20,27
17793,1,1,7,25,34
17794,0,0,5,6,11
17795,0,2,3,12,17
17796,0,0,1,30,31
17797,0,2,6,21,29
17798,1,0,1,20,22
17799,0,0,7,11,18
17800,2,0,7,16,25
17801,0,0,3,13,16
17803,0,0,3,10,13
17804,1,1,4,13,19
17805,0,0,20,30,50
17806,1,0,21,28,50
17807,0,0,1,4,5
17808,0,0,4,30,34
17809,0,0,4,18,22
17810,0,1,21,21,43
17811,0,0,1,9,10
17812,0,0,6,7,13
17813,0,0,8,9,17
17814,1,0,2,2,5
17815,4,0,0,21,25
17816,0,2,1,10,13
17817,0,1,10,35,46
17818,0,0,7,16,23
17819,0,0,2,7,9
17820,0,1,10,19,30
17821,0,0,6,20,26
17822,0,3,0,17,20
17823,2,0,3,10,15
17825,1,1,10,38,50
17826,0,0,5,5,10
17827,2,0,2,40,44
17828,1,5,13,25,44
17829,1,2,5,42,50
17830,0,0,6,35,41
17831,0,0,6,12,18
17832,0,0,5,2,7
17833,0,2,2,7,11
17835,0,0,0,12,12
17836,6,1,4,39,50
17837,0,2,2,18,22
17838,1,1,1,5,8
17839,0,3,0,12,15
17840,0,0,1,4,5
17841,0,1,1,4,6
17842,0,2,0,23,25
17843,2,0,0,18,20
17844,0,2,10,33,45
17845,1,0,10,30,41
17846,0,0,3,15,18
17847,0,2,13,30,45
17848,0,0,8,11,19
17851,1,0,10,26,37
17852,2,0,1,8,11
17853,0,3,3,17,23
17854,6,1,4,39,50
17855,6,1,1,16,24
17856,0,1,10,35,46
17857,0,3,4,8,15
17858,0,2,1,10,13
17859,0,0,6,19,25
17860,2,0,7,16,25
17861,2,7,3,18,30
17862,2,0,2,40,44
17863,1,0,4,15,20
17864,0,1,2,17,20
17865,1,4,7,33,45
17866,0,0,1,5,6
17867,0,0,8,23,31
17868,0,0,1,30,31
17869,0,0,11,31,42
17870,1,5,13,25,44
17871,0,1,4,15,20
17872,0,0,14,18,32
17873,0,0,5,6,11
17874,2,1,6,39,48
17875,0,3,8,6,17
17876,0,2,14,33,49
17877,0,0,0,7,7
17878,1,1,1,5,8
17879,0,0,20,30,50
17880,0,2,15,33,50
17881,0,0,8,20,28
17882,0,0,7,12,19
17883,0,0,0,7,7
17884,0,0,18,30,48
17887,0,3,3,14,20
17888,0,2,2,13,17
17889,0,5,0,13,18
17890,5,2,3,30,40
17891,0,2,3,12,17
17892,0,0,2,15,17
17893,0,0,1,30,31
17894,0,3,5,11,19
17895,0,0,13,36,49
17896,0,2,10,19,31
17897,0,0,3,3,6
17898,0,0,2,5,7
17899,0,1,0,22,23
17900,2,1,6,39,48
17901,0,1,10,29,40
17902,1,2,4,15,22
17903,0,0,0,7,7
17904,0,0,3,4,7
17905,1,4,7,33,45
17906,0,0,6,35,41
17907,2,0,1,15,18
17908,1,2,4,20,27
17909,0,0,8,23,31
17910,0,2,9,14,25
17911,2,0,7,16,25
17912,0,0,7,11,18
17913,0,1,2,17,20
17914,1,4,9,23,37
17915,0,0,3,7,10
17916,0,0,6,22,28
17917,0,0,14,18,32
17918,1,0,4,15,20
17919,0,0,2,7,9
17920,2,0,3,10,15
17921,0,0,5,13,18
17922,0,0,9,20,29
17923,0,1,10,19,30
17924,0,1,21,21,43
17925,0,0,5,7,12
17926,0,1,0,6,7
17927,0,1,5,9,15
17928,0,0,3,4,7
17929,0,1,1,11,13
17930,1,0,16,33,50
17931,0,4,7,38,49
17932,0,0,13,12,25
17933,0,1,0,9,10
17934,0,0,6,8,14
17935,0,3,12,29,44
17936,2,0,2,10,14
17937,0,0,1,4,5
17938,6,1,4,39,50
17939,0,0,8,9,17
17941,0,0,6,16,22
17942,0,0,3,13,16
17943,0,0,2,3,5
17944,0,0,3,5,8
17945,0,0,3,5,8
17946,0,0,2,10,12
17947,0,0,4,1,5
17948,1,1,10,36,48
17949,0,0,4,8,12
17950,0,0,0,2,2
17951,0,0,7,11,18
17952,2,0,0,15,17
17953,0,0,6,4,10
17954,0,0,8,18,26
17955,0,0,0,3,3
17956,0,0,8,20,28
17957,0,0,2,20,22
17958,0,0,6,19,25
17959,0,0,0,3,3
17960,0,0,9,17,26
17961,0,0,6,4,10
17962,0,0,0,8,8
17964,0,0,0,12,12
17965,0,0,7,11,18
17966,0,2,2,12,16
17967,0,0,4,15,19
17968,0,2,9,38,49
17969,0,1,3,11,15
17970,0,0,6,7,13
17971,0,2,11,35,48
17972,0,0,4,3,7
17973,0,0,3,4,7
17974,0,0,3,8,11
17975,1,2,4,11,18
17976,0,1,5,5,11
17978,1,0,3,12,16
17979,0,1,10,35,46
17980,1,0,9,25,35
17981,0,0,5,14,19
17982,0,0,2,9,11
17983,0,0,5,7,12
17984,0,0,16,33,49
17985,0,0,11,21,32
17986,1,4,9,23,37
17987,0,0,3,9,12
17989,0,0,4,21,25
17990,0,0,6,15,21
17991,0,0,5,18,23
17992,0,0,8,19,27
17993,1,1,6,24,32
17994,0,0,4,12,16
17995,0,0,1,9,10
17996,0,2,14,33,49
17997,0,0,3,11,14
17998,1,0,13,31,45
17999,0,1,15,17,33
18000,0,0,1,5,6
18001,0,5,4,15,24
18002,0,0,6,20,26
18003,0,0,4,4,8
18004,0,0,3,5,8
18005,0,0,0,7,7
18006,0,0,6,18,24
18007,0,1,4,17,22
18008,0,1,9,21,31
18009,0,0,2,11,13
18010,0,0,11,29,40
18011,0,0,6,6,12
18012,0,0,13,26,39
18013,0,0,4,5,9
18014,0,0,8,22,30
18015,0,0,7,11,18
18016,0,0,6,7,13
18017,0,0,12,15,27
18018,0,0,4,8,12
18019,0,0,6,11,17
18020,0,0,9,7,16
18021,0,0,11,15,26
18022,1,4,14,31,50
18023,0,0,12,25,37
18024,1,1,5,23,30
18025,0,1,3,1,5
18026,0,1,11,22,34
18027,0,2,8,24,34
18028,0,0,1,10,11
18029,0,0,8,9,17
18031,0,0,9,21,30
18032,0,0,7,22,29
18033,1,1,4,13,19
18034,0,0,5,3,8
18035,0,1,0,11,12
18036,0,0,6,16,22
18037,0,0,7,10,17
18038,0,0,6,13,19
18039,0,0,6,19,25
18040,0,0,3,24,27
18041,0,5,0,11,16
18042,0,0,3,13,16
18043,0,0,16,14,30
18044,0,2,14,22,38
18045,0,1,5,17,23
18046,0,0,6,31,37
18047,0,1,7,22,30
18048,0,0,1,7,8
18049,0,0,4,10,14
18050,0,2,4,11,17
18051,0,4,18,28,50
18052,0,1,2,15,18
18053,0,0,7,8,15
18054,0,0,5,6,11
18055,0,2,21,26,49
18056,0,0,8,18,26
18057,0,0,15,35,50
18058,0,0,5,19,24
18059,0,0,2,7,9
18060,3,1,12,32,48
18061,0,0,3,7,10
18062,0,0,9,16,25
18063,0,0,0,12,12
18064,0,0,14,11,25
18065,0,1,1,13,15
18066,0,0,4,9,13
18067,0,1,6,8,15
18069,0,0,8,23,31
18070,0,1,0,3,4
18071,0,0,7,21,28
18072,0,0,5,9,14
18073,0,0,6,17,23
18074,0,0,3,2,5
18075,0,0,3,9,12
18078,0,1,5,12,18
18079,0,0,5,11,16
18080,0,0,9,11,20
18081,0,0,5,10,15
18082,0,0,14,27,41
18083,0,0,6,13,19
18084,0,0,10,18,28
18085,0,0,0,3,3
18086,0,0,12,16,28
18087,0,0,2,14,16
18088,0,0,7,12,19
18089,0,0,5,5,10
18090,0,1,12,23,36
18091,0,0,10,14,24
18092,1,0,5,42,48
18093,0,0,0,6,6
18094,0,0,4,8,12
18095,0,0,6,25,31
18096,0,3,8,6,17
18097,0,1,2,5,8
18098,0,0,16,11,27
18099,1,0,5,12,18
18100,0,2,2,10,14
18101,0,0,5,11,16
18102,0,0,0,8,8
18103,0,1,6,8,15
18104,0,0,6,4,10
18105,0,0,0,7,7
18106,0,0,5,12,17
18107,0,6,0,10,16
18108,0,0,2,12,14
18109,0,1,4,13,18
18110,0,0,6,4,10
18111,0,7,5,38,50
18112,0,0,4,8,12
18113,0,1,1,16,18
18114,0,0,7,14,21
18115,0,0,3,17,20
18116,0,0,0,5,5
18117,0,1,4,15,20
18118,0,1,3,11,15
18119,0,0,6,8,14
18120,0,1,4,8,13
18121,0,4,5,11,20
18122,0,0,8,17,25
18123,1,0,6,17,24
18124,1,2,6,11,20
18125,0,0,1,4,5
18126,0,0,6,15,21
18127,0,0,3,13,16
18128,0,0,4,12,16
18129,0,1,9,12,22
18130,0,2,2,11,15
18131,0,1,11,27,39
18132,0,0,7,7,14
18133,0,0,8,14,22
18134,0,0,1,6,7
18135,1,0,8,18,27
18136,0,0,1,6,7
18137,0,0,3,3,6
18138,0,1,8,16,25
18139,0,0,6,15,21
18140,0,0,1,4,5
18141,0,0,8,21,29
18142,0,0,1,8,9
18143,0,0,4,13,17
18144,0,0,2,7,9
18145,0,0,2,5,7
18146,0,0,5,6,11
18147,2,0,2,13,17
18148,0,0,1,10,11
18149,0,0,4,26,30
18150,0,0,5,25,30
18151,0,0,8,17,25
18152,0,0,5,10,15
18153,0,0,2,9,11
18154,1,0,9,29,39
18155,0,0,4,16,20
18156,0,0,7,11,18
18157,0,0,6,10,16
18158,0,1,1,8,10
18159,0,0,6,14,20
18160,0,0,8,11,19
18161,0,3,19,22,44
18162,1,1,8,20,30
18163,0,0,11,18,29
18164,0,2,11,21,34
18165,0,0,4,5,9
18166,0,0,6,9,15
18167,0,0,5,1,6
18168,0,0,2,14,16
18169,0,0,2,3,5
18171,3,0,8,36,47
18172,0,0,5,14,19
18173,0,0,0,7,7
18174,0,0,4,10,14
18175,0,0,15,25,40
18176,0,0,4,9,13
18177,0,0,3,2,5
18178,0,1,1,5,7
18179,1,0,5,18,24
18180,0,1,4,24,29
18181,0,0,4,6,10
18182,4,0,2,44,50
18183,0,0,4,10,14
18184,0,1,12,31,44
18185,0,0,12,23,35
18186,0,0,4,14,18
18187,0,0,2,2,4
18188,0,1,5,10,16
18189,0,0,13,24,37
18190,0,0,4,5,9
18191,0,2,8,26,36
18192,0,0,0,7,7
18193,0,1,1,10,12
18194,0,0,4,8,12
18195,0,0,4,7,11
18197,0,0,1,12,13
18198,0,3,5,11,19
18199,0,1,4,8,13
18200,0,1,6,21,28
18201,0,1,5,9,15
18202,0,0,5,7,12
18203,0,0,6,6,12
18204,0,0,5,2,7
18206,0,0,0,13,13
18207,0,0,7,12,19
18208,0,0,8,18,26
18209,0,1,6,13,20
18210,0,0,8,14,22
18211,1,0,2,5,8
18212,0,1,8,19,28
18213,0,1,4,10,15
18214,0,0,3,7,10
18215,0,2,7,34,43
18216,1,0,10,32,43
18217,0,0,8,11,19
18218,0,0,11,18,29
18219,1,0,9,11,21
18220,0,0,8,12,20
18221,1,1,4,7,13
18222,0,0,11,19,30
18223,0,2,10,13,25
18224,0,0,3,5,8
18225,0,0,11,17,28
18226,0,1,5,20,26
18227,0,0,2,4,6
18228,0,0,0,5,5
18229,0,0,9,19,28
18230,0,0,5,6,11
18231,0,1,0,4,5
18232,0,0,1,6,7
18233,0,0,2,6,8
18234,0,0,0,8,8
18235,0,1,7,21,29
18236,0,0,1,4,5
18237,0,0,7,16,23
18238,0,0,1,9,10
18239,0,0,7,15,22
18240,0,0,11,21,32
18241,0,0,16,23,39
18242,0,0,3,15,18
18243,0,0,7,7,14
18244,0,0,5,5,10
18245,0,0,2,6,8
18246,0,0,6,7,13
18247,0,0,2,9,11
18248,0,0,0,8,8
18249,0,0,8,7,15
18250,0,2,1,4,7
18251,0,2,7,11,20
18252,0,0,9,7,16
18253,0,0,11,17,28
18254,0,0,5,8,13
18255,0,0,7,10,17
18256,0,2,3,7,12
18257,0,0,6,25,31
18258,0,0,4,8,12
18259,0,0,8,19,27
18260,0,1,4,12,17
18261,0,0,0,1,1
18262,0,1,9,10,20
18263,0,0,7,20,27
18264,1,0,11,6,18
18265,0,0,0,5,5
18266,0,0,1,3,4
18267,0,2,3,3,8
18268,0,0,12,19,31
18269,0,0,8,24,32
18270,0,0,1,2,3
18271,0,0,2,18,20
18272,0,0,0,8,8
18273,0,0,7,9,16
18274,0,0,5,12,17
18275,0,0,8,18,26
18276,1,2,1,26,30
18277,0,0,6,4,10
18278,0,0,7,9,16
18279,0,1,5,10,16
18280,0,2,10,12,24
18281,0,0,8,22,30
18282,0,0,4,12,16
18283,1,0,1,11,13
18284,0,2,16,19,37
18285,0,0,2,5,7
18286,0,0,0,5,5
18287,0,0,3,7,10
18288,0,0,2,3,5
18289,0,0,7,9,16
18290,0,0,6,3,9
18291,1,0,2,39,42
18292,0,0,4,11,15
18294,0,1,4,0,5
18295,0,0,3,21,24
18296,0,0,12,17,29
18297,0,1,6,20,27
18298,0,0,2,9,11
18299,0,0,3,15,18
18300,0,0,5,10,15
18301,0,0,4,15,19
18302,0,2,10,21,33
18303,0,0,11,28,39
18304,0,0,3,6,9
18305,0,0,1,5,6
18306,0,2,5,17,24
18307,0,0,9,5,14
18308,0,2,9,15,26
18309,0,1,10,28,39
18310,0,0,2,8,10
18311,0,0,12,15,27
18312,0,0,8,5,13
18313,0,0,3,3,6
18314,0,2,6,14,22
18315,0,0,5,8,13
18316,0,2,4,9,15
18317,0,9,10,24,43
18318,0,0,3,19,22
18319,2,4,0,7,13
18320,1,0,2,6,9
18321,0,0,6,14,20
18322,0,0,5,11,16
18323,0,1,3,11,15
18324,0,15,6,24,45
18325,0,0,5,10,15
18326,2,0,6,24,32
18327,0,0,11,19,30
18328,0,1,4,2,7
18329,0,1,10,24,35
18330,0,0,2,8,10
18331,0,1,5,1,7
18332,0,0,4,7,11
18333,0,0,9,16,25
18334,0,0,2,5,7
18335,0,0,14,23,37
18337,1,1,17,31,50
18338,0,1,8,18,27
18339,0,0,5,2,7
18340,0,0,0,6,6
18341,0,0,6,15,21
18342,0,2,2,7,11
18343,0,0,1,7,8
18344,0,1,5,24,30
18345,0,0,2,3,5
18346,0,0,3,2,5
18347,2,0,3,15,20
18348,0,0,5,9,14
18349,0,0,12,6,18
18350,0,0,4,9,13
18351,1,1,6,41,49
18352,0,0,4,11,15
18353,0,1,8,13,22
18354,10,0,7,30,47
18355,0,0,8,6,14
18356,0,1,4,23,28
18357,0,0,8,15,23
18358,0,1,1,32,34
18359,0,0,1,6,7
18360,0,0,4,12,16
18361,0,0,3,8,11
18362,0,0,4,17,21
18363,0,1,7,12,20
18364,0,0,2,5,7
18365,0,0,7,8,15
18366,0,0,4,16,20
18367,0,1,2,9,12
18368,0,1,0,9,10
18369,0,0,6,6,12
18370,0,0,3,11,14
18371,0,0,2,14,16
18372,0,0,12,18,30
18373,0,0,4,12,16
18374,1,0,7,31,39
18375,2,0,3,10,15
18376,0,0,3,7,10
18377,0,1,13,14,28
18379,0,1,12,13,26
18380,0,0,6,7,13
18381,0,0,2,3,5
18382,0,0,3,8,11
18383,1,0,19,30,50
18384,0,0,0,7,7
18385,0,0,12,15,27
18386,0,2,2,7,11
18387,0,0,2,7,9
18389,0,1,2,5,8
18390,0,0,1,4,5
18392,1,5,13,25,44
18393,0,0,12,17,29
18394,0,2,2,22,26
18395,0,2,3,10,15
18396,0,1,3,13,17
18397,0,0,5,2,7
18398,0,0,9,9,18
18399,0,5,1,28,34
18400,0,0,6,19,25
18401,0,0,4,9,13
18402,0,0,0,5,5
18403,0,0,0,2,2
18404,0,1,1,10,12
18405,0,0,2,3,5
18406,0,2,8,15,25
18407,0,0,2,3,5
18408,0,0,6,11,17
18409,0,0,2,4,6
18410,0,0,1,6,7
18411,0,2,11,35,48
18412,0,0,4,15,19
18413,0,0,11,18,29
18414,0,2,2,12,16
18415,1,0,7,19,27
18416,0,0,1,4,5
18418,0,0,4,5,9
18419,0,0,1,12,13
18420,0,0,4,5,9
18421,0,0,6,14,20
18422,0,0,0,11,11
18423,0,0,2,4,6
18424,0,0,4,22,26
18425,0,0,8,8,16
18426,0,0,6,9,15
18427,0,0,6,17,23
18428,0,0,2,2,4
18429,0,0,0,12,12
18430,0,0,9,24,33
18431,0,2,5,6,13
18432,2,0,0,20,22
18433,0,1,5,6,12
18434,0,3,0,7,10
18435,0,0,2,8,10
18436,0,0,0,6,6
18437,0,0,2,0,2
18439,0,0,1,2,3
18440,0,0,6,4,10
18441,0,0,0,7,7
18442,0,0,1,5,6
18443,0,0,0,11,11
18445,0,0,8,10,18
18449,0,0,5,14,19
18450,1,0,5,10,16
18451,0,0,4,3,7
18452,0,0,1,6,7
18453,0,0,2,5,7
18454,0,3,13,33,49
18456,0,0,0,1,1
18457,0,0,3,13,16
18459,0,0,4,8,12
18460,0,0,4,7,11
18461,0,0,5,8,13
18462,1,1,10,36,48
18463,4,1,7,38,50
18465,0,0,2,20,22
18466,0,0,10,27,37
18467,0,0,2,7,9
18468,0,0,4,8,12
18469,0,0,1,5,6
18470,0,0,7,30,37
18471,1,2,9,32,44
18472,0,1,4,23,28
18473,0,1,2,17,20
18476,0,0,3,5,8
18477,0,0,7,11,18
18479,0,0,3,12,15
18480,3,2,1,21,27
18481,0,0,1,12,13
18482,0,0,8,16,24
18483,0,2,6,16,24
18484,0,0,20,30,50
18485,1,2,10,11,24
18486,0,0,4,18,22
18487,0,0,2,8,10
18488,0,1,12,34,47
18489,0,0,2,4,6
18490,0,1,0,6,7
18491,0,0,0,12,12
18492,0,0,0,8,8
18493,2,0,2,40,44
18494,3,1,3,16,23
18495,0,2,7,25,34
18496,0,0,0,7,7
18497,0,0,6,19,25
18498,0,0,6,16,22
18499,1,1,2,9,13
18500,0,4,0,31,35
18501,0,0,2,8,10
18502,0,0,0,6,6
18503,0,0,0,7,7
18504,0,1,1,4,6
18505,0,0,6,17,23
18506,0,4,10,34,48
18507,1,0,6,21,28
18508,0,0,13,31,44
18509,0,3,12,32,47
18510,1,1,12,31,45
18511,0,1,9,14,24
18512,0,1,17,30,48
18513,0,0,5,6,11
18514,0,0,2,3,5
18515,3,0,5,15,23
18517,0,2,6,28,36
18518,0,0,4,11,15
18519,0,0,8,19,27
18520,1,1,6,24,32
18521,0,0,2,5,7
18522,0,1,12,14,27
18523,0,0,11,30,41
18524,0,1,18,28,47
18525,0,1,17,32,50
18526,0,3,14,21,38
18527,0,2,9,15,26
18528,0,0,13,25,38
18529,0,0,11,20,31
18530,0,1,15,17,33
18531,4,0,8,37,49
18532,0,1,3,19,23
18533,0,0,1,30,31
18534,0,0,11,31,42
18535,0,0,11,27,38
18536,0,0,3,12,15
18537,0,0,16,14,30
18538,0,0,7,12,19
18539,0,0,10,27,37
18540,0,0,11,15,26
18541,1,1,12,36,50
18542,0,0,6,16,22
18543,0,2,5,29,36
18544,0,1,1,28,30
18545,0,0,6,22,28
18546,0,1,2,12,15
18547,0,0,13,36,49
18548,0,1,11,17,29
18549,0,1,11,38,50
18550,0,0,12,18,30
18551,0,1,6,20,27
18552,0,0,7,18,25
18553,0,1,13,35,49
18554,0,1,8,40,49
18555,0,0,11,24,35
18556,0,0,4,4,8
18557,0,0,3,12,15
18558,0,0,10,28,38
18559,0,1,14,33,48
18560,0,0,8,21,29
18561,0,0,4,7,11
18562,0,2,3,12,17
18563,0,0,16,22,38
18564,0,0,8,23,31
18565,0,1,8,29,38
18566,1,0,4,14,19
18567,0,0,11,35,46
18568,1,0,4,18,23
18569,0,0,10,14,24
18570,0,0,16,28,44
18571,0,0,5,14,19
18572,0,0,13,16,29
18573,0,0,5,17,22
18575,1,0,3,19,23
18576,1,0,2,24,27
18577,0,0,3,5,8
18578,0,2,7,15,24
18579,0,1,5,12,18
18580,0,0,3,13,16
18582,0,3,5,13,21
18583,0,0,6,13,19
18584,1,0,10,21,32
18585,0,0,11,22,33
18586,0,1,7,37,45
18587,0,0,7,30,37
18588,0,0,5,37,42
18589,0,0,11,17,28
18590,0,0,6,6,12
18591,0,0,8,28,36
18592,1,0,0,5,6
18593,2,0,5,14,21
18594,0,0,7,12,19
18595,0,0,4,19,23
18596,0,0,8,27,35
18597,0,1,5,26,32
18598,0,0,13,16,29
18599,0,2,3,7,12
18602,2,0,4,7,13
18603,0,0,6,7,13
18604,0,0,1,12,13
18605,0,1,6,15,22
18606,0,0,7,8,15
18607,0,0,10,40,50
18608,0,1,14,21,36
18609,0,0,12,17,29
18610,0,0,2,6,8
18611,0,1,4,3,8
18612,0,0,11,25,36
18613,0,0,10,40,50
18614,0,1,8,18,27
18615,0,0,1,6,7
18616,0,0,2,3,5
18617,0,1,8,38,47
18618,0,0,13,17,30
18619,0,0,4,4,8
18620,0,0,4,27,31
18621,0,0,8,14,22
18622,0,0,4,5,9
18623,1,2,0,12,15
18624,0,0,3,10,13
18625,0,2,8,26,36
18627,1,1,10,30,42
18628,0,0,5,10,15
18629,0,0,2,3,5
18630,3,0,2,18,23
18631,4,0,0,21,25
18632,0,0,10,13,23
18633,0,0,11,37,48
18634,0,0,7,13,20
18635,0,0,2,8,10
18636,0,0,3,3,6
18637,4,1,12,30,47
18638,0,0,6,5,11
18639,0,0,8,28,36
18640,0,0,4,6,10
18641,3,1,3,16,23
18642,1,2,4,16,23
18643,0,1,15,32,48
18645,0,0,0,7,7
18646,1,1,2,9,13
18647,2,2,4,42,50
18648,0,0,11,21,32
18649,0,0,0,4,4
18650,1,4,9,23,37
18651,0,0,3,11,14
18652,1,0,8,20,29
18653,0,0,1,9,10
18654,0,0,16,33,49
18655,0,0,11,33,44
18656,0,0,6,15,21
18657,5,1,6,29,41
18658,0,4,18,28,50
18659,4,1,7,38,50
18660,0,0,1,10,11
18661,0,2,21,26,49
18662,0,0,7,11,18
18663,1,1,4,13,19
18664,0,0,3,13,16
18665,0,0,4,21,25
18666,3,0,8,36,47
18667,0,0,10,15,25
18668,0,1,9,12,22
18669,0,1,1,16,18
18670,0,0,5,1,6
18671,0,0,0,7,7
18672,2,0,2,13,17
18673,0,4,5,11,20
18674,1,2,9,32,44
18675,1,0,19,30,50
18676,1,0,17,12,30
18677,0,1,12,34,47
18678,1,0,5,18,24
18679,0,0,1,4,5
18680,0,2,9,38,49
18681,0,0,2,12,14
18682,0,0,1,5,6
18683,4,0,4,28,36
18684,0,0,7,20,27
18685,0,0,3,4,7
18686,1,2,10,11,24
18687,1,0,1,3,5
18688,2,0,2,26,30
18689,0,2,9,15,26
18690,1,1,17,31,50
18691,0,0,2,8,10
18692,0,2,1,10,13
18693,0,1,4,23,28
18694,0,0,3,15,18
18695,0,0,2,14,16
18696,0,0,3,7,10
18697,0,1,10,35,46
18698,1,5,13,25,44
18699,2,0,2,40,44
18700,0,2,2,7,11
18701,0,3,3,17,23
18702,0,0,5,9,14
18703,2,0,3,10,15
18705,0,1,0,6,7
18706,0,0,0,12,12
18707,0,0,2,7,9
18708,0,1,1,4,6
18709,0,0,0,12,12
18710,0,0,6,19,25
18711,0,0,2,4,6
18712,0,4,0,31,35
18713,1,0,8,36,45
18714,0,0,12,37,49
18716,0,0,9,41,50
18717,0,2,3,29,34
18718,1,1,6,24,32
18719,0,1,5,6,12
18720,1,0,3,19,23
18721,1,0,13,31,45
18722,2,0,0,5,7
18723,0,2,1,13,16
18724,0,14,6,30,50
18725,0,2,6,28,36
18726,0,1,8,16,25
18727,0,0,5,5,10
18728,0,2,1,10,13
18729,0,0,2,7,9
18730,4,0,8,37,49
18731,3,2,1,21,27
18732,0,2,3,7,12
18733,1,1,0,13,15
18734,1,2,6,30,39
18735,1,1,17,31,50
18736,0,3,3,17,23
18737,1,0,19,30,50
18738,0,0,6,19,25
18739,0,0,0,5,5
18740,0,2,6,16,24
18741,0,1,10,35,46
18743,0,1,0,6,7
18744,0,0,2,4,6
18745,1,1,4,18,24
18746,0,0,5,6,11
18747,0,1,8,33,42
18748,3,0,2,18,23
18749,0,1,7,21,29
18750,0,0,20,30,50
18751,1,0,17,12,30
18752,0,1,2,17,20
18753,1,0,6,21,28
18754,3,1,3,16,23
18755,0,4,0,31,35
18756,0,0,0,8,8
18757,2,0,2,40,44
18758,0,0,2,8,10
18759,0,2,6,16,24
18760,2,2,4,42,50
18761,4,1,3,19,27
18762,0,0,6,17,23
18763,5,1,6,29,41
18764,0,0,1,30,31
18765,0,0,5,6,11
18766,1,0,8,20,29
18767,0,0,0,7,7
18768,0,0,12,16,28
18769,0,3,8,6,17
18770,0,7,5,38,50
18771,1,5,13,25,44
18772,0,0,20,30,50
18773,0,2,6,16,24
18774,2,0,2,26,30
18775,0,1,4,15,20
18776,7,4,2,18,31
18777,0,0,0,10,10
18778,5,1,6,29,41
18779,0,0,8,20,28
18780,0,0,0,7,7
18781,2,0,2,26,30
18782,0,0,2,7,9
18783,0,2,6,16,24
18784,0,0,11,33,44
18785,0,0,3,4,7
18786,3,1,3,16,23
18787,7,4,2,18,31
18788,1,2,6,30,39
18789,1,4,9,23,37
18790,0,0,1,30,31
18791,0,0,4,27,31
18792,0,1,8,33,42
18793,0,0,3,3,6
18794,0,3,14,21,38
18795,0,0,2,7,9
18796,0,0,7,11,18
18797,4,1,3,19,27
18798,0,0,4,21,25
18799,0,0,9,16,25
18800,0,2,3,12,17
18801,0,7,5,38,50
18802,0,1,5,9,15
18803,0,0,3,7,10
18804,0,2,21,26,49
18805,2,2,4,42,50
18806,0,1,2,17,20
18807,0,2,3,3,8
18808,0,1,10,35,46
18809,1,0,19,30,50
18810,1,1,0,13,15
18811,0,0,20,30,50
18812,1,5,13,25,44
18813,0,0,6,19,25
18814,2,0,3,10,15
18815,0,1,7,24,32
18816,0,1,7,10,18
18817,0,0,1,9,10
18818,0,0,7,13,20
18819,0,0,4,10,14
18821,0,0,8,14,22
18822,0,0,2,20,22
18823,0,0,8,18,26
18824,1,0,2,2,5
18825,0,0,6,4,10
18826,0,0,0,8,8
18827,0,0,0,1,1
18828,0,0,6,2,8
18829,0,1,6,33,40
18830,2,2,8,34,46
18831,0,0,7,15,22
18832,0,0,6,21,27
18833,0,0,1,7,8
18834,0,0,4,8,12
18835,0,0,3,8,11
18836,0,0,12,29,41
18837,0,0,6,17,23
18838,0,0,8,13,21
18839,0,0,4,6,10
18840,1,0,4,19,24
18841,0,0,3,8,11
18842,0,0,2,10,12
18843,0,0,7,15,22
18844,0,0,3,7,10
18845,0,2,14,24,40
18846,0,0,1,11,12
18847,0,0,11,15,26
18848,0,0,6,5,11
18849,0,0,12,19,31
18851,0,0,3,17,20
18852,0,0,4,13,17
18853,0,0,10,26,36
18854,2,0,10,38,50
18855,0,0,0,8,8
18856,0,2,9,14,25
18857,0,0,0,9,9
18858,0,0,4,33,37
18859,0,0,0,3,3
18860,0,1,16,31,48
18861,0,0,6,7,13
18862,0,0,0,5,5
18863,0,0,8,14,22
18864,0,0,0,4,4
18865,0,0,0,2,2
18866,0,0,4,7,11
18867,0,1,1,8,10
18868,0,0,9,21,30
18869,0,3,8,38,49
18870,1,0,5,19,25
18871,0,0,7,7,14
18872,0,0,1,7,8
18873,0,0,5,32,37
18874,0,0,8,22,30
18875,1,1,10,28,40
18876,0,1,6,11,18
18877,0,0,5,3,8
18878,0,2,7,28,37
18880,0,0,7,21,28
18881,0,0,1,9,10
18882,0,1,3,20,24
18883,1,1,1,14,17
18884,1,0,9,29,39
18885,0,0,3,16,19
18886,0,0,3,12,15
18887,0,0,4,4,8
18888,0,0,2,20,22
18889,1,0,0,7,8
18890,1,0,8,22,31
18891,0,1,4,17,22
18892,1,0,4,15,20
18893,0,0,6,13,19
18894,0,0,2,5,7
18895,0,0,6,15,21
18896,0,0,4,14,18
18897,0,1,7,26,34
18898,0,0,8,5,13
18899,0,0,8,23,31
18900,0,0,4,15,19
18901,0,0,0,12,12
18902,0,0,1,7,8
18903,0,0,6,5,11
18904,0,0,0,14,14
18905,0,0,4,11,15
18907,0,0,10,26,36
18908,0,0,1,4,5
18909,0,0,6,15,21
18910,0,1,4,8,13
18911,0,0,8,24,32
18912,1,2,0,33,36
18913,0,0,6,2,8
18914,0,0,0,5,5
18915,0,1,21,28,50
18916,1,0,4,30,35
18917,0,0,1,2,3
18918,0,0,6,17,23
18919,0,0,7,7,14
18920,0,1,2,5,8
18921,0,0,3,5,8
18922,0,2,4,16,22
18923,0,0,6,4,10
18924,0,0,5,9,14
18925,0,0,0,5,5
18926,0,1,8,20,29
18927,0,0,5,10,15
18928,0,0,3,5,8
18929,0,0,11,23,34
18930,0,0,11,18,29
18931,0,0,14,18,32
18932,0,0,1,9,10
18933,0,0,2,11,13
18934,0,0,9,25,34
18935,4,2,8,36,50
18936,1,2,3,18,24
18937,0,0,6,4,10
18938,0,0,14,34,48
18939,0,0,1,7,8
18940,0,0,11,25,36
18941,0,1,4,4,9
18942,0,0,9,15,24
18943,0,0,7,9,16
18944,0,1,1,12,14
18945,0,0,16,20,36
18946,0,0,7,8,15
18947,0,0,11,25,36
18948,0,0,11,13,24
18949,0,0,4,10,14
18950,1,0,2,15,18
18951,0,0,3,1,4
18952,0,0,11,11,22
18953,0,1,9,26,36
18954,0,0,1,5,6
18955,0,0,7,18,25
18956,0,0,5,9,14
18957,0,4,5,11,20
18958,0,1,10,15,26
18961,0,0,3,5,8
18962,0,0,0,8,8
18963,0,0,4,7,11
18964,0,2,8,27,37
18965,0,0,8,25,33
18966,1,0,2,13,16
18967,0,0,12,27,39
18968,0,0,5,3,8
18969,0,0,10,12,22
18970,0,0,1,2,3
18971,0,0,15,17,32
18972,0,1,7,20,28
18973,0,0,1,10,11
18974,0,3,2,37,42
18975,0,0,0,36,36
18976,0,0,3,10,13
18977,0,1,2,10,13
18978,0,0,1,6,7
18979,0,0,4,19,23
18980,0,0,1,7,8
18981,0,1,5,19,25
18982,0,0,13,18,31
18983,1,0,6,17,24
18984,0,1,6,8,15
18985,0,1,8,11,20
18986,0,1,3,5,9
18987,0,0,6,12,18
18988,0,0,3,11,14
18989,1,1,7,16,25
18990,0,0,7,13,20
18991,0,0,9,17,26
18992,0,0,7,10,17
18993,1,0,6,13,20
18994,0,0,7,16,23
18995,0,2,9,33,44
18996,0,0,2,8,10
18997,0,3,4,7,14
18998,0,0,18,23,41
18999,0,0,0,3,3
19000,0,0,2,1,3
19001,1,0,1,18,20
19002,2,3,6,31,42
19003,0,0,2,12,14
19004,0,4,12,16,32
19005,0,0,10,12,22
19006,0,0,6,27,33
19007,0,1,8,20,29
19008,0,0,11,29,40
19009,0,2,11,31,44
19010,1,0,5,34,40
19011,0,0,11,25,36
19012,0,0,1,3,4
19013,0,1,2,12,15
19014,0,0,4,10,14
19015,0,0,7,30,37
19016,1,1,10,24,36
19017,0,0,8,12,20
19018,0,1,1,8,10
19019,0,4,0,10,14
19020,0,0,3,8,11
19021,0,0,6,26,32
19023,0,2,1,7,10
19024,0,0,3,10,13
19025,0,0,10,12,22
19026,0,0,6,2,8
19027,1,2,0,11,14
19028,0,0,4,13,17
19029,1,0,5,4,10
19030,0,0,2,24,26
19031,0,0,6,5,11
19032,0,0,2,12,14
19033,0,0,6,24,30
19034,0,0,11,39,50
19035,0,0,8,14,22
19036,0,1,6,21,28
19037,1,0,11,26,38
19038,0,0,3,7,10
19039,0,1,13,36,50
19041,0,2,1,6,9
19042,0,0,2,19,21
19043,0,2,7,32,41
19044,0,0,7,18,25
19045,0,0,8,29,37
19046,1,0,2,21,24
19047,0,0,4,10,14
19048,0,1,3,9,13
19049,0,0,3,7,10
19050,0,1,2,22,25
19051,0,0,1,3,4
19052,0,0,6,9,15
19053,1,0,4,19,24
19054,0,2,9,21,32
19055,0,1,8,6,15
19056,0,1,5,32,38
19057,0,1,2,13,16
19058,0,0,4,18,22
19059,0,0,5,9,14
19060,0,0,3,9,12
19061,0,0,1,4,5
19062,0,2,4,10,16
19063,0,0,0,7,7
19064,0,1,9,27,37
19065,0,0,11,32,43
19066,0,0,4,11,15
19067,0,0,10,13,23
19068,0,1,5,16,22
19069,0,0,7,12,19
19070,1,0,0,6,7
19071,0,0,1,8,9
19072,0,0,2,7,9
19073,0,3,2,20,25
19074,0,0,5,19,24
19075,0,1,7,11,19
19076,0,0,1,12,13
19077,0,0,1,20,21
19078,0,0,5,3,8
19079,0,0,4,6,10
19080,0,0,0,4,4
19081,0,1,10,29,40
19082,0,0,3,7,10
19084,0,0,0,8,8
19085,0,0,1,22,23
19086,0,0,7,19,26
19087,1,1,10,28,40
19088,0,1,3,9,13
19089,0,0,9,22,31
19090,0,1,9,31,41
19091,0,0,0,6,6
19092,0,0,7,10,17
19093,0,0,5,4,9
19094,2,0,0,4,6
19095,0,0,3,10,13
19096,0,0,0,6,6
19098,0,0,3,11,14
19099,0,0,12,17,29
19100,0,0,2,12,14
19101,1,1,5,32,39
19102,0,0,7,12,19
19103,0,0,0,5,5
19104,2,2,8,34,46
19105,0,0,0,10,10
19106,0,0,3,14,17
19107,0,1,4,9,14
19108,0,0,7,5,12
19109,0,0,1,2,3
19110,0,0,8,16,24
19111,0,1,14,24,39
19112,0,0,2,10,12
19113,0,0,4,18,22
19114,0,0,6,13,19
19115,1,1,7,15,24
19116,0,0,1,7,8
19117,0,0,4,19,23
19118,0,5,2,8,15
19119,0,0,12,28,40
19120,0,0,7,8,15
19121,0,0,11,39,50
19122,0,4,6,22,32
19123,0,0,9,11,20
19124,0,0,5,9,14
19125,1,0,20,29,50
19126,0,0,4,11,15
19127,0,0,5,16,21
19128,0,0,5,9,14
19129,0,0,3,9,12
19130,0,0,1,4,5
19131,0,0,3,5,8
19133,0,2,5,12,19
19134,0,0,10,22,32
19135,0,3,6,11,20
19139,1,0,0,34,35
19140,0,4,3,21,28
19141,0,1,5,35,41
19142,0,0,8,6,14
19143,0,0,6,9,15
19144,0,0,0,9,9
19145,0,0,9,18,27
19146,0,0,0,16,16
19147,0,0,4,4,8
19148,0,1,6,36,43
19149,0,0,9,13,22
19151,0,0,14,19,33
19152,0,0,10,7,17
19153,0,0,16,33,49
19154,0,1,10,19,30
19155,0,0,1,3,4
19156,0,0,15,34,49
19157,0,0,3,8,11
19158,0,0,11,14,25
19159,0,4,16,25,45
19160,0,0,4,13,17
19161,0,0,7,4,11
19162,0,0,2,33,35
19163,0,0,2,11,13
19164,0,0,12,20,32
19165,0,2,5,16,23
19166,0,0,1,11,12
19167,2,0,16,30,48
19168,0,1,6,12,19
19169,0,0,1,6,7
19170,0,0,0,5,5
19172,0,1,3,13,17
19173,0,1,2,13,16
19174,0,3,0,17,20
19175,0,0,4,2,6
19176,0,0,7,4,11
19177,0,1,6,16,23
19178,0,0,0,5,5
19179,0,0,4,11,15
19180,0,0,4,21,25
19181,0,1,8,10,19
19182,0,0,1,3,4
19183,0,0,0,8,8
19184,0,0,12,38,50
19186,0,0,5,5,10
19187,0,0,0,13,13
19189,0,0,6,7,13
19190,0,0,10,17,27
19191,0,0,4,12,16
19192,0,5,12,32,49
19193,0,0,1,7,8
19194,0,0,8,26,34
19195,0,0,2,5,7
19196,0,0,4,3,7
19197,0,1,4,10,15
19198,0,1,4,10,15
19199,0,0,6,2,8
19201,0,0,8,24,32
19202,0,0,3,4,7
19203,0,1,1,14,16
19204,0,2,4,25,31
19205,0,1,12,7,20
19206,0,2,2,18,22
19207,2,0,14,34,50
19208,0,0,2,9,11
19209,0,0,2,2,4
19210,0,0,1,5,6
19212,0,0,2,8,10
19213,0,1,6,6,13
19214,0,0,7,13,20
19215,0,0,9,8,17
19216,0,0,3,3,6
19217,0,0,0,1,1
19218,0,0,1,4,5
19219,0,1,8,17,26
19220,0,5,0,2,7
19222,0,0,5,6,11
19223,0,4,4,29,37
19224,0,0,4,3,7
19225,0,0,1,5,6
19226,0,0,5,3,8
19227,0,0,1,10,11
19229,0,0,3,0,3
19234,0,0,4,7,11
19235,0,0,3,7,10
19236,0,0,6,13,19
19240,0,0,0,6,6
19241,1,0,1,16,18
19242,1,1,6,28,36
19243,0,0,5,4,9
19244,1,4,9,23,37
19245,0,0,4,7,11
19246,0,2,7,24,33
19247,0,1,13,28,42
19248,0,0,6,15,21
19250,0,0,0,10,10
19251,1,0,9,11,21
19252,0,0,4,4,8
19253,0,3,0,9,12
19254,0,0,2,14,16
19255,0,2,6,10,18
19256,0,0,9,25,34
19257,1,0,2,2,5
19258,0,0,6,12,18
19259,1,4,7,27,39
19260,0,1,2,17,20
19261,2,0,2,13,17
19262,0,0,6,16,22
19264,0,0,4,18,22
19265,2,0,2,11,15
19266,0,1,12,34,47
19267,0,1,5,10,16
19268,1,0,16,30,47
19269,0,3,5,7,15
19270,0,1,7,24,32
19271,0,0,20,30,50
19272,0,2,4,14,20
19273,0,0,4,19,23
19274,1,2,5,42,50
19275,0,1,6,33,40
19276,1,5,13,25,44
19277,0,0,0,7,7
19280,1,1,1,5,8
19281,0,0,0,8,8
19282,4,0,0,15,19
19283,0,0,0,1,1
19284,1,2,0,7,10
19285,1,1,2,9,13
19286,0,0,10,29,39
19287,0,1,1,21,23
19288,0,0,4,11,15
19289,0,2,23,25,50
19290,0,0,25,25,50
19291,0,0,9,40,49
19292,0,1,4,18,23
19293,0,0,13,30,43
19294,1,4,9,23,37
19295,0,0,11,30,41
19296,0,1,10,21,32
19297,0,0,9,16,25
19298,1,0,8,29,38
19299,2,0,11,37,50
19300,0,0,6,15,21
19301,0,0,12,26,38
19302,0,0,4,24,28
19303,1,1,6,28,36
19304,0,1,4,41,46
19305,1,0,8,20,29
19306,0,0,10,24,34
19307,0,0,6,4,10
19308,2,0,10,38,50
19309,0,0,12,38,50
19310,0,3,14,21,38
19311,0,1,3,10,14
19312,0,0,0,9,9
19313,0,1,12,31,44
19314,0,0,4,14,18
19315,0,0,1,3,4
19316,0,0,8,22,30
19317,0,0,4,6,10
19318,1,0,20,29,50
19319,0,5,11,34,50
19320,0,0,2,9,11
19321,0,1,4,17,22
19322,0,0,10,13,23
19323,0,1,10,24,35
19324,0,1,9,21,31
19325,0,0,10,22,32
19326,0,1,14,22,37
19327,0,0,1,4,5
19328,0,0,6,10,16
19329,1,0,1,16,18
19330,2,0,10,9,21
19331,0,0,6,9,15
19332,0,0,5,16,21
19333,1,1,10,28,40
19334,0,0,5,8,13
19335,0,0,1,22,23
19336,0,1,14,31,46
19337,0,3,10,35,48
19338,0,0,0,10,10
19339,0,0,10,25,35
19340,1,0,9,25,35
19342,1,0,10,19,30
19343,0,0,7,20,27
19344,0,1,0,23,24
19345,0,0,4,8,12
19346,0,6,11,32,49
19347,1,2,6,18,27
19348,0,0,16,32,48
19349,0,0,6,7,13
19350,0,0,14,28,42
19351,0,0,9,34,43
19352,0,0,5,10,15
19353,0,1,8,26,35
19354,0,0,0,13,13
19355,0,0,5,9,14
19356,0,0,8,13,21
19357,0,0,8,4,12
19358,0,0,7,11,18
19359,0,0,4,8,12
19360,0,0,10,13,23
19361,0,0,11,25,36
19362,0,0,8,13,21
19363,1,0,9,11,21
19364,0,1,3,11,15
19365,0,1,10,38,49
19366,0,2,9,29,40
19367,0,2,10,31,43
19368,0,0,9,41,50
19369,0,1,3,16,20
19370,0,1,6,6,13
19371,0,0,8,18,26
19372,0,0,17,19,36
19373,0,0,1,4,5
19375,0,0,3,1,4
19376,0,1,9,32,42
19377,0,0,3,5,8
19378,0,0,9,20,29
19379,1,0,8,39,48
19380,0,0,14,34,48
19381,2,0,4,7,13
19382,0,0,12,8,20
19383,0,1,9,26,36
19384,2,0,4,23,29
19385,0,0,6,12,18
19386,0,0,5,36,41
19387,1,2,13,29,45
19388,0,0,7,32,39
19389,2,0,12,23,37
19390,0,0,7,12,19
19391,0,1,5,23,29
19392,0,6,6,34,46
19393,1,3,3,23,30
19394,1,0,7,14,22
19395,0,1,6,20,27
19396,7,1,0,22,30
19397,1,1,6,33,41
19398,0,0,8,9,17
19399,0,0,18,11,29
19401,1,0,21,28,50
19402,0,0,8,42,50
19403,0,0,13,16,29
19404,1,0,4,15,20
19406,0,0,12,23,35
19407,1,0,12,37,50
19408,1,1,1,7,10
19409,0,0,5,35,40
19410,0,0,10,22,32
19411,0,1,2,26,29
19413,0,0,3,4,7
19414,0,0,2,3,5
19415,1,0,0,6,7
19416,0,0,3,24,27
19417,0,0,3,19,22
19418,0,1,12,34,47
19419,0,0,12,7,19
19420,0,0,9,11,20
19421,1,0,18,31,50
19422,0,0,4,25,29
19423,0,0,13,20,33
19424,1,1,4,12,18
19425,0,0,8,17,25
19426,1,1,12,30,44
19428,0,1,17,32,50
19429,4,0,0,20,24
19430,0,0,6,7,13
19431,0,0,0,6,6
19432,2,1,4,32,39
19433,0,0,4,5,9
19434,1,1,3,23,28
19436,0,0,7,11,18
19437,0,0,3,24,27
19438,0,0,7,12,19
19439,0,0,9,14,23
19440,0,1,9,40,50
19441,4,0,9,29,42
19443,1,0,4,8,13
19444,1,0,8,15,24
19445,2,0,2,11,15
19446,0,0,12,10,22
19447,0,0,4,6,10
19448,0,0,7,21,28
19449,0,3,5,7,15
19450,1,0,0,11,12
19451,0,0,6,11,17
19452,0,1,13,22,36
19453,0,0,10,31,41
19454,0,0,5,9,14
19455,0,0,1,1,2
19456,0,0,8,13,21
19457,0,0,8,28,36
19458,0,0,0,7,7
19459,0,0,7,10,17
19460,3,0,6,21,30
19461,0,0,13,14,27
19463,0,0,2,6,8
19464,0,0,5,6,11
19465,0,0,2,3,5
19467,1,0,1,3,5
19468,0,0,1,6,7
19469,0,1,13,18,32
19470,0,0,1,8,9
19471,0,0,4,3,7
19472,0,0,1,0,1
19473,0,0,0,1,1
19474,0,0,9,11,20
19475,1,5,13,25,44
19477,2,2,3,24,31
19478,0,0,4,8,12
19479,1,0,5,9,15
19480,0,1,2,5,8
19481,0,0,6,4,10
19482,1,1,1,5,8
19483,0,1,12,25,38
19485,0,0,2,20,22
19486,1,0,1,5,7
19487,1,1,8,28,38
19489,0,0,13,10,23
19490,0,0,3,17,20
19491,0,2,7,24,33
19492,4,0,8,37,49
19493,0,0,4,7,11
19494,0,0,5,32,37
19495,1,0,6,21,28
19496,0,0,10,40,50
19497,0,0,1,12,13
19498,2,0,2,13,17
19499,0,0,6,27,33
19500,0,0,9,25,34
19501,0,1,3,22,26
19502,0,4,5,11,20
19503,0,0,0,36,36
19504,0,0,3,5,8
19505,0,0,4,4,8
19506,0,0,1,8,9
19507,0,1,6,31,38
19508,1,0,2,2,5
19509,1,0,16,30,47
19510,0,0,20,30,50
19512,0,0,7,30,37
19513,3,0,2,18,23
19514,0,2,6,10,18
19515,0,0,4,18,22
19516,1,0,3,12,16
19517,0,0,0,23,23
19519,0,1,6,33,40
19520,0,1,10,19,30
19521,1,2,5,42,50
19522,0,0,0,5,5
19523,0,3,0,17,20
19524,0,0,6,16,22
19525,1,0,0,34,35
19526,4,0,0,15,19
19527,1,1,2,9,13
19528,0,0,0,1,1
19529,0,2,2,18,22
19530,0,0,7,15,22
19531,1,0,1,16,18
19532,0,0,13,19,32
19533,4,0,8,37,49
19534,0,0,0,10,10
19535,0,1,1,21,23
19536,0,0,8,23,31
19537,0,1,13,28,42
19538,0,0,3,35,38
19539,0,0,16,20,36
19540,1,0,2,8,11
19541,0,0,12,35,47
19543,4,0,10,34,48
19544,2,0,4,23,29
19545,1,0,8,39,48
19546,0,2,9,29,40
19547,0,1,0,14,15
19548,0,1,12,37,50
19550,0,0,9,16,25
19551,0,0,10,12,22
19552,0,0,2,27,29
19553,0,0,0,15,15
19554,0,0,9,37,46
19557,0,0,11,17,28
19558,0,0,1,5,6
19559,0,0,2,6,8
19560,0,0,6,10,16
19561,2,0,9,14,25
19563,1,0,3,12,16
19564,0,1,8,41,50
19565,0,0,0,10,10
19566,0,0,1,17,18
19567,0,1,3,22,26
19568,1,0,1,5,7
19569,0,0,0,23,23
19571,0,0,7,4,11
19572,0,2,5,43,50
19573,1,0,1,9,11
19574,0,2,0,18,20
19575,1,0,6,21,28
19576,0,0,1,4,5
19577,0,0,1,24,25
19578,0,0,7,15,22
19580,0,0,1,12,13
19581,0,1,2,17,20
19582,0,2,7,22,31
19583,0,0,1,17,18
19584,4,0,10,34,48
19585,0,0,1,8,9
19586,3,0,2,18,23
19587,1,4,7,27,39
19588,0,0,1,4,5
19589,0,0,2,6,8
19590,1,0,9,25,35
19591,2,0,0,4,6
19592,0,0,0,8,8
19593,1,0,0,34,35
19594,2,0,9,38,49
19595,0,0,8,23,31
19596,0,0,0,10,10
19597,0,0,2,6,8
19598,0,1,6,33,40
19599,0,0,4,7,11
19600,0,1,1,11,13
19601,1,0,0,34,35
19602,4,0,0,15,19
19603,1,1,1,5,8
19604,1,5,13,25,44
19605,0,0,14,28,42
19606,1,0,18,31,50
19607,1,0,8,20,29
19608,0,1,1,11,13
19609,0,0,5,4,9
19610,0,0,2,6,8
19611,2,0,9,38,49
19612,2,0,9,38,49
19613,0,1,6,31,38
19614,0,1,2,17,20
19615,0,2,9,14,25
19616,0,0,6,27,33
19617,0,3,14,21,38
19618,0,0,8,23,31
19619,0,1,10,29,40
19620,0,0,4,19,23
19621,1,4,9,23,37
19622,1,2,5,42,50
19623,0,1,10,19,30
19624,1,5,13,25,44
19626,0,0,6,16,22
19627,1,1,2,2,6
19628,0,1,7,21,29
19629,0,0,7,8,15
19630,0,0,3,1,4
19631,0,0,5,4,9
19632,0,0,3,4,7
19634,0,0,1,5,6
19635,0,1,3,11,15
19636,0,1,9,21,31
19637,0,0,0,16,16
19638,0,0,3,9,12
19639,0,0,14,33,47
19640,0,0,4,15,19
19641,1,1,7,23,32
19642,0,0,5,16,21
19643,0,0,1,4,5
19644,0,0,10,38,48
19645,0,0,3,5,8
19646,0,0,1,5,6
19647,0,0,10,32,42
19648,0,1,16,31,48
19649,0,0,9,28,37
19650,0,1,2,13,16
19651,0,0,3,16,19
19652,1,0,5,16,22
19653,0,1,1,35,37
19654,0,0,2,18,20
19655,0,0,1,13,14
19656,0,0,10,22,32
19657,0,0,2,19,21
19658,0,0,2,23,25
19659,0,0,0,4,4
19660,0,2,9,12,23
19661,0,0,4,9,13
19662,1,0,0,7,8
19663,0,0,6,9,15
19664,0,2,2,7,11
19665,0,0,8,25,33
19666,0,0,3,9,12
19667,0,0,15,21,36
19668,0,1,4,17,22
19669,0,0,3,7,10
19670,0,0,5,10,15
19671,0,0,5,11,16
19672,0,2,6,15,23
19673,0,1,6,42,49
19674,0,0,12,15,27
19675,0,0,2,8,10
19676,0,0,7,1,8
19677,0,0,0,8,8
19678,0,0,1,4,5
19679,1,0,1,8,10
19680,0,0,3,20,23
19681,0,1,5,11,17
19682,0,1,13,27,41
19683,0,0,5,11,16
19684,1,0,15,32,48
19685,0,0,1,18,19
19686,0,1,8,9,18
19687,0,2,11,14,27
19688,0,0,16,34,50
19689,0,0,2,10,12
19690,0,0,3,16,19
19691,0,3,10,20,33
19692,0,0,2,3,5
19693,1,0,9,11,21
19695,0,1,11,26,38
19696,1,0,5,22,28
19697,0,1,5,12,18
19698,0,1,6,16,23
19699,0,0,4,11,15
19700,1,0,9,24,34
19701,1,1,4,21,27
19702,0,0,11,12,23
19703,0,0,16,33,49
19704,0,0,4,26,30
19705,0,0,6,10,16
19706,0,1,10,14,25
19707,0,0,9,22,31
19708,0,0,4,6,10
19709,0,1,2,4,7
19710,1,1,7,18,27
19711,2,1,8,13,24
19712,0,0,10,26,36
19713,0,0,0,6,6
19714,0,0,6,3,9
19715,0,0,1,7,8
19716,0,0,0,6,6
19717,0,0,4,13,17
19718,0,0,1,4,5
19719,0,0,4,22,26
19720,0,0,1,9,10
19721,0,0,8,14,22
19722,0,0,1,2,3
19723,0,0,10,12,22
19724,0,0,2,27,29
19725,0,1,2,25,28
19726,0,0,9,20,29
19727,0,0,3,24,27
19728,0,1,5,17,23
19729,0,0,2,6,8
19730,0,0,2,5,7
19731,0,0,5,22,27
19732,0,0,8,34,42
19733,0,1,9,24,34
19734,0,0,3,0,3
19735,0,0,4,11,15
19736,0,0,7,5,12
19737,0,1,1,9,11
19738,0,0,1,5,6
19739,0,0,9,23,32
19740,0,0,11,21,32
19741,0,0,1,8,9
19742,0,0,1,4,5
19744,0,0,5,6,11
19745,0,0,0,5,5
19746,0,0,3,20,23
19747,0,0,1,20,21
19748,0,0,1,1,2
19749,1,0,3,15,19
19750,1,0,7,25,33
19751,0,1,6,15,22
19752,0,0,6,3,9
19753,0,0,4,5,9
19754,0,0,2,0,2
19755,0,0,9,27,36
19757,0,0,8,15,23
19758,0,0,5,6,11
19759,0,0,8,39,47
19760,0,0,6,19,25
19761,0,1,13,27,41
19762,0,0,6,11,17
19763,0,1,5,10,16
19764,0,1,3,11,15
19765,0,0,7,10,17
19766,0,1,4,11,16
19767,1,0,5,13,19
19768,0,0,6,13,19
19769,0,0,3,10,13
19770,1,2,2,27,32
19771,0,0,3,8,11
19772,0,0,5,18,23
19773,0,0,1,7,8
19775,0,1,13,36,50
19776,0,0,13,16,29
19777,0,0,3,10,13
19778,0,0,1,16,17
19779,0,0,10,27,37
19780,0,0,6,14,20
19781,0,0,3,16,19
19782,0,0,0,7,7
19783,0,1,2,26,29
19784,0,0,5,13,18
19785,0,0,10,10,20
19786,0,0,3,22,25
19787,0,0,3,9,12
19788,0,0,5,1,6
19789,0,0,9,19,28
19790,0,0,1,13,14
19791,0,0,2,3,5
19792,0,0,9,26,35
19793,1,0,13,19,33
19794,0,0,4,11,15
19795,1,1,13,34,49
19796,0,0,3,3,6
19797,1,0,2,25,28
19798,0,0,2,2,4
19799,1,2,4,20,27
19800,0,1,4,9,14
19801,0,0,9,18,27
19802,0,1,1,11,13
19803,0,0,5,4,9
19804,0,0,11,16,27
19805,0,1,14,29,44
19806,0,0,9,11,20
19807,0,0,9,22,31
19808,0,0,4,14,18
19809,0,0,3,12,15
19810,0,0,3,8,11
19811,1,0,16,30,47
19812,0,0,0,7,7
19813,0,0,6,28,34
19814,0,0,2,13,15
19815,0,1,2,13,16
19816,0,0,10,15,25
19817,0,0,7,12,19
19819,1,3,9,20,33
19820,0,4,9,24,37
19821,0,0,2,12,14
19822,0,0,2,6,8
19823,0,0,10,22,32
19824,0,0,2,6,8
19825,0,2,8,21,31
19826,0,1,9,16,26
19827,0,0,3,9,12
19828,0,0,7,7,14
19829,1,2,10,31,44
19830,0,0,2,7,9
19831,0,0,6,6,12
19832,1,0,9,22,32
19833,0,0,3,9,12
19834,0,0,0,6,6
19835,0,0,11,22,33
19836,0,0,3,9,12
19838,0,0,0,7,7
19839,0,0,0,6,6
19840,0,0,0,2,2
19841,0,1,4,15,20
19842,0,0,0,9,9
19843,0,0,3,6,9
19845,0,0,7,8,15
19846,0,0,2,3,5
19847,1,2,5,42,50
19848,0,0,5,7,12
19849,0,0,1,5,6
19850,0,0,2,18,20
19851,0,0,9,32,41
19852,0,0,6,13,19
19853,0,0,7,19,26
19854,0,0,4,6,10
19855,1,0,5,35,41
19856,0,0,3,12,15
19857,0,0,12,11,23
19858,0,1,2,13,16
19860,0,0,5,10,15
19861,0,0,0,7,7
19862,0,1,7,14,22
19863,0,0,4,29,33
19864,0,0,7,8,15
19865,1,0,1,1,3
19866,0,0,1,6,7
19867,0,0,0,1,1
19868,0,0,9,31,40
19869,0,0,4,8,12
19870,0,0,8,13,21
19871,0,0,16,25,41
19873,0,0,0,6,6
19874,1,0,1,8,10
19875,0,3,4,40,47
19877,0,1,4,4,9
19878,0,0,2,10,12
19880,0,0,1,4,5
19881,0,0,0,6,6
19883,1,0,2,7,10
19884,0,0,6,16,22
19885,0,5,2,8,15
19886,0,0,2,5,7
19887,0,0,2,8,10
19888,8,0,3,33,44
19889,0,0,7,4,11
19890,0,2,3,3,8
19891,0,0,4,13,17
19892,0,0,1,4,5
19893,1,1,2,2,6
19894,0,0,15,35,50
19895,0,0,6,11,17
19897,0,0,15,35,50
19898,0,0,10,22,32
19899,0,0,2,19,21
19900,1,0,11,18,30
19901,0,0,7,23,30
19902,1,1,11,36,49
19903,1,0,4,25,30
19904,0,0,12,30,42
19905,0,0,5,16,21
19906,0,1,1,19,21
19907,0,0,11,24,35
19908,0,0,10,26,36
19909,0,5,1,12,18
19910,0,1,12,23,36
19911,0,0,7,43,50
19912,0,0,11,21,32
19913,1,0,5,16,22
19914,0,0,7,18,25
19915,0,0,10,29,39
19916,0,0,1,3,4
19917,0,2,6,42,50
19918,0,0,2,39,41
19919,0,0,10,21,31
19920,0,0,1,7,8
19921,0,0,8,10,18
19922,0,0,5,16,21
19923,0,0,0,2,2
19924,1,0,8,17,26
19925,0,1,4,4,9
19927,0,1,8,19,28
19928,1,0,2,8,11
19929,0,1,10,36,47
19930,0,1,2,11,14
19931,0,1,15,33,49
19932,0,0,6,44,50
19933,0,2,0,12,14
19934,0,0,8,24,32
19935,0,0,3,15,18
19936,0,0,4,15,19
19937,0,0,8,9,17
19938,0,0,7,21,28
19939,0,0,10,27,37
19940,0,2,3,28,33
19941,0,0,10,7,17
19942,2,0,3,6,11
19943,0,0,3,3,6
19944,0,0,7,11,18
19945,0,0,1,42,43
19946,0,0,3,7,10
19948,0,0,2,14,16
19949,0,0,13,24,37
19950,0,1,1,10,12
19951,0,1,7,36,44
19952,0,0,4,14,18
19953,1,0,9,25,35
19954,0,0,5,19,24
19955,0,4,6,30,40
19956,0,0,2,3,5
19957,0,2,8,39,49
19958,0,1,4,18,23
19959,0,0,7,18,25
19960,1,1,0,12,14
19961,0,0,5,12,17
19962,0,1,3,6,10
19963,0,0,3,23,26
19964,0,1,5,17,23
19965,0,0,8,22,30
19966,1,0,6,26,33
19967,0,0,4,46,50
19968,0,1,4,25,30
19969,0,1,2,13,16
19970,0,0,7,17,24
19971,0,0,15,25,40
19972,0,1,10,39,50
19973,0,0,14,25,39
19974,0,0,3,9,12
19975,0,1,5,12,18
19976,0,0,6,18,24
19977,1,0,7,36,44
19978,0,0,11,23,34
19979,0,0,15,32,47
19980,0,0,2,7,9
19981,0,0,1,8,9
19982,0,0,7,32,39
19983,0,0,4,24,28
19984,1,0,7,8,16
19986,0,1,15,31,47
19987,0,0,3,18,21
19988,0,0,10,19,29
19989,0,2,6,19,27
19990,0,2,3,8,13
19991,0,0,1,4,5
19992,0,0,7,4,11
19993,1,0,2,30,33
19994,1,0,5,25,31
19995,1,0,6,13,20
19996,1,0,8,28,37
19997,0,0,1,11,12
19998,0,0,7,13,20
19999,1,0,19,30,50
20001,0,0,5,10,15
20002,1,2,13,22,38
20003,0,0,3,45,48
20004,0,0,15,31,46
20005,0,2,2,18,22
20006,0,1,3,12,16
20007,0,0,0,4,4
20008,0,4,1,13,18
20009,0,0,7,9,16
20010,8,0,3,33,44
20011,3,0,1,15,19
20012,3,0,4,40,47
20013,0,0,4,11,15
20014,0,0,1,39,40
20015,0,0,4,5,9
20017,1,0,9,12,22
20018,0,1,8,25,34
20019,1,0,0,11,12
20020,0,0,2,5,7
20021,0,0,8,39,47
20022,0,1,2,17,20
20023,0,0,7,10,17
20024,0,3,4,40,47
20025,0,0,12,26,38
20026,0,1,0,10,11
20027,2,7,5,31,45
20028,0,1,2,25,28
20029,1,0,10,21,32
20030,5,1,6,29,41
20031,0,0,11,33,44
20032,0,0,6,16,22
20033,0,0,15,35,50
20034,1,0,9,11,21
20035,0,0,1,20,21
20036,0,0,2,8,10
20037,0,0,2,47,49
20038,1,1,8,32,42
20039,2,0,2,26,30
20040,1,2,5,42,50
20041,1,0,5,14,20
20042,0,0,10,27,37
20043,1,0,16,30,47
20044,0,0,2,5,7
20045,0,1,4,9,14
20046,2,0,5,21,28
20047,0,0,0,6,6
20048,0,0,19,25,44
20049,1,0,4,25,30
20050,0,0,1,14,15
20051,0,2,0,12,14
20052,0,3,4,40,47
20053,0,1,4,20,25
20054,0,0,0,4,4
20055,0,0,2,39,41
20056,0,0,5,16,21
20057,0,3,1,11,15
20058,0,0,0,17,17
20059,0,1,3,22,26
20060,0,0,0,13,13
20061,0,1,3,25,29
20062,0,1,19,30,50
20063,1,1,0,12,14
20064,0,4,6,30,40
20065,0,0,11,28,39
20066,0,0,1,9,10
20067,0,0,6,16,22
20068,4,0,2,14,20
20069,1,1,8,32,42
20070,0,0,4,34,38
20071,2,0,5,21,28
20072,0,1,10,39,50
20073,0,1,2,8,11
20074,1,0,4,15,20
20075,1,0,5,14,20
20076,2,3,0,25,30
20077,0,0,8,42,50
20078,0,0,1,5,6
20079,8,0,3,33,44
20080,0,0,7,4,11
20081,0,0,11,32,43
20082,1,0,3,22,26
20083,1,0,19,30,50
20084,0,0,0,16,16
20085,0,0,7,43,50
20086,0,0,12,38,50
20087,1,0,9,25,35
20088,0,0,15,35,50
20089,1,0,4,15,20
20090,0,0,1,35,36
20091,0,1,1,19,21
20092,1,0,2,30,33
20093,5,1,6,29,41
20094,2,0,2,26,30
20095,5,1,6,29,41
20096,0,0,11,33,44
20097,2,0,2,26,30
20098,1,2,5,42,50
20099,1,0,4,15,20
20100,0,0,2,8,10
20101,1,0,19,30,50
20102,0,0,12,38,50
20103,0,2,3,3,8
20104,0,0,6,15,21
20105,0,1,7,24,32
20106,0,1,6,33,40
20107,0,0,6,5,11
20108,0,0,4,9,13
20109,0,0,7,11,18
20110,0,1,2,9,12
20111,0,0,3,13,16
20112,1,1,14,19,35
20113,0,0,8,11,19
20114,0,0,12,22,34
20115,1,0,1,14,16
20116,2,1,1,18,22
20117,0,0,2,9,11
20118,0,0,9,31,40
20119,0,0,5,11,16
20120,0,0,7,10,17
20121,0,0,7,17,24
20122,0,0,4,17,21
20123,1,0,5,30,36
20124,0,0,4,8,12
20126,0,0,5,8,13
20127,1,1,6,28,36
20128,1,1,8,21,31
20129,0,0,4,19,23
20130,0,0,9,19,28
20131,0,0,14,22,36
20132,0,0,13,28,41
20133,0,1,5,8,14
20134,0,0,0,10,10
20135,0,0,7,14,21
20136,0,0,2,2,4
20137,0,0,7,21,28
20138,0,0,3,29,32
20139,0,0,14,10,24
20140,0,0,1,6,7
20141,0,0,1,10,11
20143,0,0,12,26,38
20144,0,1,3,8,12
20145,0,0,1,6,7
20146,0,0,3,14,17
20147,1,1,3,14,19
20148,0,0,7,3,10
20149,0,0,6,7,13
20150,0,0,2,6,8
20151,0,0,6,8,14
20152,0,0,4,25,29
20153,0,0,1,9,10
20154,0,0,5,11,16
20155,0,0,2,9,11
20156,0,1,10,36,47
20157,0,0,4,9,13
20158,0,0,6,16,22
20159,0,0,0,7,7
20160,0,0,6,8,14
20161,0,0,2,9,11
20162,0,0,2,3,5
20163,0,1,7,7,15
20164,1,0,11,32,44
20165,0,0,4,10,14
20166,0,0,5,5,10
20167,1,1,1,14,17
20168,1,0,6,20,27
20169,0,0,5,4,9
20170,0,0,4,8,12
20171,0,0,11,13,24
20172,1,1,2,15,19
20173,0,4,8,37,49
20174,0,2,5,15,22
20175,0,0,5,7,12
20176,0,0,5,11,16
20177,0,0,9,28,37
20178,0,0,4,13,17
20179,0,0,14,21,35
20180,0,0,6,5,11
20181,0,1,11,24,36
20182,0,0,13,19,32
20183,0,0,5,17,22
20184,0,0,10,12,22
20185,0,1,7,16,24
20186,0,3,5,11,19
20187,0,0,1,12,13
20188,0,0,1,10,11
20189,0,0,4,15,19
20190,0,0,4,5,9
20191,0,0,7,12,19
20192,0,0,3,11,14
20193,1,0,9,14,24
20194,0,0,7,10,17
20195,0,0,4,9,13
20197,0,0,16,19,35
20198,0,0,8,15,23
20199,0,0,6,12,18
20200,0,0,10,17,27
20202,0,0,2,9,11
20203,0,0,9,14,23
20204,1,3,4,15,23
20205,0,0,8,17,25
20206,0,0,3,10,13
20208,0,0,7,13,20
20209,0,0,6,15,21
20210,0,0,6,13,19
20211,0,0,7,11,18
20212,0,0,0,8,8
20213,0,1,11,10,22
20214,0,0,6,15,21
20215,0,5,7,14,26
20216,0,0,9,26,35
20217,0,1,1,10,12
20218,0,0,5,5,10
20219,0,0,0,7,7
20220,0,0,4,14,18
20221,0,0,4,14,18
20222,0,1,7,21,29
20223,0,0,6,8,14
20224,0,1,7,24,32
20225,0,0,7,3,10
20226,1,0,1,12,14
20227,0,0,8,11,19
20228,0,1,4,12,17
20229,0,0,4,4,8
20230,0,0,0,5,5
20232,1,0,5,21,27
20234,0,0,3,19,22
20235,0,0,10,29,39
20236,0,0,4,1,5
20237,0,0,6,25,31
20238,0,0,3,8,11
20239,0,0,0,3,3
20240,0,0,4,4,8
20241,0,0,5,17,22
20242,0,0,7,8,15
20243,0,2,5,43,50
20244,0,0,8,15,23
20245,0,1,11,21,33
20246,1,0,4,14,19
20247,0,0,12,26,38
20248,1,1,3,9,14
20249,0,0,4,21,25
20250,0,0,6,5,11
20251,1,1,8,6,16
20252,1,1,5,13,20
20253,0,0,10,7,17
20254,0,0,1,7,8
20255,1,0,11,22,34
20256,1,1,6,27,35
20257,0,0,0,1,1
20258,0,1,6,8,15
20259,0,1,2,7,10
20260,0,0,2,7,9
20261,0,0,4,13,17
20262,0,0,4,3,7
20263,0,0,9,18,27
20265,0,0,4,14,18
20266,0,0,6,19,25
20267,0,0,7,18,25
20268,0,0,7,12,19
20269,0,0,14,18,32
20270,0,0,0,3,3
20271,0,0,19,19,38
20272,0,0,9,8,17
20273,0,1,6,11,18
20275,0,1,2,5,8
20276,0,0,3,8,11
20277,0,0,5,4,9
20279,1,0,2,23,26
20280,1,0,7,14,22
20282,0,0,3,11,14
20283,0,0,12,26,38
20284,0,0,0,5,5
20286,0,5,2,16,23
20287,0,0,5,14,19
20289,0,0,1,11,12
20290,0,0,8,22,30
20291,1,2,2,16,21
20292,0,0,0,5,5
20293,0,0,6,6,12
20294,0,0,4,11,15
20295,0,0,3,14,17
20296,0,0,4,8,12
20297,0,1,7,17,25
20298,0,0,8,18,26
20299,0,0,3,16,19
20301,1,0,2,11,14
20302,0,0,0,8,8
20303,0,1,0,25,26
20304,0,0,0,6,6
20305,0,0,2,4,6
20306,0,2,0,13,15
20307,0,1,2,9,12
20308,1,0,1,11,13
20310,0,0,4,4,8
20311,2,1,10,28,41
20312,0,0,4,4,8
20313,0,0,0,12,12
20314,0,0,6,27,33
20315,0,0,1,12,13
20316,2,0,1,6,9
20317,0,0,6,9,15
20318,0,1,4,15,20
20319,0,0,4,18,22
20320,0,0,5,1,6
20321,0,1,0,3,4
20323,0,1,6,33,40
20324,0,0,2,5,7
20325,0,0,9,19,28
20326,0,0,6,15,21
20327,0,0,6,15,21
20329,0,0,4,17,21
20330,2,0,0,4,6
20331,0,0,0,7,7
20332,0,1,5,13,19
20333,0,0,6,9,15
20334,2,1,6,39,48
20335,0,0,7,10,17
20336,1,0,3,30,34
20337,2,1,1,18,22
20338,0,0,10,26,36
20339,0,0,3,14,17
20340,0,1,7,16,24
20341,1,0,5,30,36
20342,0,0,7,9,16
20343,0,1,9,27,37
20344,0,1,17,32,50
20345,0,0,7,26,33
20346,0,2,0,13,15
20348,0,0,10,22,32
20349,0,0,14,22,36
20350,0,0,1,8,9
20351,2,0,11,28,41
20352,0,1,2,20,23
20353,0,0,1,15,16
20354,1,0,18,31,50
20355,0,0,16,33,49
20356,0,1,12,13,26
20357,0,0,7,31,38
20358,0,0,7,17,24
20359,0,0,12,30,42
20360,0,0,4,13,17
20361,0,0,2,9,11
20362,0,0,2,15,17
20363,0,0,11,30,41
20364,0,1,3,26,30
20365,0,1,10,38,49
20366,0,1,11,34,46
20367,0,0,4,4,8
20368,0,0,7,22,29
20369,0,0,6,13,19
20370,0,1,3,12,16
20371,0,0,2,7,9
20372,0,0,4,8,12
20373,1,0,1,11,13
20374,0,0,15,22,37
20375,1,0,18,31,50
20376,0,0,6,3,9
20377,0,0,1,12,13
20378,0,0,8,24,32
20379,0,0,0,12,12
20380,0,0,5,16,21
20381,0,1,10,11,22
20382,0,0,8,14,22
20383,0,0,2,11,13
20384,0,0,1,18,19
20385,0,0,14,32,46
20386,0,0,7,11,18
20387,2,0,14,17,33
20388,0,0,11,15,26
20389,2,0,1,6,9
20391,0,0,0,10,10
20392,0,0,13,29,42
20393,0,0,5,19,24
20394,1,1,13,35,50
20395,1,0,5,17,23
20397,0,0,9,8,17
20398,0,0,3,21,24
20399,0,0,6,9,15
20400,0,0,4,9,13
20401,0,1,6,31,38
20402,1,0,6,14,21
20403,0,0,3,12,15
20404,0,1,1,12,14
20405,0,0,10,29,39
20406,3,0,1,16,20
20407,0,0,6,18,24
20408,0,0,3,9,12
20409,0,0,6,15,21
20410,0,1,9,40,50
20411,0,0,5,11,16
20412,0,0,1,7,8
20413,0,0,3,11,14
20414,0,0,10,25,35
20416,0,0,2,15,17
20417,0,1,8,41,50
20418,1,1,3,5,10
20419,0,0,3,8,11
20420,0,2,6,26,34
20421,0,0,6,8,14
20422,0,0,0,9,9
20424,0,0,8,27,35
20425,0,0,6,23,29
20426,0,0,5,33,38
20427,0,0,3,5,8
20428,0,0,0,13,13
20429,3,1,4,13,21
20430,0,2,4,13,19
20432,0,2,0,10,12
20434,1,1,6,28,36
20435,0,0,1,6,7
20436,0,0,6,12,18
20437,0,0,0,3,3
20438,0,2,6,28,36
20440,0,0,11,8,19
20441,0,1,8,29,38
20442,1,1,2,19,23
20443,0,0,7,12,19
20444,0,0,6,27,33
20445,0,0,6,9,15
20446,0,0,5,1,6
20447,0,0,4,21,25
20448,0,1,18,26,45
20449,0,0,1,12,13
20450,0,0,10,15,25
20451,0,0,4,18,22
20452,0,0,9,8,17
20453,0,1,0,3,4
20454,1,0,11,22,34
20455,0,0,6,15,21
20456,0,0,0,7,7
20457,0,0,9,19,28
20458,0,1,6,33,40
20459,0,0,2,6,8
20460,0,0,3,46,49
20461,0,0,1,29,30
20462,0,1,17,32,50
20463,0,1,1,11,13
20464,0,2,0,10,12
20465,0,0,0,14,14
20466,5,1,5,39,50
20467,0,0,1,3,4
20468,0,2,0,13,15
20469,2,1,1,18,22
20470,0,2,9,24,35
20471,0,1,5,16,22
20472,0,0,14,32,46
20473,0,2,2,38,42
20474,0,2,4,14,20
20475,0,0,7,11,18
20476,0,0,0,12,12
20477,1,0,2,14,17
20478,0,0,10,40,50
20479,1,0,5,17,23
20481,0,2,6,28,36
20482,0,1,1,12,14
20483,0,3,5,11,19
20484,0,0,2,5,7
20485,0,1,0,3,4
20486,0,1,0,25,26
20487,0,0,2,6,8
20488,0,0,0,5,5
20489,0,0,8,17,25
20490,1,0,8,33,42
20491,1,1,2,19,23
20492,0,2,0,10,12
20493,0,2,2,23,27
20494,0,2,5,31,38
20495,0,0,0,16,16
20496,0,0,1,22,23
20497,2,0,0,4,6
20499,0,0,2,6,8
20501,0,0,1,7,8
20502,0,1,6,33,40
20503,0,0,2,6,8
20504,4,1,3,19,27
20505,0,1,4,15,20
20506,1,0,11,22,34
20507,0,0,1,7,8
20508,0,0,5,4,9
20509,0,0,2,6,8
20510,0,0,7,26,33
20511,0,0,7,9,16
20512,0,0,1,7,8
20513,0,1,0,3,4
20514,0,0,6,27,33
20515,0,0,11,8,19
20516,0,0,4,21,25
20517,0,3,5,11,19
20518,0,1,6,31,38
20519,4,1,3,19,27
20520,0,0,5,13,18
20521,0,0,5,4,9
20522,0,0,4,14,18
20523,0,0,7,15,22
20524,0,0,8,4,12
20525,1,0,2,2,5
20526,0,0,4,3,7
20527,0,0,0,5,5
20528,0,0,2,5,7
20529,0,2,9,38,49
20531,0,0,0,1,1
20532,1,1,0,25,27
20533,0,0,10,26,36
20534,1,1,5,35,42
20535,0,2,6,25,33
20536,0,0,4,14,18
20537,0,1,9,32,42
20538,0,2,7,24,33
20539,0,1,8,41,50
20540,0,0,3,17,20
20541,0,0,7,10,17
20542,0,0,12,22,34
20543,0,0,3,24,27
20544,0,0,3,27,30
20545,0,2,14,33,49
20546,0,0,9,37,46
20547,0,0,1,6,7
20548,0,0,5,34,39
20549,0,0,2,9,11
20550,0,0,4,15,19
20551,0,0,1,4,5
20552,0,0,2,15,17
20554,0,0,8,16,24
20555,0,0,1,6,7
20556,0,0,12,27,39
20557,0,0,3,24,27
20558,0,0,2,12,14
20559,0,0,13,21,34
20560,0,1,1,11,13
20561,0,0,1,15,16
20562,0,0,9,11,20
20563,0,0,6,4,10
20564,0,0,7,13,20
20565,0,1,4,10,15
20566,0,0,8,14,22
20567,0,0,3,6,9
20568,0,0,10,27,37
20569,0,0,7,22,29
20570,0,1,11,35,47
20571,1,0,10,26,37
20572,1,0,1,7,9
20573,0,0,1,7,8
20574,0,0,1,8,9
20575,0,1,11,29,41
20576,0,0,7,3,10
20577,1,0,2,11,14
20578,0,0,9,21,30
20579,0,0,13,22,35
20580,0,0,6,4,10
20581,0,0,3,13,16
20582,0,1,2,6,9
20583,0,0,14,32,46
20584,0,1,1,33,35
20585,0,0,0,9,9
20586,0,1,10,14,25
20588,0,0,3,8,11
20589,0,0,2,7,9
20590,0,0,18,27,45
20591,0,2,9,17,28
20592,0,0,0,8,8
20593,0,0,0,15,15
20594,0,0,1,11,12
20595,0,0,14,27,41
20596,0,0,5,10,15
20597,0,0,5,8,13
20598,0,0,1,6,7
20599,0,0,4,5,9
20600,0,2,10,36,48
20603,0,0,11,4,15
20604,0,0,5,9,14
20605,0,0,0,6,6
20606,1,0,19,21,41
20607,0,0,0,15,15
20608,0,3,4,32,39
20610,0,0,1,13,14
20612,0,0,6,16,22
20613,0,0,14,25,39
20614,0,0,10,12,22
20615,0,0,6,15,21
20616,0,0,11,24,35
20617,0,0,4,8,12
20618,0,0,9,30,39
20619,0,0,17,33,50
20620,0,0,3,13,16
20621,0,1,11,35,47
20623,0,0,6,1,7
20624,0,0,8,21,29
20625,0,0,1,5,6
20626,0,0,3,20,23
20627,1,1,4,24,30
20628,1,0,4,30,35
20629,0,0,10,12,22
20631,0,0,14,25,39
20632,0,0,2,10,12
20633,0,0,9,18,27
20634,0,1,0,19,20
20635,0,0,10,17,27
20636,0,0,14,26,40
20637,0,0,8,21,29
20638,0,0,5,7,12
20639,0,0,5,13,18
20640,0,0,2,2,4
20642,0,0,9,11,20
20643,0,0,7,4,11
20644,0,0,9,17,26
20645,0,0,4,3,7
20646,1,0,5,42,48
20647,0,1,17,32,50
20648,0,0,3,14,17
20649,0,0,5,9,14
20650,0,0,1,5,6
20651,1,0,2,9,12
20652,0,0,12,26,38
20653,0,0,11,21,32
20654,0,0,4,14,18
20655,2,0,7,23,32
20656,0,0,5,17,22
20657,0,0,6,8,14
20658,1,0,1,8,10
20659,0,0,4,17,21
20660,0,0,9,17,26
20661,0,0,7,8,15
20662,0,0,7,4,11
20663,0,0,4,13,17
20665,0,0,12,25,37
20666,0,2,7,13,22
20667,0,1,6,8,15
20668,0,2,0,15,17
20669,0,0,5,14,19
20670,0,0,14,16,30
20671,0,0,11,21,32
20672,0,0,4,13,17
20673,0,0,7,14,21
20674,0,0,0,7,7
20675,0,0,7,22,29
20676,0,0,4,13,17
20677,0,0,3,10,13
20678,0,1,6,8,15
20680,0,0,10,19,29
20681,2,0,0,17,19
20682,0,0,3,21,24
20683,1,0,3,7,11
20684,0,1,7,17,25
20685,0,0,5,9,14
20686,0,0,5,11,16
20687,0,0,3,8,11
20688,0,0,5,13,18
20689,0,0,8,9,17
20690,0,1,13,36,50
20691,0,0,6,7,13
20692,0,3,2,9,14
20693,0,0,1,16,17
20694,0,1,8,8,17
20695,0,0,5,9,14
20696,0,0,4,5,9
20697,0,0,3,13,16
20698,0,0,2,27,29
20699,0,0,15,15,30
20700,0,0,10,15,25
20701,0,1,4,13,18
20702,1,0,10,18,29
20703,0,3,9,20,32
20704,0,0,4,18,22
20705,0,0,11,34,45
20706,0,0,3,9,12
20707,1,0,8,27,36
20708,0,2,19,28,49
20709,0,0,11,26,37
20710,0,0,11,21,32
20711,0,0,7,17,24
20712,0,0,5,13,18
20713,0,0,0,3,3
20714,1,0,11,30,42
20715,0,0,1,7,8
20716,0,1,1,7,9
20717,0,1,5,13,19
20718,0,1,15,34,50
20719,0,0,7,4,11
20720,0,2,5,22,29
20721,1,0,5,6,12
20722,0,0,9,21,30
20723,0,0,5,38,43
20724,0,0,5,1,6
20725,0,0,0,3,3
20726,0,1,0,10,11
20727,1,0,6,25,32
20728,0,2,13,35,50
20729,0,0,3,19,22
20730,0,0,3,4,7
20731,0,0,2,7,9
20732,0,0,4,4,8
20733,0,0,16,31,47
20734,0,0,7,19,26
20735,0,1,8,33,42
20736,0,0,7,34,41
20737,0,0,11,6,17
20738,0,0,6,11,17
20739,0,1,4,8,13
20740,0,0,2,6,8
20741,0,0,1,20,21
20742,0,0,0,6,6
20743,0,0,4,9,13
20744,0,1,5,21,27
20745,2,0,11,16,29
20746,2,0,3,36,41
20747,0,0,9,17,26
20748,0,0,9,25,34
20749,0,0,9,17,26
20750,0,0,7,18,25
20751,0,0,9,15,24
20752,0,0,8,9,17
20753,0,0,4,15,19
20754,0,1,8,14,23
20755,0,3,2,33,38
20756,0,0,9,24,33
20757,0,0,4,30,34
20758,0,0,3,10,13
20759,0,1,11,37,49
20760,1,1,3,25,30
20761,0,2,10,25,37
20762,0,0,9,1,10
20763,0,0,4,7,11
20764,0,0,8,9,17
20765,0,0,11,23,34
20766,0,0,5,13,18
20767,0,1,6,20,27
20768,0,3,4,37,44
20769,0,0,1,11,12
20770,0,0,4,15,19
20772,2,1,10,28,41
20773,0,1,7,28,36
20774,0,0,9,15,24
20775,0,3,10,26,39
20776,1,0,7,16,24
20777,0,0,3,21,24
20778,0,0,5,12,17
20779,0,0,0,1,1
20783,0,0,14,19,33
20784,1,0,10,38,49
20785,5,0,0,10,15
20786,0,0,9,15,24
20787,0,1,4,2,7
20788,0,0,12,22,34
20789,3,0,1,5,9
20790,0,1,7,28,36
20791,0,0,8,35,43
20792,0,0,3,5,8
20793,0,0,12,34,46
20794,0,0,0,7,7
20795,1,2,6,14,23
20796,1,0,6,20,27
20797,0,0,1,18,19
20798,0,0,5,5,10
20799,0,0,6,15,21
20800,0,0,15,15,30
20801,0,0,13,25,38
20802,0,0,5,5,10
20803,0,0,2,4,6
20804,0,0,16,11,27
20806,0,0,8,19,27
20807,0,0,6,6,12
20808,0,0,6,7,13
20809,0,0,2,0,2
20810,0,0,6,15,21
20811,0,0,4,8,12
20812,0,0,4,8,12
20813,0,0,1,6,7
20815,0,0,7,3,10
20816,0,0,2,2,4
20817,0,1,3,7,11
20818,1,3,16,27,47
20819,0,0,9,20,29
20820,0,0,4,9,13
20821,0,1,5,10,16
20822,0,0,1,5,6
20823,0,0,12,15,27
20824,0,0,3,24,27
20825,0,0,5,10,15
20826,0,0,3,18,21
20827,0,0,9,19,28
20828,2,0,6,41,49
20829,0,0,10,14,24
20830,0,0,7,17,24
20831,0,0,8,12,20
20832,0,0,2,7,9
20833,1,0,4,19,24
20835,0,0,1,7,8
20836,0,0,3,6,9
20837,1,0,7,41,49
20839,0,0,2,17,19
20840,0,0,2,7,9
20841,3,0,1,3,7
20842,0,0,3,12,15
20843,0,0,11,7,18
20844,0,0,6,11,17
20845,0,0,7,6,13
20846,0,0,0,7,7
20847,0,1,2,6,9
20849,0,0,2,10,12
20850,0,0,3,6,9
20851,0,0,11,12,23
20853,0,0,8,8,16
20854,0,0,6,8,14
20855,0,0,6,12,18
20856,0,2,5,16,23
20857,0,0,2,3,5
20858,0,0,5,3,8
20859,0,0,1,4,5
20860,0,0,8,13,21
20862,0,0,1,6,7
20863,0,0,0,14,14
20864,0,2,9,35,46
20865,0,0,6,9,15
20866,0,0,13,36,49
20867,0,0,0,25,25
20868,0,0,6,19,25
20869,3,0,1,5,9
20870,0,0,14,8,22
20871,0,0,6,8,14
20872,0,1,0,4,5
20873,0,0,8,10,18
20874,0,0,5,42,47
20875,0,0,3,18,21
20876,0,0,0,14,14
20877,0,0,7,12,19
20878,0,0,2,4,6
20879,0,0,9,11,20
20880,0,0,1,8,9
20881,0,0,3,16,19
20882,0,0,6,8,14
20883,0,0,5,8,13
20884,0,0,11,14,25
20885,0,1,21,28,50
20886,0,0,3,5,8
20887,1,0,11,35,47
20888,0,0,7,9,16
20889,0,1,0,13,14
20890,0,0,9,12,21
20891,0,0,4,6,10
20892,0,0,5,17,22
20893,0,0,5,7,12
20894,0,0,6,5,11
20895,1,0,8,8,17
20896,0,0,8,18,26
20898,0,0,4,4,8
20899,0,0,4,10,14
20900,1,0,4,4,9
20901,0,0,7,9,16
20902,0,0,4,19,23
20903,1,1,3,17,22
20904,0,0,4,6,10
20905,0,0,1,11,12
20906,0,0,2,4,6
20907,0,0,3,7,10
20908,0,0,11,10,21
20909,0,1,5,23,29
20910,0,0,6,11,17
20911,0,1,12,10,23
20912,0,0,10,21,31
20913,0,0,7,6,13
20914,1,0,2,8,11
20915,0,0,7,12,19
20916,0,0,6,6,12
20917,0,1,14,31,46
20918,0,0,1,2,3
20919,0,0,6,11,17
20920,1,0,0,4,5
20921,0,0,4,7,11
20922,0,1,1,8,10
20923,0,0,1,4,5
20925,0,0,4,18,22
20926,0,0,0,6,6
20927,0,0,4,7,11
20928,0,2,12,24,38
20930,0,0,7,20,27
20931,0,0,6,11,17
20932,0,0,4,25,29
20934,0,0,10,24,34
20935,0,0,9,13,22
20937,0,0,0,5,5
20939,0,0,4,7,11
20940,0,0,4,17,21
20945,0,0,2,6,8
20946,0,3,13,33,49
20947,1,1,1,24,27
20949,0,0,0,5,5
20950,0,0,4,8,12
20953,0,0,2,10,12
20955,0,0,0,10,10
20956,0,2,6,21,29
20957,0,2,15,33,50
20958,0,0,4,4,8
20959,1,0,2,27,30
20960,0,0,1,6,7
20961,0,0,0,36,36
20962,0,1,4,4,9
20963,1,0,20,25,46
20964,1,1,11,11,24
20965,0,1,9,12,22
20966,1,0,2,2,5
20967,0,0,8,16,24
20968,0,1,4,9,14
20969,0,0,10,27,37
20970,0,3,19,22,44
20971,2,0,2,11,15
20972,0,0,6,9,15
20973,2,0,0,11,13
20974,1,0,3,20,24
20975,1,2,5,42,50
20976,0,0,5,9,14
20977,0,1,4,9,14
20978,1,0,0,34,35
20979,0,0,3,23,26
20980,1,2,10,11,24
20981,3,0,1,10,14
20982,0,1,6,12,19
20983,0,0,0,6,6
20985,0,0,0,1,1
20986,1,1,0,25,27
20987,0,2,0,23,25
20988,0,0,4,3,7
20989,1,2,3,6,12
20990,0,1,1,10,12
20991,0,4,0,31,35
20992,0,1,4,32,37
20993,0,2,6,25,33
20994,0,3,9,37,49
20995,0,0,3,17,20
20996,0,1,4,12,17
20997,2,1,7,17,27
20998,0,1,8,41,50
20999,0,0,10,25,35
21000,0,1,10,33,44
21001,0,0,7,10,17
21002,0,0,9,13,22
21003,0,1,7,17,25
21004,0,0,13,36,49
21005,0,0,9,19,28
21006,0,1,10,23,34
21007,1,0,14,24,39
21008,2,0,11,37,50
21009,0,1,2,7,10
21010,0,0,13,25,38
21011,0,0,8,6,14
21012,0,1,3,18,22
21013,0,0,11,15,26
21014,0,1,11,28,40
21015,1,0,8,18,27
21016,0,0,5,22,27
21017,1,1,9,39,50
21018,0,0,9,26,35
21019,0,1,12,18,31
21020,0,2,6,21,29
21021,0,0,3,13,16
21022,0,0,10,36,46
21023,0,0,12,22,34
21024,0,0,7,26,33
21025,0,0,6,15,21
21026,0,1,4,4,9
21027,1,2,5,36,44
21028,0,0,2,22,24
21029,0,1,4,17,22
21030,0,1,4,10,15
21032,0,1,10,20,31
21033,0,1,5,15,21
21034,0,0,3,13,16
21035,0,0,11,25,36
21036,0,0,8,32,40
21037,0,1,6,25,32
21038,0,0,2,19,21
21039,0,1,9,40,50
21040,2,0,16,24,42
21041,0,0,1,6,7
21042,0,0,6,7,13
21043,0,0,2,15,17
21044,0,0,4,24,28
21045,0,0,1,22,23
21046,0,0,12,23,35
21047,0,0,2,8,10
21048,0,0,7,12,19
21049,0,0,14,33,47
21050,0,0,12,15,27
21051,0,0,5,19,24
21052,0,0,1,29,30
21053,0,2,7,41,50
21054,0,1,1,8,10
21055,0,0,13,31,44
21056,0,0,7,18,25
21058,0,0,4,3,7
21059,0,0,17,33,50
21060,0,0,5,14,19
21061,0,0,5,12,17
21062,0,0,8,10,18
21063,0,0,6,16,22
21064,0,0,16,34,50
21065,0,0,10,26,36
21066,0,0,2,29,31
21067,0,0,6,19,25
21068,0,0,0,15,15
21069,0,0,10,24,34
21070,0,0,9,23,32
21071,1,1,6,22,30
21072,1,0,1,13,15
21073,0,0,12,27,39
21074,0,0,11,20,31
21075,0,0,3,9,12
21076,1,0,19,18,38
21077,0,2,3,42,47
21078,0,0,5,18,23
21079,1,0,6,38,45
21080,0,0,4,8,12
21081,1,0,4,29,34
21082,0,1,18,31,50
21083,0,1,1,17,19
21084,0,0,5,18,23
21085,0,0,5,32,37
21086,0,0,3,23,26
21087,2,0,14,29,45
21088,0,0,12,26,38
21089,0,0,5,40,45
21090,0,1,11,26,38
21091,0,0,6,7,13
21092,0,1,4,41,46
21093,0,0,7,5,12
21094,0,0,2,13,15
21095,1,0,10,33,44
21096,1,1,9,21,32
21097,0,0,1,12,13
21098,0,2,16,32,50
21099,0,0,17,18,35
21100,0,0,0,6,6
21102,0,0,5,7,12
21103,2,0,6,42,50
21104,0,1,7,18,26
21105,0,0,16,31,47
21106,0,1,17,32,50
21107,0,0,7,14,21
21108,0,0,8,20,28
21109,0,0,6,2,8
21110,0,0,4,22,26
21111,0,0,9,24,33
21112,0,1,5,2,8
21113,0,0,1,10,11
21114,0,0,5,17,22
21115,0,0,9,17,26
21116,0,0,6,8,14
21117,0,1,13,13,27
21118,0,0,9,8,17
21119,0,0,8,15,23
21120,0,0,13,37,50
21121,1,0,2,12,15
21122,0,4,3,24,31
21123,0,0,13,18,31
21124,0,0,1,20,21
21125,1,0,8,32,41
21127,0,0,8,10,18
21128,0,0,15,13,28
21129,0,1,9,17,27
21130,0,0,15,30,45
21132,0,0,7,43,50
21133,0,0,10,20,30
21134,0,1,9,12,22
21135,0,2,7,25,34
21136,0,0,2,8,10
21137,0,0,10,40,50
21138,0,0,9,16,25
21139,1,0,20,25,46
21140,0,0,6,16,22
21141,0,0,0,6,6
21142,0,0,11,14,25
21143,1,0,21,28,50
21144,0,0,5,9,14
21145,0,0,9,13,22
21146,0,0,7,34,41
21147,0,1,7,15,23
21148,1,0,4,9,14
21149,0,0,8,33,41
21150,0,0,9,27,36
21152,0,0,1,5,6
21153,0,0,13,37,50
21154,0,0,0,1,1
21155,0,1,4,9,14
21156,0,1,3,18,22
21157,0,1,5,44,50
21158,0,1,16,28,45
21159,0,0,13,26,39
21160,0,0,9,14,23
21161,0,0,8,19,27
21162,0,1,8,39,48
21163,0,0,5,23,28
21164,0,0,6,15,21
21165,1,1,8,32,42
21166,1,0,10,17,28
21167,0,0,9,27,36
21168,0,1,10,33,44
21169,0,0,8,7,15
21170,0,0,22,19,41
21171,0,0,0,7,7
21172,0,1,6,11,18
21174,0,0,7,9,16
21175,0,0,13,35,48
21176,0,0,8,10,18
21177,0,0,0,6,6
21178,0,0,11,23,34
21180,0,0,2,24,26
21181,2,3,5,29,39
21182,0,0,1,7,8
21183,2,0,6,14,22
21184,0,0,10,27,37
21185,2,0,12,34,48
21186,0,0,1,5,6
21188,0,1,5,3,9
21189,0,2,9,38,49
21190,0,2,4,5,11
21191,0,1,0,6,7
21192,0,1,12,25,38
21193,1,0,7,21,29
21194,1,1,11,37,50
21195,1,0,7,21,29
21196,0,1,14,28,43
21197,0,0,20,30,50
21198,0,0,6,14,20
21199,0,0,5,13,18
21200,0,0,6,9,15
21201,0,0,5,10,15
21203,0,0,4,32,36
21204,0,0,2,24,26
21205,0,0,6,9,15
21206,2,1,5,13,21
21207,0,0,6,19,25
21208,0,0,5,11,16
21209,0,0,18,13,31
21210,0,0,11,14,25
21212,0,1,12,32,45
21213,0,1,17,28,46
21214,1,0,0,16,17
21215,0,1,9,17,27
21216,1,2,10,11,24
21217,0,0,20,25,45
21218,0,0,2,10,12
21219,0,0,7,28,35
21220,0,0,1,1,2
21221,0,0,3,4,7
21222,0,0,4,1,5
21223,1,0,5,36,42
21224,2,0,13,35,50
21225,0,0,7,16,23
21226,0,0,7,39,46
21227,0,1,5,18,24
21228,0,0,9,16,25
21229,0,1,12,23,36
21230,0,0,2,8,10
21231,0,1,8,26,35
21232,0,0,11,21,32
21233,0,0,5,2,7
21234,0,1,6,12,19
21235,0,0,6,12,18
21236,1,1,4,17,23
21237,0,0,10,32,42
21238,0,0,12,17,29
21241,0,0,1,5,6
21243,0,0,4,29,33
21244,1,1,10,38,50
21245,0,0,8,11,19
21246,0,0,0,5,5
21247,0,0,2,15,17
21248,0,0,1,4,5
21249,1,0,1,4,6
21250,0,0,10,19,29
21251,0,0,12,36,48
21252,0,0,2,6,8
21253,0,0,3,12,15
21254,0,0,2,14,16
21255,1,0,2,27,30
21256,0,0,10,27,37
21257,2,0,1,7,10
21258,0,0,6,8,14
21259,0,0,4,4,8
21261,0,2,7,24,33
21262,0,0,2,10,12
21263,0,0,4,9,13
21264,0,0,4,30,34
21265,0,0,5,4,9
21266,0,0,9,25,34
21267,0,0,0,36,36
21268,1,0,2,2,5
21269,0,0,4,4,8
21270,0,0,5,13,18
21271,0,0,1,20,21
21272,0,1,5,28,34
21273,0,0,0,5,5
21274,0,0,9,19,28
21275,1,1,11,11,24
21276,2,0,2,11,15
21277,5,0,0,10,15
21278,0,0,1,18,19
21279,1,0,10,38,49
21280,0,1,4,9,14
21281,0,0,2,8,10
21282,0,0,9,17,26
21283,1,0,2,5,8
21284,0,0,4,16,20
21285,3,0,1,3,7
21286,0,0,0,7,7
21287,0,0,5,9,14
21288,0,0,3,8,11
21289,1,0,0,34,35
21291,0,0,3,23,26
21292,0,2,12,24,38
21293,1,0,3,20,24
21294,0,0,7,15,22
21295,1,2,5,42,50
21296,0,4,0,31,35
21297,0,0,0,1,1
21298,0,0,2,47,49
21299,0,2,0,23,25
21300,1,0,0,4,5
21301,1,0,2,8,11
21302,0,0,7,13,20
21303,0,0,12,38,50
21304,0,2,0,6,8
21305,1,1,8,39,49
21306,2,1,7,17,27
21307,1,0,10,15,26
21308,0,2,16,32,50
21309,0,2,1,13,16
21310,0,1,2,16,19
21311,1,0,10,26,37
21312,0,1,0,16,17
21313,0,2,9,25,36
21314,0,2,2,17,21
21315,0,0,1,10,11
21316,0,0,1,13,14
21317,0,0,2,19,21
21318,0,2,0,14,16
21319,1,1,9,37,48
21320,2,0,10,38,50
21321,0,1,1,8,10
21323,0,0,5,40,45
21324,0,1,7,38,46
21325,0,1,0,7,8
21326,0,0,8,19,27
21327,0,1,14,27,42
21328,1,0,4,9,14
21329,1,0,2,12,15
21330,0,0,1,10,11
21331,1,0,5,19,25
21332,0,0,11,19,30
21333,5,0,12,33,50
21334,0,1,5,28,34
21335,2,0,6,14,22
21336,0,0,9,30,39
21337,0,0,13,32,45
21338,0,0,10,19,29
21339,0,0,5,11,16
21340,1,1,8,32,42
21341,0,0,5,23,28
21343,0,0,6,13,19
21344,1,0,3,13,17
21345,0,0,7,8,15
21346,0,0,1,9,10
21347,0,0,2,6,8
21348,3,0,1,10,14
21349,0,0,12,17,29
21350,0,0,17,31,48
21351,0,0,0,5,5
21352,0,0,4,14,18
21353,0,0,0,10,10
21355,0,0,5,19,24
21356,0,0,0,6,6
21358,2,2,5,36,45
21359,1,0,0,34,35
21360,0,1,4,12,17
21361,1,0,8,40,49
21362,0,0,2,14,16
21363,2,1,12,34,49
21364,0,1,5,28,34
21365,0,0,1,12,13
21366,0,0,4,21,25
21367,0,4,0,31,35
21368,2,0,9,38,49
21369,0,0,0,10,10
21370,1,0,0,34,35
21371,2,0,8,25,35
21372,0,0,7,26,33
21373,0,0,20,30,50
21374,2,0,9,38,49
21375,0,0,3,4,7
21376,0,2,15,33,50
21377,1,2,5,42,50
21378,0,0,13,36,49
21379,0,0,2,8,10
21380,2,0,9,38,49
21381,2,1,12,34,49
21382,1,1,11,11,24
21383,1,1,2,2,6
21384,0,0,8,16,24
21385,0,0,7,10,17
21386,0,0,5,11,16
21387,0,1,12,17,30
21388,0,0,3,15,18
21389,0,0,2,2,4
21390,0,0,7,14,21
21391,0,0,8,21,29
21392,0,0,3,11,14
21393,0,0,4,5,9
21394,1,2,11,29,43
21395,0,0,4,6,10
21396,0,0,5,12,17
21397,0,0,0,6,6
21398,0,0,7,9,16
21399,0,0,5,12,17
21400,0,0,6,7,13
21401,2,0,1,9,12
21402,0,1,0,8,9
21403,0,0,4,31,35
21404,0,0,0,9,9
21407,0,0,12,21,33
21408,0,0,8,27,35
21409,0,0,6,9,15
21410,0,0,3,8,11
21411,0,0,14,31,45
21412,0,0,9,18,27
21413,0,0,0,3,3
21414,0,0,1,9,10
21415,0,0,1,5,6
21416,0,0,6,6,12
21417,0,0,0,2,2
21418,0,0,2,3,5
21419,0,0,2,7,9
21420,0,2,9,39,50
21421,0,0,12,15,27
21422,1,1,2,2,6
21423,1,0,8,20,29
21424,0,0,7,9,16
21425,0,0,4,15,19
21427,0,0,11,18,29
21428,0,0,11,16,27
21429,0,0,5,8,13
21430,0,1,4,21,26
21431,0,0,1,6,7
21432,0,0,3,14,17
21433,0,0,5,20,25
21434,0,0,10,24,34
21435,0,0,7,14,21
21436,0,0,2,17,19
21437,0,0,6,18,24
21438,0,0,20,27,47
21439,0,0,8,16,24
21440,0,2,5,22,29
21441,0,1,3,27,31
21442,2,0,1,6,9
21443,0,0,8,15,23
21444,0,0,7,19,26
21446,0,0,7,7,14
21447,0,0,19,15,34
21448,0,0,10,38,48
21449,1,1,2,11,15
21450,0,1,11,33,45
21451,0,0,3,7,10
21452,0,1,5,18,24
21453,0,0,4,5,9
21454,1,0,6,17,24
21455,1,0,3,10,14
21456,0,0,6,15,21
21457,0,0,1,6,7
21458,1,0,12,25,38
21459,0,0,6,6,12
21460,1,0,18,29,48
21461,0,1,7,7,15
21462,0,3,12,26,41
21463,0,0,1,4,5
21464,0,0,1,4,5
21465,0,0,9,4,13
21466,0,1,7,24,32
21468,0,0,7,8,15
21469,0,1,13,17,31
21470,0,0,2,12,14
21471,0,2,0,14,16
21472,0,0,10,10,20
21473,0,0,3,5,8
21474,0,0,9,14,23
21475,0,0,0,8,8
21476,0,0,3,17,20
21477,0,0,5,9,14
21478,1,0,6,21,28
21479,0,0,2,8,10
21481,0,2,0,6,8
21482,0,1,10,18,29
21483,0,0,6,24,30
21484,1,0,5,18,24
21485,0,0,3,6,9
21486,0,0,7,7,14
21487,0,0,0,5,5
21488,0,2,2,12,16
21489,0,0,5,1,6
21490,0,0,7,10,17
21491,0,0,5,7,12
21493,0,1,2,29,32
21494,0,0,7,9,16
21495,0,0,10,23,33
21496,0,0,0,1,1
21497,1,0,7,14,22
21498,0,1,5,13,19
21499,0,0,1,2,3
21500,0,0,4,3,7
21501,1,0,9,28,38
21502,0,0,4,5,9
21503,0,0,7,10,17
21504,0,0,6,21,27
21505,0,0,3,13,16
21506,0,0,3,9,12
21507,2,0,2,46,50
21508,0,0,0,9,9
21509,0,0,9,11,20
21510,0,1,5,10,16
21511,0,0,12,22,34
21512,0,0,1,9,10
21513,0,3,10,11,24
21514,0,0,0,6,6
21515,0,0,8,9,17
21516,0,0,0,9,9
21517,0,0,13,25,38
21518,0,1,2,9,12
21519,0,1,9,26,36
21520,0,0,6,6,12
21521,1,0,8,18,27
21522,2,0,7,13,22
21523,1,0,2,13,16
21524,1,0,3,20,24
21525,0,0,0,6,6
21527,0,0,1,4,5
21529,0,0,1,6,7
21530,0,0,1,0,1
21532,0,0,4,10,14
21534,0,0,7,8,15
21535,0,1,4,13,18
21537,0,0,3,22,25
21538,0,0,1,14,15
21539,0,0,4,18,22
21540,0,0,1,4,5
21541,0,0,0,10,10
21543,0,0,8,9,17
21544,0,1,8,41,50
21545,0,0,1,20,21
21546,0,0,1,12,13
21547,0,0,7,16,23
21548,8,0,3,33,44
21549,1,1,11,11,24
21550,0,1,10,19,30
21552,0,1,14,29,44
21553,0,0,8,13,21
21554,0,3,8,30,41
21555,0,3,9,26,38
21556,0,0,9,17,26
21557,0,1,8,41,50
21558,0,0,12,13,25
21559,0,0,12,37,49
21560,0,0,9,25,34
21561,0,0,3,46,49
21562,0,0,3,8,11
21563,0,0,7,7,14
21564,0,0,9,33,42
21565,0,0,8,17,25
21566,0,0,0,8,8
21567,0,0,7,14,21
21568,0,1,12,17,30
21569,0,0,8,5,13
21570,0,2,3,27,32
21571,0,0,2,7,9
21572,0,0,7,17,24
21573,0,1,7,9,17
21574,0,0,11,30,41
21575,0,0,9,18,27
21576,1,1,3,45,50
21577,0,0,7,31,38
21578,0,0,10,14,24
21580,0,0,16,24,40
21581,1,0,1,5,7
21582,0,0,11,6,17
21583,0,2,11,25,38
21584,1,0,8,20,29
21585,0,2,9,39,50
21586,0,0,12,32,44
21587,0,0,11,18,29
21588,0,1,3,17,21
21589,0,0,5,17,22
21590,0,0,8,17,25
21591,0,0,3,5,8
21592,0,0,0,7,7
21593,0,0,1,10,11
21594,0,0,2,11,13
21595,1,0,12,21,34
21596,2,0,0,6,8
21597,0,0,11,24,35
21598,0,0,2,7,9
21599,1,0,8,36,45
21600,0,1,6,43,50
21601,0,0,6,4,10
21602,1,0,5,17,23
21603,4,0,2,10,16
21604,1,1,8,28,38
21605,3,1,3,14,21
21606,0,0,3,22,25
21607,0,1,9,32,42
21608,3,0,5,12,20
21609,0,0,8,9,17
21610,0,0,18,32,50
21613,0,0,9,22,31
21614,0,0,3,27,30
21615,0,0,3,31,34
21616,0,0,4,9,13
21617,0,0,2,17,19
21618,0,1,18,26,45
21620,0,0,12,32,44
21621,0,0,1,8,9
21622,0,0,22,25,47
21623,1,1,0,20,22
21624,0,0,17,21,38
21625,0,0,10,15,25
21626,0,1,11,29,41
21627,0,0,10,15,25
21628,0,0,0,3,3
21629,0,0,4,10,14
21630,0,0,0,1,1
21631,0,1,11,11,23
21632,0,0,1,8,9
21633,0,0,11,21,32
21634,0,0,5,8,13
21635,1,0,14,22,37
21636,0,0,4,8,12
21637,0,1,4,22,27
21638,0,0,8,5,13
21639,0,0,4,3,7
21640,0,0,3,8,11
21641,0,1,0,18,19
21642,0,1,8,29,38
21643,0,1,6,14,21
21644,1,0,12,21,34
21645,0,0,4,10,14
21646,0,0,10,15,25
21647,0,1,3,12,16
21648,0,0,10,11,21
21649,0,0,7,16,23
21650,0,0,1,2,3
21652,0,0,1,6,7
21653,1,0,1,13,15
21654,6,0,3,15,24
21655,0,0,9,34,43
21656,1,0,2,13,16
21657,0,0,1,4,5
21658,0,0,6,21,27
21659,0,0,3,3,6
21660,1,1,3,17,22
21663,0,2,11,36,49
21664,0,0,3,11,14
21665,0,2,5,26,33
21666,0,0,4,18,22
21667,2,0,1,6,9
21668,0,0,2,2,4
21670,0,0,1,20,21
21671,0,0,1,6,7
21672,0,0,0,6,6
21673,1,1,11,11,24
21674,0,0,7,16,23
21675,8,0,3,33,44
21676,0,0,2,8,10
21677,1,0,3,20,24
21678,0,1,10,19,30
21679,0,2,0,6,8
21681,0,1,6,20,27
21682,0,0,5,15,20
21683,0,0,8,28,36
21684,0,3,8,30,41
21685,0,0,0,10,10
21686,0,0,2,11,13
21687,1,0,1,5,7
21688,0,0,7,25,32
21689,0,2,1,28,31
21690,0,0,0,8,8
21691,1,3,3,37,44
21692,0,0,0,5,5
21693,0,0,14,36,50
21694,0,1,6,43,50
21695,1,0,1,19,21
21696,0,0,1,21,22
21697,0,0,1,9,10
21698,4,0,2,10,16
21699,0,0,1,14,15
21701,0,0,7,20,27
21702,0,0,10,22,32
21703,0,0,5,19,24
21704,1,0,10,28,39
21705,1,1,0,20,22
21706,4,0,10,34,48
21707,0,0,1,6,7
21709,0,0,3,3,6
21710,0,0,0,1,1
21711,8,0,3,33,44
21712,0,1,3,27,31
21714,4,0,10,34,48
21715,0,2,11,36,49
21716,0,0,3,31,34
21718,0,0,0,10,10
21719,0,1,10,19,30
21721,0,0,1,5,6
21722,0,0,6,4,10
21723,0,0,0,1,1
21724,0,0,5,4,9
21725,0,1,6,33,40
21727,0,0,4,1,5
21728,0,0,6,7,13
21729,0,0,5,16,21
21730,0,0,6,2,8
21731,0,2,11,35,48
21732,0,0,4,14,18
21733,0,1,3,8,12
21734,0,0,6,29,35
21735,0,0,4,14,18
21736,0,0,9,31,40
21737,0,0,6,7,13
21738,0,0,1,8,9
21739,0,0,8,27,35
21740,0,0,17,22,39
21741,0,0,11,15,26
21742,0,0,1,5,6
21743,0,0,9,7,16
21744,0,0,1,12,13
21745,1,1,4,41,47
21746,0,1,2,23,26
21747,0,1,10,30,41
21748,0,0,4,12,16
21749,1,1,10,34,46
21750,4,0,4,15,23
21753,1,2,4,35,42
21754,0,0,2,6,8
21755,0,1,0,8,9
21756,0,0,5,3,8
21757,0,0,9,13,22
21758,0,0,4,6,10
21759,0,0,4,9,13
21760,0,0,15,26,41
21761,0,0,10,24,34
21762,0,0,3,12,15
21763,1,0,4,5,10
21764,0,1,9,14,24
21765,1,0,4,17,22
21766,0,0,1,9,10
21767,0,0,6,22,28
21768,2,0,1,10,13
21769,0,0,6,14,20
21770,0,0,2,7,9
21771,0,0,10,29,39
21772,0,1,13,18,32
21773,2,1,10,36,49
21774,0,1,4,22,27
21775,1,0,5,17,23
21776,0,0,11,4,15
21777,0,0,1,5,6
21778,1,0,8,12,21
21779,1,1,8,9,19
21781,0,0,3,13,16
21782,0,0,4,3,7
21783,0,0,1,14,15
21784,0,4,8,9,21
21785,0,0,10,19,29
21786,0,0,2,12,14
21787,6,1,2,28,37
21788,0,0,8,21,29
21789,0,0,1,3,4
21791,0,0,2,8,10
21792,0,0,9,17,26
21793,0,0,2,8,10
21794,0,0,3,1,4
21795,0,0,6,21,27
21796,0,0,9,12,21
21797,0,0,4,6,10
21798,1,1,1,11,14
21799,0,0,11,35,46
21800,0,2,10,22,34
21801,0,0,6,15,21
21802,0,0,10,15,25
21803,0,0,7,38,45
21805,0,0,6,18,24
21806,0,0,4,12,16
21807,1,1,5,21,28
21808,0,0,0,8,8
21809,0,0,13,19,32
21810,0,1,6,21,28
21811,0,0,4,7,11
21812,1,0,3,10,14
21813,1,0,17,31,49
21814,0,0,8,11,19
21815,0,0,4,11,15
21816,0,0,3,7,10
21817,1,1,11,9,22
21818,0,0,9,13,22
21819,0,0,13,28,41
21820,0,0,9,11,20
21821,1,0,1,16,18
21822,0,0,7,26,33
21823,0,0,5,13,18
21824,1,0,4,12,17
21825,0,0,4,5,9
21826,0,0,1,7,8
21827,0,1,5,6,12
21828,0,0,9,12,21
21829,1,1,6,21,29
21830,0,0,14,36,50
21832,0,0,6,12,18
21833,0,1,9,18,28
21834,0,0,17,9,26
21836,0,0,12,18,30
21837,0,1,1,21,23
21838,0,0,4,18,22
21839,1,0,9,33,43
21840,0,1,6,9,16
21841,0,0,0,5,5
21842,0,0,2,12,14
21843,0,0,2,18,20
21844,1,0,3,10,14
21845,1,0,6,15,22
21846,0,0,2,4,6
21847,0,1,14,16,31
21848,0,1,11,24,36
21850,1,1,13,27,42
21851,1,0,4,36,41
21852,1,0,3,16,20
21853,0,1,5,20,26
21854,0,0,6,5,11
21855,0,0,5,13,18
21856,0,0,3,20,23
21857,0,0,12,15,27
21858,0,0,6,15,21
21859,0,0,0,4,4
21861,0,0,12,38,50
21862,0,0,7,8,15
21863,2,0,5,8,15
21865,0,2,11,36,49
21866,0,0,1,8,9
21867,1,0,7,20,28
21868,0,0,4,21,25
21869,0,1,3,10,14
21870,0,0,7,14,21
21871,0,1,5,16,22
21872,0,0,11,25,36
21873,0,0,5,5,10
21874,0,0,11,29,40
21875,0,0,3,9,12
21876,0,0,4,18,22
21877,0,0,10,27,37
21878,0,0,0,5,5
21879,0,0,5,13,18
21880,0,0,5,3,8
21881,0,0,6,7,13
21882,0,1,3,15,19
21883,0,0,9,16,25
21884,0,0,3,3,6
21885,0,0,4,8,12
21886,0,0,1,3,4
21887,0,0,8,11,19
21888,1,1,10,27,39
21889,0,0,6,9,15
21890,0,2,4,10,16
21891,0,0,6,4,10
21892,0,0,3,12,15
21893,0,0,1,11,12
21894,0,0,7,9,16
21895,0,0,1,7,8
21896,0,0,3,17,20
21897,0,0,5,1,6
21898,0,0,3,4,7
21899,7,0,0,11,18
21900,0,1,3,8,12
21901,0,0,10,18,28
21902,0,0,1,18,19
21903,0,0,7,15,22
21904,0,0,1,7,8
21905,1,0,5,15,21
21906,0,1,4,30,35
21907,0,0,6,13,19
21908,0,0,5,18,23
21909,0,0,7,9,16
21910,0,1,7,20,28
21911,0,1,11,38,50
21912,0,0,5,11,16
21913,0,1,0,17,18
21914,0,0,4,5,9
21915,0,0,2,3,5
21916,2,1,10,28,41
21917,0,0,10,18,28
21918,0,0,3,5,8
21919,0,0,5,18,23
21920,0,0,1,6,7
21921,0,0,13,9,22
21922,0,0,5,17,22
21923,0,0,5,12,17
21925,0,2,10,37,49
21926,0,1,15,22,38
21927,0,0,0,1,1
21928,0,0,7,8,15
21929,0,0,8,18,26
21930,0,2,18,29,49
21931,0,0,0,5,5
21932,1,1,5,10,17
21933,0,0,5,15,20
21934,0,0,14,35,49
21935,0,0,8,35,43
21936,1,0,3,7,11
21937,0,0,12,29,41
21938,0,0,17,33,50
21939,1,0,12,17,30
21940,0,0,3,10,13
21941,0,0,6,19,25
21942,0,0,5,19,24
21943,3,0,9,33,45
21944,1,2,8,15,26
21946,0,0,5,9,14
21947,0,1,4,11,16
21948,0,0,4,6,10
21949,0,0,1,4,5
21950,0,0,5,14,19
21951,0,0,0,5,5
21952,0,0,23,18,41
21953,0,0,0,8,8
21954,0,0,0,5,5
21955,2,0,7,26,35
21957,0,0,4,4,8
21958,0,0,12,8,20
21959,0,0,8,13,21
21960,0,0,5,8,13
21961,0,0,0,1,1
21962,0,3,5,42,50
21963,0,0,1,15,16
21964,0,0,2,12,14
21965,0,0,8,14,22
21966,0,0,4,14,18
21967,0,0,9,18,27
21968,0,0,6,5,11
21969,0,1,0,4,5
21970,0,1,7,11,19
21971,0,1,3,14,18
21972,0,0,5,27,32
21974,0,0,10,10,20
21975,0,0,3,5,8
21976,2,0,10,22,34
21978,0,0,7,16,23
21979,0,0,5,16,21
21980,0,0,1,11,12
21982,0,0,0,20,20
21983,0,2,7,14,23
21984,0,0,6,14,20
21985,0,0,6,17,23
21986,0,0,7,18,25
21987,0,0,7,10,17
21988,0,0,9,12,21
21989,1,0,15,23,39
21990,0,1,6,8,15
21991,1,0,2,25,28
21992,0,0,5,13,18
21994,0,1,11,36,48
21995,0,0,1,10,11
21996,0,0,17,17,34
21997,1,0,3,19,23
21998,0,0,8,26,34
22000,0,0,12,25,37
22001,1,0,4,28,33
22002,0,1,6,42,49
22003,0,0,13,33,46
22004,0,0,5,3,8
22005,0,1,4,13,18
22006,0,5,6,8,19
22008,0,0,1,13,14
22009,0,0,1,5,6
22010,0,0,4,12,16
22011,0,0,6,8,14
22012,0,0,5,14,19
22013,0,0,3,3,6
22014,0,0,6,15,21
22015,1,0,1,17,19
22016,0,0,5,13,18
22017,0,0,6,16,22
22018,1,0,6,29,36
22019,0,1,7,12,20
22020,0,0,1,3,4
22021,1,0,12,35,48
22022,0,1,1,9,11
22023,1,0,9,7,17
22024,0,0,5,14,19
22025,0,0,5,12,17
22026,0,0,19,31,50
22027,0,0,5,4,9
22028,0,0,2,5,7
22029,0,0,12,17,29
22030,0,1,6,9,16
22031,0,0,2,8,10
22032,0,0,0,13,13
22033,0,0,4,7,11
22034,0,0,5,20,25
22035,0,1,6,33,40
22036,0,0,5,18,23
22038,0,0,6,5,11
22039,0,5,2,8,15
22040,0,0,5,6,11
22041,1,0,6,20,27
22042,0,0,9,10,19
22044,1,0,3,10,14
22045,0,0,5,9,14
22046,4,0,4,23,31
22047,3,0,2,14,19
22048,0,0,6,5,11
22050,0,0,2,3,5
22052,0,0,1,17,18
22053,0,0,13,19,32
22055,0,0,1,7,8
22056,1,0,7,42,50
22057,0,0,1,12,13
22058,0,0,0,7,7
22059,2,0,0,11,13
22060,0,0,0,13,13
22061,0,0,0,1,1
22062,0,0,2,7,9
22064,0,0,10,20,30
22065,0,0,0,1,1
22067,0,0,1,5,6
22068,0,0,8,19,27
22070,0,0,5,9,14
22071,0,0,3,33,36
22074,0,0,8,19,27
22075,0,0,6,5,11
22076,0,1,6,13,20
22077,0,1,0,12,13
22079,0,1,0,3,4
22080,0,2,7,25,34
22081,0,0,0,7,7
22082,0,1,7,12,20
22084,1,0,3,10,14
22086,0,0,8,16,24
22087,0,0,0,3,3
22088,1,2,3,6,12
22089,1,0,0,12,13
22090,0,0,9,18,27
22093,0,2,0,11,13
22094,0,1,11,12,24
22095,0,0,13,7,20
22096,0,1,8,15,24
22098,0,0,7,15,22
22099,0,0,5,11,16
22100,0,0,1,1,2
22101,0,3,1,4,8
22103,0,0,2,19,21
22104,4,1,7,38,50
22106,0,0,1,6,7
22107,0,0,6,31,37
22112,1,1,6,23,31
22113,0,1,4,6,11
22114,0,4,18,28,50
22115,0,2,15,33,50
22116,0,1,2,25,28
22117,0,0,2,11,13
22118,0,0,1,20,21
22119,0,0,6,4,10
22120,0,0,6,8,14
22122,1,0,3,16,20
22123,0,2,0,6,8
22126,0,0,9,8,17
22127,0,1,10,35,46
22128,1,1,11,11,24
22129,0,1,2,5,8
22130,1,0,11,22,34
22131,0,0,1,7,8
22132,1,2,5,42,50
22133,0,1,6,28,35
22135,0,0,6,2,8
22136,1,0,0,9,10
22137,0,1,2,9,12
22138,0,0,4,11,15
22139,0,2,11,35,48
22140,5,0,0,15,20
22141,0,0,6,19,25
22142,0,0,0,1,1
22143,0,0,0,5,5
22144,0,0,0,1,1
22146,0,1,4,5,10
22147,0,0,3,18,21
22148,0,1,1,30,32
22149,1,3,10,29,43
22150,0,0,5,3,8
22151,0,0,2,8,10
22152,0,1,3,44,48
22153,2,0,7,26,35
22154,0,1,13,34,48
22155,0,0,5,19,24
22156,0,0,8,11,19
22157,0,1,1,16,18
22158,0,1,4,33,38
22159,1,0,16,33,50
22160,0,3,1,16,20
22161,0,0,9,23,32
22162,1,1,3,31,36
22163,0,0,2,19,21
22164,0,0,5,13,18
22165,0,0,9,7,16
22167,0,1,4,34,39
22169,0,0,9,23,32
22170,0,0,9,13,22
22171,0,1,5,43,49
22172,0,0,6,27,33
22173,1,0,6,18,25
22174,0,0,9,26,35
22175,0,0,14,33,47
22176,0,0,3,1,4
22177,0,0,2,4,6
22178,0,0,5,14,19
22179,0,3,5,18,26
22180,0,1,4,15,20
22181,0,0,12,37,49
22182,0,1,9,20,30
22183,0,0,2,15,17
22184,0,0,11,21,32
22186,0,0,4,9,13
22187,0,1,13,18,32
22188,0,0,5,14,19
22189,2,0,5,8,15
22190,0,0,5,34,39
22191,4,0,3,19,26
22192,0,0,5,19,24
22193,1,1,16,27,45
22194,0,0,18,31,49
22195,0,0,9,16,25
22196,2,0,8,14,24
22197,0,0,0,5,5
22198,1,0,9,30,40
22199,0,0,3,21,24
22200,0,0,12,38,50
22201,0,0,1,20,21
22202,0,1,1,48,50
22203,0,1,5,17,23
22204,0,1,0,11,12
22205,1,0,0,12,13
22206,0,1,4,29,34
22207,1,0,9,19,29
22208,2,1,1,17,21
22209,0,0,0,5,5
22210,1,0,3,5,9
22211,2,1,2,25,30
22212,0,1,1,3,5
22213,1,0,14,34,49
22214,1,1,4,34,40
22215,2,2,1,45,50
22216,0,0,3,15,18
22217,0,0,4,9,13
22218,0,1,11,29,41
22219,0,0,5,4,9
22220,0,0,2,10,12
22221,1,0,9,19,29
22222,1,0,3,5,9
22223,1,0,1,12,14
22224,0,1,4,29,34
22225,0,0,0,5,5
22227,2,0,6,25,33
22228,0,0,6,14,20
22229,0,0,1,3,4
22230,1,0,0,17,18
22231,0,0,11,29,40
22232,2,1,6,29,38
22233,0,1,10,35,46
22234,0,0,8,19,27
22235,0,0,7,4,11
22236,0,0,14,18,32
22237,0,0,1,13,14
22238,0,0,5,10,15
22239,0,0,2,15,17
22240,0,1,2,23,26
22241,0,0,5,3,8
22242,0,0,8,9,17
22243,0,0,13,14,27
22244,0,1,5,11,17
22245,1,0,2,5,8
22246,1,0,14,32,47
22248,1,1,6,35,43
22249,0,0,7,4,11
22250,2,0,13,35,50
22251,1,0,5,25,31
22252,0,0,8,8,16
22253,1,0,0,17,18
22254,0,0,7,3,10
22255,0,0,6,6,12
22256,0,0,0,8,8
22257,0,0,4,4,8
22258,1,0,11,22,34
22259,0,0,1,8,9
22260,0,0,6,7,13
22261,0,0,3,4,7
22262,0,2,0,6,8
22264,1,1,11,11,24
22265,1,1,5,10,17
22266,0,0,0,5,5
22267,1,1,2,7,11
22268,5,0,0,15,20
22269,0,0,0,1,1
22270,0,1,0,3,4
22271,1,0,7,42,50
22272,1,0,0,9,10
22274,2,2,1,15,20
22275,1,1,5,11,18
22276,0,0,2,42,44
22278,0,0,12,37,49
22279,0,0,5,10,15
22280,0,0,1,31,32
22281,0,0,2,8,10
22282,0,0,0,6,6
22283,0,0,4,15,19
22284,1,0,8,12,21
22285,1,1,10,38,50
22286,1,0,2,6,9
22287,0,1,4,22,27
22288,0,2,11,36,49
22289,1,3,10,29,43
22290,1,0,9,19,29
22291,1,0,1,47,49
22292,1,0,1,7,9
22293,0,2,15,33,50
22294,3,0,1,12,16
22295,0,0,1,7,8
22296,0,0,2,6,8
22298,0,0,3,4,7
22299,0,1,1,11,13
22300,1,2,5,42,50
22301,0,0,2,15,17
22302,0,1,0,3,4
22303,0,0,6,22,28
22304,0,0,6,19,25
22305,0,2,11,36,49
22306,0,0,3,14,17
22307,0,2,4,30,36
22308,0,3,3,15,21
22309,0,2,4,14,20
22310,0,0,0,10,10
22311,0,0,12,8,20
22312,0,0,9,4,13
22313,0,0,4,8,12
22314,0,0,1,13,14
22315,0,0,5,24,29
22316,0,0,3,0,3
22317,0,0,1,6,7
22319,0,1,6,13,20
22320,1,0,2,6,9
22321,0,0,5,0,5
22322,0,0,3,8,11
22323,1,4,6,28,39
22324,0,2,10,17,29
22326,0,0,5,4,9
22327,0,0,16,30,46
22328,0,0,3,6,9
22329,0,1,16,14,31
22330,0,0,3,6,9
22331,0,0,6,5,11
22332,0,1,9,8,18
22333,0,0,4,8,12
22334,0,0,5,3,8
22335,0,0,5,3,8
22336,0,1,3,13,17
22337,0,2,4,15,21
22338,0,0,9,10,19
22339,0,0,4,5,9
22340,0,0,2,4,6
22341,0,1,16,14,31
22342,0,0,2,5,7
22343,0,0,8,6,14
22344,0,0,1,5,6
22345,0,0,4,13,17
22346,0,1,6,19,26
22347,0,0,3,3,6
22348,0,0,5,3,8
22349,0,0,0,15,15
22350,0,0,2,5,7
22351,0,0,1,4,5
22352,0,1,2,3,6
22353,1,0,1,10,12
22354,0,0,2,2,4
22356,0,0,4,5,9
22357,0,0,4,8,12
22358,0,0,1,4,5
22359,0,0,0,5,5
22360,0,0,0,5,5
22361,0,2,7,12,21
22362,0,0,4,8,12
22363,0,0,2,4,6
22364,0,0,0,5,5
22366,1,0,6,30,37
22367,1,2,5,30,38
22368,0,0,10,11,21
22369,0,3,3,15,21
22370,0,1,16,25,42
22371,1,1,8,40,50
22372,0,1,10,28,39
22373,0,0,11,34,45
22374,0,0,5,29,34
22375,2,1,10,17,30
22376,0,0,17,22,39
22377,0,0,2,7,9
22378,0,0,13,34,47
22380,0,0,12,5,17
22381,0,4,13,33,50
22382,1,1,14,29,45
22383,3,0,3,23,29
22384,0,0,5,10,15
22385,0,0,0,7,7
22386,0,0,7,23,30
22387,0,0,1,6,7
22388,0,0,12,26,38
22389,0,0,3,3,6
22390,0,1,2,3,6
22391,0,0,2,3,5
22392,0,0,7,20,27
22393,0,4,13,33,50
22394,0,0,0,7,7
22395,0,0,2,4,6
22396,0,1,10,28,39
22397,0,0,5,29,34
22398,0,0,11,34,45
22399,1,0,1,9,11
22400,0,0,12,26,38
22401,0,0,3,8,11
22402,0,0,3,11,14
22403,1,1,8,40,50
22404,0,0,7,20,27
22405,0,1,10,12,23
22406,0,1,1,10,12
22407,0,0,4,8,12
22408,0,3,3,15,21
22409,0,0,4,8,12
22411,0,0,10,21,31
22412,0,0,2,9,11
22413,0,0,4,13,17
22414,0,0,4,1,5
22415,3,0,3,23,29
22416,0,0,13,18,31
22417,0,0,4,15,19
22418,0,0,9,4,13
22419,0,1,6,15,22
22420,0,0,1,6,7
22421,0,1,6,19,26
22422,0,0,10,21,31
22423,0,0,1,13,14
22424,0,0,7,11,18
22425,0,0,4,8,12
22426,0,0,1,7,8
22427,0,0,8,17,25
22428,0,0,20,30,50
22429,0,0,7,23,30
22430,0,0,5,14,19
22431,0,0,2,3,5
22432,1,4,6,28,39
22433,0,1,1,7,9
22434,3,0,3,23,29
22435,0,1,10,24,35
22436,0,1,10,22,33
22437,0,0,20,28,48
22438,0,0,5,13,18
22439,0,0,4,32,36
22440,0,1,8,11,20
22441,0,0,2,10,12
22442,0,2,16,30,48
22443,0,0,2,10,12
22444,0,0,4,13,17
22445,0,0,8,17,25
22446,0,0,2,6,8
22447,0,0,0,5,5
22448,0,0,5,28,33
22449,0,0,3,2,5
22450,0,0,14,36,50
22451,0,0,3,8,11
22452,0,0,4,4,8
22453,0,0,4,32,36
22454,0,0,4,10,14
22455,0,0,6,8,14
22456,0,0,4,9,13
22457,0,2,6,26,34
22458,0,0,5,14,19
22459,0,0,8,8,16
22460,1,0,5,23,29
22461,0,0,4,10,14
22462,0,0,2,10,12
22463,0,0,3,11,14
22464,0,0,7,7,14
22465,0,0,1,4,5
22466,0,0,1,16,17
22468,0,0,4,4,8
22469,0,0,4,9,13
22470,0,0,7,7,14
22471,0,0,11,22,33
22472,0,2,6,26,34
22473,0,2,11,9,22
22474,0,0,2,10,12
22475,0,0,3,11,14
22476,0,3,2,8,13
22477,0,0,2,9,11
22478,0,0,4,5,9
22479,0,0,4,12,16
22480,0,0,2,3,5
22481,0,0,5,14,19
22483,0,0,1,7,8
22484,1,0,5,24,30
22485,0,0,2,26,28
22486,0,0,2,5,7
22487,0,0,7,19,26
22488,0,0,4,5,9
22489,0,0,5,10,15
22491,0,0,2,6,8
22493,0,0,4,13,17
22494,0,0,9,15,24
22496,0,0,2,10,12
22497,0,0,3,3,6
22498,0,0,4,9,13
22499,0,0,6,4,10
22500,0,0,3,17,20
22501,1,0,3,4,8
22502,0,0,6,15,21
22503,0,0,0,7,7
22504,0,0,0,5,5
22505,0,0,7,5,12
22506,0,0,7,15,22
22507,0,0,5,6,11
22508,0,0,0,5,5
22509,1,1,14,29,45
22510,0,0,2,10,12
22511,0,0,3,3,6
22513,0,0,8,8,16
22516,2,1,5,11,19
22517,0,1,6,21,28
22518,0,1,11,14,26
22519,0,0,7,6,13
22520,0,0,2,3,5
22521,0,0,8,12,20
22522,0,4,6,21,31
22523,0,0,8,8,16
22524,0,0,3,9,12
22525,0,0,2,2,4
22526,0,0,4,1,5
22527,0,3,0,14,17
22528,2,0,1,13,16
22530,0,0,3,8,11
22531,0,0,9,18,27
22532,0,1,12,30,43
22533,0,0,2,11,13
22534,0,0,0,2,2
22535,0,1,2,4,7
22536,0,0,1,4,5
22537,0,0,7,10,17
22538,0,0,12,22,34
22539,0,0,2,11,13
22540,0,0,0,2,2
22541,0,0,6,10,16
22542,0,0,8,20,28
22543,1,0,1,10,12
22544,0,2,9,20,31
22546,0,0,1,4,5
22547,0,0,4,10,14
22548,0,0,7,7,14
22549,0,0,2,5,7
22550,0,0,2,3,5
22551,0,0,1,4,5
22552,0,0,1,4,5
22553,0,0,7,10,17
22554,0,1,8,13,22
22555,0,0,0,5,5
22556,0,0,5,10,15
22557,1,3,0,21,25
22558,0,0,7,8,15
22559,0,0,5,5,10
22562,0,0,4,10,14
22563,0,0,3,7,10
22564,0,0,2,4,6
22565,0,1,8,13,22
22566,0,0,5,7,12
22568,0,1,11,10,22
22571,0,1,13,29,43
22572,0,2,3,27,32
22575,0,1,0,4,5
22576,0,0,4,4,8
22577,0,0,6,8,14
22578,0,0,1,13,14
22579,0,0,12,26,38
22580,0,0,2,3,5
22581,0,0,1,4,5
22582,0,1,1,10,12
22583,0,0,3,12,15
22584,0,2,5,16,23
22585,0,1,6,9,16
22586,0,0,8,13,21
22587,0,0,7,25,32
22588,0,3,3,15,21
22589,0,0,4,8,12
22591,0,0,2,6,8
22592,0,0,4,5,9
22593,0,0,4,1,5
22594,0,0,0,6,6
22595,0,2,14,32,48
22596,0,0,8,7,15
22597,0,5,5,18,28
22598,0,0,5,29,34
22599,0,1,17,27,45
22600,0,0,12,26,38
22601,1,0,9,40,50
22602,0,0,13,34,47
22603,1,0,4,20,25
22604,0,1,4,7,12
22605,1,0,3,21,25
22606,1,0,3,16,20
22607,0,0,6,30,36
22608,0,0,10,19,29
22609,1,0,9,21,31
22610,0,1,10,10,21
22611,0,0,6,8,14
22612,0,0,5,9,14
22613,0,0,11,29,40
22614,0,0,6,11,17
22615,0,0,2,3,5
22616,0,0,4,5,9
22617,1,0,3,19,23
22618,0,1,7,22,30
22619,0,0,14,23,37
22620,0,4,13,33,50
22621,0,0,11,12,23
22622,0,1,0,10,11
22623,0,0,0,6,6
22624,0,1,8,19,28
22625,0,0,19,31,50
22627,3,0,3,23,29
22628,0,0,3,12,15
22629,0,0,1,13,14
22630,0,2,1,6,9
22631,0,0,1,6,7
22632,0,0,7,23,30
22633,0,1,3,34,38
22634,4,1,9,26,40
22635,1,1,14,29,45
22636,0,1,0,4,5
22637,0,0,4,4,8
22638,1,0,3,21,25
22639,0,0,14,35,49
22640,0,0,2,14,16
22641,0,1,8,18,27
22642,0,4,13,33,50
22643,0,0,0,6,6
22646,0,0,4,10,14
22647,0,0,4,4,8
22648,0,0,19,31,50
22650,1,4,6,28,39
22651,0,4,13,33,50
22652,0,0,5,29,34
22653,0,0,4,8,12
22654,0,0,5,22,27
22655,0,1,1,10,12
22656,0,0,3,11,14
22657,0,0,2,6,8
22658,1,0,5,24,30
22659,0,0,12,26,38
22660,0,1,6,9,16
22662,0,0,3,9,12
22663,3,0,3,23,29
22664,0,0,6,6,12
22665,0,0,2,6,8
22666,0,0,0,5,5
22667,0,0,8,11,19
22668,1,0,5,33,39
22669,0,0,4,15,19
22670,0,1,5,24,30
22671,0,0,12,26,38
22672,0,1,8,11,20
22673,2,0,6,28,36
22674,0,0,14,32,46
22675,0,0,3,8,11
22676,1,0,6,10,17
22677,0,0,0,7,7
22678,0,0,7,16,23
22679,0,1,4,9,14
22680,0,0,4,13,17
22681,0,0,4,16,20
22682,0,0,5,10,15
22683,0,0,3,3,6
22686,0,2,8,34,44
22687,0,1,5,25,31
22688,0,0,1,2,3
22689,0,0,0,7,7
22690,0,0,4,11,15
22691,0,0,10,38,48
22692,1,0,6,10,17
22693,0,0,5,45,50
22694,0,2,5,26,33
22695,0,0,2,11,13
22696,0,0,5,9,14
22697,0,0,5,21,26
22698,0,2,4,12,18
22699,0,1,20,28,49
22701,0,1,0,6,7
22702,0,0,1,9,10
22703,0,0,4,6,10
22704,0,0,8,19,27
22705,0,0,7,4,11
22706,0,0,4,13,17
22708,0,0,4,10,14
22709,0,0,6,12,18
22710,0,0,5,9,14
22711,0,0,6,8,14
22713,0,0,7,5,12
22714,0,0,2,11,13
22715,0,0,1,6,7
22716,0,1,2,7,10
22717,0,0,6,11,17
22718,0,1,6,12,19
22719,0,0,3,16,19
22720,0,0,1,5,6
22721,0,1,6,12,19
22722,0,1,11,17,29
22723,1,1,10,15,27
22724,0,1,5,9,15
22725,0,0,4,7,11
22728,2,1,7,30,40
22729,0,2,4,9,15
22730,0,2,2,9,13
22731,0,0,6,14,20
22733,0,0,2,6,8
22734,0,0,4,7,11
22735,0,0,2,8,10
22736,0,0,9,5,14
22737,0,2,9,13,24
22738,0,2,1,6,9
22739,0,0,1,4,5
22740,0,0,6,14,20
22742,1,0,4,9,14
22743,0,0,4,5,9
22744,0,0,4,14,18
22745,0,0,8,7,15
22746,0,0,6,17,23
22747,0,0,6,16,22
22748,1,0,8,9,18
22749,0,0,0,8,8
22750,1,0,1,2,4
22751,0,1,14,26,41
22752,0,0,9,5,14
22753,1,0,10,6,17
22754,0,0,8,3,11
22755,0,0,7,14,21
22756,0,0,1,14,15
22757,0,0,6,12,18
22758,1,4,6,28,39
22760,0,0,6,14,20
22761,0,2,6,18,26
22762,0,0,3,8,11
22763,0,0,2,6,8
22764,0,0,11,13,24
22765,1,0,5,8,14
22766,0,0,18,32,50
22767,0,0,9,25,34
22768,0,0,5,16,21
22769,0,1,6,28,35
22770,1,1,6,22,30
22771,0,0,19,31,50
22772,1,0,5,33,39
22773,0,0,10,27,37
22774,0,0,3,10,13
22775,0,0,6,34,40
22776,0,0,9,17,26
22778,1,0,4,16,21
22779,4,1,9,26,40
22780,3,0,4,8,15
22781,0,4,2,12,18
22782,0,0,5,9,14
22783,0,1,1,11,13
22784,0,0,5,2,7
22785,0,0,4,15,19
22786,1,0,6,36,43
22787,0,1,1,26,28
22788,0,0,6,14,20
22789,0,0,4,6,10
22790,0,1,3,34,38
22792,0,0,6,14,20
22793,0,0,2,7,9
22794,1,0,3,17,21
22795,0,0,12,37,49
22797,0,0,12,26,38
22798,3,0,3,23,29
22799,0,1,1,26,28
22800,1,0,3,12,16
22801,0,0,5,10,15
22802,0,1,16,25,42
22803,0,0,7,9,16
22804,0,0,12,37,49
22805,0,0,2,13,15
22806,0,0,2,27,29
22807,0,0,0,5,5
22808,0,0,1,7,8
22809,0,0,10,23,33
22810,0,1,1,11,13
22811,0,0,2,15,17
22813,1,0,3,12,16
22814,2,0,13,34,49
22815,0,0,13,20,33
22816,1,4,6,28,39
22817,2,0,13,34,49
22818,0,0,19,31,50
22819,0,0,3,8,11
22820,0,0,12,26,38
22821,0,0,2,6,8
22822,0,0,7,13,20
22823,0,1,4,3,8
22824,0,1,9,8,18
22825,0,0,5,15,20
22826,2,0,2,42,46
22827,0,0,2,7,9
22828,0,0,6,10,16
22829,0,0,4,7,11
22830,0,0,14,15,29
22831,0,0,4,18,22
22832,0,0,1,2,3
22833,0,0,11,28,39
22834,0,0,8,31,39
22835,0,0,9,14,23
22836,0,0,7,15,22
22837,0,0,2,3,5
22838,0,0,1,4,5
22839,0,1,9,40,50
22840,0,2,1,9,12
22841,0,0,0,7,7
22842,0,1,8,21,30
22843,0,0,0,24,24
22844,0,0,5,11,16
22845,1,0,1,9,11
22846,0,0,7,12,19
22847,0,2,1,23,26
22848,0,2,5,19,26
22849,1,1,4,20,26
22850,0,0,1,4,5
22851,0,0,2,9,11
22852,0,0,5,11,16
22853,0,0,3,3,6
22855,0,0,1,1,2
22856,1,0,10,12,23
22857,0,0,3,13,16
22858,0,0,11,27,38
22859,1,1,4,20,26
22860,0,0,6,18,24
22862,0,0,3,4,7
22863,0,0,4,5,9
22864,0,0,2,3,5
22865,0,0,3,12,15
22866,0,0,3,4,7
22867,0,2,13,33,48
22868,0,0,4,4,8
22869,0,0,8,18,26
22870,0,1,5,8,14
22871,0,0,8,16,24
22872,0,0,5,11,16
22875,0,0,4,25,29
22876,0,0,4,5,9
22877,0,0,7,16,23
22879,0,0,10,12,22
22880,0,0,8,23,31
22881,0,0,7,9,16
22882,0,0,2,10,12
22883,0,0,2,4,6
22885,0,0,7,20,27
22886,0,0,4,7,11
22887,0,0,7,22,29
22888,0,0,2,4,6
22889,0,0,4,5,9
22890,0,0,9,9,18
22891,0,0,7,9,16
22892,0,0,6,21,27
22893,0,0,2,13,15
22894,0,1,15,30,46
22895,0,0,2,10,12
22896,0,1,0,8,9
22897,0,1,0,24,25
22898,0,0,12,24,36
22899,0,0,10,8,18
22900,0,0,6,6,12
22901,0,1,9,8,18
22902,0,0,16,28,44
22903,0,1,2,18,21
22904,0,0,3,3,6
22906,0,1,6,17,24
22907,0,1,1,3,5
22908,0,0,7,20,27
22909,1,0,9,34,44
22910,0,0,5,10,15
22911,0,0,2,4,6
22913,0,0,0,6,6
22914,0,0,13,35,48
22915,0,1,0,11,12
22916,0,0,0,6,6
22917,0,0,7,20,27
22918,0,2,4,10,16
22919,3,0,3,23,29
22920,0,0,5,12,17
22921,0,3,5,7,15
22922,0,1,17,19,37
22923,5,0,12,23,40
22924,0,2,4,10,16
22925,0,0,3,16,19
22926,0,0,3,8,11
22927,0,2,3,27,32
22928,0,0,6,12,18
22929,0,0,6,10,16
22930,0,1,6,21,28
22931,0,0,4,7,11
22932,0,0,1,13,14
22933,0,0,8,19,27
22934,0,0,18,27,45
22935,0,0,6,6,12
22936,0,0,8,16,24
22937,0,0,3,8,11
22938,0,0,1,18,19
22939,0,0,6,13,19
22940,0,0,8,23,31
22941,0,1,6,21,28
22942,0,2,9,26,37
22943,0,0,16,22,38
22944,0,1,13,19,33
22945,1,0,13,22,36
22946,0,0,3,17,20
22947,0,2,5,13,20
22948,0,0,2,3,5
22949,0,1,1,10,12
22950,0,0,6,16,22
22951,0,0,5,2,7
22952,0,0,0,7,7
22953,0,0,8,21,29
22954,0,2,16,28,46
22956,0,0,4,7,11
22957,0,0,4,21,25
22958,1,0,13,22,36
22959,0,1,7,9,17
22960,0,0,8,4,12
22961,0,0,5,4,9
22962,0,0,6,7,13
22963,0,1,5,17,23
22964,0,0,8,13,21
22965,1,0,6,18,25
22966,0,0,7,25,32
22967,1,1,8,18,28
22968,0,1,1,3,5
22969,0,1,7,9,17
22970,0,0,3,15,18
22971,0,0,6,14,20
22972,0,0,2,10,12
22973,0,1,2,3,6
22974,0,0,5,23,28
22975,3,0,3,23,29
22976,0,1,6,14,21
22977,0,0,3,25,28
22978,0,0,6,14,20
22979,0,0,2,3,5
22980,0,0,9,27,36
22981,0,0,10,10,20
22982,0,0,5,23,28
22983,0,1,7,16,24
22984,0,3,10,21,34
22985,0,1,4,12,17
22986,0,0,3,15,18
22987,0,0,1,11,12
22988,0,1,1,10,12
22989,0,1,6,14,21
22990,2,0,0,4,6
22991,0,0,4,6,10
22992,0,0,8,18,26
22993,1,0,7,23,31
22994,0,0,3,15,18
22995,0,0,3,17,20
22996,0,0,1,13,14
22997,1,0,9,5,15
22998,0,0,2,10,12
22999,3,0,3,23,29
23000,0,1,2,3,6
23001,0,0,0,7,7
23002,1,0,13,22,36
23003,0,0,6,14,20
23004,1,1,8,18,28
23005,0,0,5,23,28
23006,0,1,2,16,19
23007,0,0,0,7,7
23008,0,1,9,8,18
23009,0,0,4,1,5
23010,0,0,3,4,7
23011,0,0,10,13,23
23012,0,0,10,20,30
23013,0,0,5,8,13
23014,0,0,7,20,27
23015,0,0,11,13,24
23016,0,0,9,17,26
23017,0,1,5,5,11
23018,0,0,7,20,27
23019,0,1,6,19,26
23020,0,2,16,31,49
23021,0,3,2,41,46
23022,0,0,4,13,17
23023,0,1,2,15,18
23024,0,0,1,4,5
23025,0,1,3,23,27
23026,0,0,3,12,15
23027,0,0,4,9,13
23028,0,0,4,9,13
23029,0,0,3,16,19
23030,0,0,13,20,33
23031,0,3,7,22,32
23032,0,0,3,9,12
23033,0,0,7,20,27
23035,0,0,6,10,16
23036,0,0,3,13,16
23037,0,0,7,22,29
23038,0,1,2,5,8
23039,0,2,16,31,49
23040,0,2,2,9,13
23041,0,0,1,15,16
23042,0,0,5,12,17
23043,0,0,4,8,12
23044,0,0,3,6,9
23045,0,0,0,9,9
23046,0,0,2,7,9
23047,0,0,2,4,6
23048,0,0,3,11,14
23049,0,0,1,15,16
23051,0,0,7,12,19
23052,0,0,10,17,27
23053,0,0,5,9,14
23054,0,0,13,34,47
23055,0,0,4,6,10
23056,0,2,2,9,13
23057,0,0,11,15,26
23058,0,0,3,17,20
23059,0,0,5,12,17
23060,0,3,0,7,10
23061,0,0,2,7,9
23062,0,1,0,7,8
23064,1,2,14,33,50
23065,0,1,13,27,41
23067,0,0,2,3,5
23068,1,0,1,9,11
23069,0,0,6,8,14
23070,0,0,15,26,41
23071,0,0,8,8,16
23072,0,0,7,7,14
23073,1,0,5,16,22
23074,0,0,11,18,29
23075,0,0,4,1,5
23076,0,3,9,18,30
23077,0,1,4,33,38
23078,0,0,1,10,11
23079,0,0,1,0,1
23080,0,1,6,13,20
23081,0,0,3,6,9
23082,0,0,0,13,13
23083,0,0,14,17,31
23084,0,0,1,7,8
23085,0,0,1,9,10
23086,0,0,3,12,15
23087,0,0,2,5,7
23088,0,0,4,4,8
23089,0,0,1,16,17
23090,0,0,2,2,4
23092,0,1,8,12,21
23093,0,0,0,1,1
23094,0,0,4,4,8
23095,0,1,6,13,20
23096,0,1,8,21,30
23097,0,0,9,5,14
23098,0,0,3,9,12
23099,0,0,1,2,3
23100,0,0,6,15,21
23101,0,0,1,9,10
23102,0,0,10,31,41
23103,0,0,2,5,7
23106,0,0,7,7,14
23107,0,1,6,21,28
23108,0,0,3,5,8
23109,0,0,4,12,16
23111,0,0,9,29,38
23112,0,0,3,2,5
23113,0,0,4,6,10
23114,0,0,0,5,5
23115,0,0,7,6,13
23116,0,3,4,15,22
23117,0,0,5,15,20
23118,0,0,0,11,11
23119,0,0,1,4,5
23120,0,0,5,10,15
23121,0,1,1,27,29
23122,0,1,9,8,18
23123,0,1,0,4,5
23124,0,0,2,12,14
23125,0,0,2,3,5
23126,0,0,4,1,5
23128,0,1,12,25,38
23129,0,0,9,24,33
23130,1,0,7,13,21
23131,0,0,6,33,39
23132,0,1,15,34,50
23133,0,0,4,28,32
23134,0,1,9,16,26
23135,0,0,4,16,20
23136,0,0,0,11,11
23137,0,0,2,4,6
23138,0,1,11,28,40
23139,1,2,16,31,50
23140,0,0,4,15,19
23141,0,3,5,37,45
23142,0,0,8,20,28
23143,0,2,8,37,47
23144,0,1,12,25,38
23145,0,1,13,25,39
23146,0,0,7,16,23
23147,0,0,7,17,24
23148,0,0,10,40,50
23149,0,0,3,17,20
23151,1,1,5,27,34
23153,0,0,4,27,31
23154,0,0,7,17,24
23155,0,0,5,10,15
23156,0,0,6,12,18
23158,0,0,11,18,29
23159,2,1,6,12,21
23160,0,0,9,41,50
23161,0,0,8,21,29
23162,0,0,2,3,5
23163,0,0,8,14,22
23164,0,0,5,6,11
23165,0,0,10,40,50
23166,0,0,4,9,13
23167,0,1,3,34,38
23168,0,0,0,5,5
23169,0,0,6,44,50
23170,1,0,0,9,10
23171,1,0,15,17,33
23172,0,0,4,9,13
23173,0,0,1,4,5
23174,0,0,2,12,14
23175,0,0,3,12,15
23177,0,0,10,20,30
23178,0,0,2,7,9
23179,1,1,8,40,50
23180,0,1,0,4,5
23181,0,0,1,2,3
23182,0,0,3,17,20
23183,0,0,14,33,47
23184,0,0,0,9,9
23185,1,0,8,16,25
23187,0,0,1,8,9
23188,0,0,1,13,14
23190,0,0,0,11,11
23191,0,0,12,5,17
23192,0,0,3,17,20
23193,0,0,0,6,6
23194,0,1,13,27,41
23195,2,0,13,34,49
23196,0,0,2,12,14
23198,0,0,2,6,8
23199,2,0,13,34,49
23201,0,0,14,33,47
23202,1,1,8,40,50
23203,0,0,4,8,12
23204,0,2,4,10,16
23205,0,0,1,15,16
23206,0,0,5,7,12
23207,0,0,11,22,33
23208,1,0,10,30,41
23209,0,0,6,8,14
23210,0,0,1,12,13
23211,0,0,4,3,7
23212,0,0,6,8,14
23213,0,0,5,20,25
23214,0,0,5,24,29
23215,0,0,4,10,14
23217,0,0,11,14,25
23218,0,2,5,16,23
23219,0,2,3,11,16
23220,0,0,0,12,12
23221,0,0,11,23,34
23222,0,0,6,9,15
23223,0,1,7,19,27
23224,0,0,1,3,4
23225,0,0,2,13,15
23226,0,2,2,24,28
23227,0,2,3,35,40
23228,0,0,7,6,13
23229,0,1,6,14,21
23230,0,0,3,8,11
23231,0,0,10,13,23
23232,0,0,0,2,2
23233,0,0,9,8,17
23234,0,0,2,10,12
23235,0,0,11,19,30
23237,0,0,7,23,30
23238,0,2,4,10,16
23239,0,0,4,8,12
23241,0,0,7,11,18
23243,0,0,4,11,15
23244,0,0,3,3,6
23245,1,1,4,44,50
23246,0,3,4,14,21
23247,0,0,2,14,16
23248,0,1,8,20,29
23249,1,0,2,18,21
23250,0,1,5,11,17
23251,0,0,7,23,30
23252,0,0,1,4,5
23253,0,1,4,15,20
23255,0,0,0,6,6
23256,0,2,16,31,49
23257,0,0,9,13,22
23258,0,0,0,12,12
23259,0,0,4,11,15
23260,0,0,4,12,16
23261,0,0,2,22,24
23262,2,0,9,18,29
23263,0,1,3,18,22
23264,0,0,11,19,30
23265,0,0,12,20,32
23266,0,2,1,6,9
23267,0,0,6,8,14
23268,1,0,10,30,41
23269,0,0,2,22,24
23270,0,0,7,18,25
23271,0,0,6,9,15
23272,0,0,0,9,9
23273,1,1,5,43,50
23274,0,0,5,24,29
23275,0,0,3,8,11
23276,0,1,12,37,50
23277,0,0,6,8,14
23278,0,3,5,7,15
23280,0,0,0,6,6
23281,0,0,5,14,19
23282,0,0,5,12,17
23283,0,0,10,10,20
23284,0,2,11,37,50
23285,0,0,5,11,16
23286,0,0,2,4,6
23287,0,0,1,13,14
23288,1,1,6,21,29
23289,0,4,8,11,23
23290,0,0,4,3,7
23291,0,1,5,7,13
23292,0,0,11,15,26
23293,0,1,7,11,19
23294,0,0,9,9,18
23295,0,0,8,12,20
23296,0,0,10,18,28
23297,0,0,3,10,13
23298,0,0,11,18,29
23301,0,0,5,11,16
23302,1,0,3,7,11
23303,0,1,0,7,8
23304,0,0,6,17,23
23305,0,0,4,2,6
23306,0,0,3,3,6
23307,0,2,0,16,18
23308,0,0,6,24,30
23309,0,0,8,5,13
23311,0,0,5,8,13
23313,0,1,5,7,13
23314,0,0,0,6,6
23315,0,0,2,0,2
23316,1,0,10,12,23
23317,1,0,1,3,5
23318,0,1,13,13,27
23319,0,0,1,5,6
23322,0,1,4,19,24
23323,0,0,11,7,18
23324,0,0,10,27,37
23326,0,0,1,2,3
23327,0,0,5,32,37
23331,0,0,1,8,9
23332,0,0,1,5,6
23333,0,0,8,15,23
23334,0,1,9,26,36
23335,0,0,11,17,28
23337,1,0,15,34,50
23340,0,1,1,8,10
23341,0,0,3,20,23
23342,0,0,5,10,15
23343,1,1,8,18,28
23345,0,0,2,3,5
23346,1,0,0,5,6
23347,0,0,2,4,6
23348,1,0,1,10,12
23349,0,1,6,14,21
23350,0,1,17,31,49
23351,1,0,2,12,15
23352,0,0,7,23,30
23353,0,0,6,17,23
23354,0,2,7,34,43
23355,0,0,10,14,24
23356,0,2,8,31,41
23357,2,1,2,6,11
23358,0,0,2,4,6
23359,2,1,1,12,16
23360,2,1,5,17,25
23361,0,0,7,18,25
23362,1,0,9,21,31
23363,0,0,18,20,38
23364,0,0,5,10,15
23365,0,2,11,23,36
23366,0,0,8,42,50
23367,0,1,7,18,26
23368,0,0,8,11,19
23369,2,1,8,29,40
23370,0,7,1,30,38
23371,0,0,3,15,18
23372,0,0,9,18,27
23373,0,1,18,20,39
23374,1,0,12,36,49
23375,0,0,9,27,36
23376,0,1,11,30,42
23377,0,0,12,38,50
23378,1,0,5,19,25
23379,0,0,2,7,9
23380,1,1,10,28,40
23381,1,0,5,25,31
23382,0,2,8,40,50
23383,0,1,5,21,27
23384,0,0,5,30,35
23385,0,0,3,20,23
23387,0,1,13,26,40
23388,0,0,6,13,19
23389,0,2,1,19,22
23390,1,1,4,44,50
23391,0,0,4,8,12
23392,0,1,0,7,8
23393,0,1,6,20,27
23394,2,1,11,36,50
23395,0,0,3,15,18
23396,0,0,11,25,36
23397,0,1,4,4,9
23398,0,0,1,3,4
23399,0,0,4,9,13
23401,0,0,6,13,19
23402,0,1,6,11,18
23403,0,2,0,16,18
23404,0,1,6,14,21
23405,0,1,3,34,38
23406,0,0,1,10,11
23407,0,0,0,6,6
23408,1,1,8,40,50
23409,0,0,0,10,10
23410,1,1,8,18,28
23411,0,1,1,8,10
23412,0,0,0,7,7
23413,0,0,7,18,25
23414,1,0,9,35,45
23415,0,0,0,10,10
23416,0,0,2,11,13
23417,0,0,1,4,5
23418,0,0,6,9,15
23419,1,0,5,6,12
23420,0,0,10,21,31
23421,0,0,7,18,25
23422,0,0,0,6,6
23423,0,0,3,20,23
23424,0,2,0,16,18
23425,0,2,8,40,50
23426,0,1,1,8,10
23427,0,0,7,18,25
23428,1,1,8,40,50
23429,0,0,14,36,50
23430,0,2,4,21,27
23431,0,0,7,16,23
23432,0,0,13,28,41
23433,1,0,6,11,18
23434,0,0,13,28,41
23435,2,2,8,34,46
23436,0,0,5,13,18
23437,0,0,0,7,7
23438,0,1,3,8,12
23439,0,2,6,24,32
23440,0,0,1,4,5
23441,0,0,9,22,31
23442,0,0,0,8,8
23443,0,0,10,17,27
23444,0,0,5,10,15
23445,0,0,3,2,5
23446,0,0,6,10,16
23447,0,0,8,14,22
23448,0,0,11,5,16
23449,0,0,5,9,14
23450,0,0,14,31,45
23451,1,0,5,14,20
23452,0,0,10,9,19
23453,2,1,1,25,29
23454,0,0,0,9,9
23455,0,0,7,13,20
23456,0,0,3,4,7
23457,0,0,5,8,13
23458,0,0,1,4,5
23459,0,0,7,22,29
23461,1,0,4,9,14
23462,0,0,3,1,4
23463,0,2,1,16,19
23464,0,0,2,12,14
23465,2,1,1,25,29
23466,0,0,4,12,16
23467,0,0,7,15,22
23468,0,1,11,22,34
23470,0,0,3,4,7
23471,0,0,3,14,17
23472,0,0,0,14,14
23473,0,1,7,18,26
23475,0,0,3,23,26
23476,0,0,1,7,8
23477,0,0,8,16,24
23478,1,0,2,21,24
23479,0,1,5,7,13
23480,0,0,6,4,10
23481,0,0,8,17,25
23482,0,0,8,11,19
23483,1,0,6,5,12
23484,0,2,6,18,26
23485,0,1,1,11,13
23486,0,0,2,1,3
23487,0,0,4,13,17
23488,0,1,5,13,19
23489,0,0,10,40,50
23490,0,0,0,12,12
23491,0,0,7,9,16
23492,0,0,2,3,5
23493,0,0,0,5,5
23494,0,1,2,7,10
23495,0,1,6,17,24
23496,0,1,3,17,21
23497,0,0,2,8,10
23498,0,0,0,5,5
23499,0,0,8,14,22
23500,0,0,2,22,24
23502,1,0,5,17,23
23503,0,0,12,23,35
23504,0,0,1,4,5
23506,0,1,3,8,12
23507,0,0,1,6,7
23508,0,3,0,8,11
23509,1,0,0,4,5
23510,1,0,1,3,5
23511,0,0,9,26,35
23512,0,0,5,12,17
23513,2,2,8,34,46
23514,0,0,1,24,25
23515,0,0,3,6,9
23517,0,0,3,10,13
23518,0,0,0,7,7
23519,0,0,4,9,13
23520,0,0,9,9,18
23521,0,0,4,5,9
23522,1,0,8,28,37
23523,0,0,5,13,18
23524,0,0,5,7,12
23525,1,1,13,23,38
23526,0,0,12,23,35
23527,0,0,2,6,8
23528,0,0,10,16,26
23529,0,2,15,15,32
23530,0,1,11,12,24
23531,0,0,8,25,33
23532,0,2,2,30,34
23533,0,0,9,26,35
23534,0,3,13,18,34
23535,0,0,4,12,16
23536,1,0,0,4,5
23537,0,0,8,14,22
23538,0,0,0,7,7
23539,0,0,3,23,26
23540,0,0,2,22,24
23541,0,0,2,22,24
23542,0,0,2,6,8
23543,0,1,11,12,24
23544,0,0,5,12,17
23545,1,0,0,4,5
23546,0,3,3,15,21
23547,0,2,2,14,18
23548,0,2,2,30,34
23549,0,0,5,18,23
23550,0,0,3,6,9
23551,1,1,9,39,50
23552,0,0,8,25,33
23553,0,0,3,10,13
23554,0,0,8,14,22
23555,0,0,4,5,9
23556,0,0,6,4,10
23557,0,1,2,7,10
23558,0,0,3,10,13
23559,0,0,3,4,7
23560,0,0,1,6,7
23562,0,0,4,11,15
23563,0,0,12,15,27
23564,0,1,10,26,37
23565,0,0,2,6,8
23566,0,0,4,18,22
23567,0,0,14,36,50
23568,0,0,6,8,14
23569,0,2,21,27,50
23570,0,0,9,22,31
23571,0,1,2,5,8
23572,0,0,11,26,37
23573,0,0,0,5,5
23574,0,0,9,6,15
23575,0,0,7,13,20
23577,0,0,5,18,23
23578,1,0,2,4,7
23579,1,0,0,16,17
23580,0,1,6,21,28
23581,0,0,7,8,15
23582,0,0,11,16,27
23583,0,0,1,6,7
23585,0,0,6,19,25
23586,0,1,7,16,24
23587,0,2,12,30,44
23588,1,0,6,19,26
23589,0,0,5,7,12
23590,1,0,13,36,50
23591,0,0,7,4,11
23592,0,0,4,5,9
23593,0,1,11,30,42
23594,0,0,1,1,2
23595,0,0,11,16,27
23596,0,0,4,6,10
23597,0,0,3,8,11
23598,0,0,9,22,31
23599,0,0,5,8,13
23600,0,0,7,13,20
23601,0,0,4,17,21
23602,0,0,16,22,38
23603,0,0,4,8,12
23604,0,0,5,7,12
23605,0,0,12,20,32
23606,0,0,5,9,14
23607,0,0,7,16,23
23608,0,0,4,5,9
23609,0,0,5,9,14
23610,0,0,8,13,21
23611,0,0,6,12,18
23612,0,0,5,8,13
23613,0,0,9,6,15
23614,0,0,4,17,21
23615,0,1,9,23,33
23616,0,0,0,5,5
23617,0,2,9,12,23
23618,0,0,5,9,14
23619,0,0,0,1,1
23620,0,0,4,9,13
23621,0,0,5,7,12
23622,0,0,1,5,6
23623,0,1,8,29,38
23624,0,2,3,13,18
23625,0,0,9,21,30
23626,0,0,5,12,17
23627,0,0,4,2,6
23628,0,0,8,10,18
23629,0,0,4,6,10
23630,0,1,13,20,34
23631,0,0,11,25,36
23632,0,0,5,12,17
23633,1,1,9,16,27
23634,1,1,9,24,35
23635,0,1,15,30,46
23636,0,0,0,7,7
23637,0,0,6,20,26
23638,0,1,3,6,10
23639,0,0,4,5,9
23640,0,0,2,10,12
23641,0,0,5,10,15
23642,0,0,2,11,13
23643,0,0,10,11,21
23644,0,1,9,27,37
23645,0,1,6,14,21
23646,0,0,9,14,23
23647,0,0,5,12,17
23648,0,0,3,15,18
23649,0,1,15,34,50
23650,0,0,1,15,16
23651,0,1,1,5,7
23652,0,5,5,11,21
23653,0,0,5,33,38
23654,0,0,0,5,5
23655,0,0,5,14,19
23656,0,0,3,8,11
23657,0,0,10,40,50
23658,0,0,0,5,5
23660,0,0,2,9,11
23661,0,2,2,6,10
23662,0,0,2,3,5
23663,0,0,5,8,13
23664,0,1,8,12,21
23665,0,0,7,3,10
23666,0,0,7,6,13
23667,0,0,3,8,11
23668,0,0,6,11,17
23669,0,0,10,10,20
23670,0,0,3,8,11
23671,0,1,5,4,10
23672,0,0,4,12,16
23673,0,0,3,6,9
23674,0,0,4,23,27
23675,0,0,10,23,33
23676,0,1,7,13,21
23677,0,0,7,11,18
23678,0,0,8,27,35
23679,0,1,9,27,37
23680,0,0,8,17,25
23683,0,0,8,11,19
23684,0,0,8,11,19
23685,0,0,0,6,6
23688,1,0,13,23,37
23689,0,0,2,8,10
23690,0,0,6,8,14
23691,0,0,4,3,7
23692,0,1,0,5,6
23694,0,0,4,14,18
23695,0,0,6,20,26
23696,0,0,1,4,5
23698,0,1,6,10,17
23699,0,0,3,3,6
23700,0,0,2,6,8
23701,0,2,3,27,32
23702,1,1,10,8,20
23703,0,1,2,10,13
23706,0,0,2,4,6
23707,0,1,16,26,43
23708,0,0,4,13,17
23709,0,0,1,6,7
23710,0,0,8,7,15
23711,0,1,11,14,26
23712,0,0,3,2,5
23713,2,0,3,15,20
23714,0,0,3,7,10
23715,0,0,8,14,22
23716,0,0,19,17,36
23717,1,0,8,28,37
23718,1,0,7,34,42
23719,0,0,8,16,24
23720,0,0,3,13,16
23721,0,4,9,35,48
23722,0,1,9,23,33
23723,0,0,9,8,17
23725,1,0,18,31,50
23726,0,0,8,21,29
23727,1,1,10,8,20
23728,0,1,13,22,36
23729,0,1,16,26,43
23730,0,0,3,11,14
23731,0,0,0,5,5
23732,0,2,7,25,34
23734,0,1,13,36,50
23735,0,0,0,2,2
23736,0,0,5,18,23
23737,0,0,7,13,20
23738,0,3,13,18,34
23739,0,0,2,6,8
23740,0,1,17,27,45
23741,0,0,2,4,6
23742,0,0,2,6,8
23743,3,0,3,10,16
23744,0,0,1,4,5
23745,0,1,3,11,15
23746,0,1,11,38,50
23747,0,1,9,34,44
23748,0,0,4,37,41
23749,0,2,12,30,44
23751,2,2,3,17,24
23752,0,0,5,34,39
23753,0,0,2,6,8
23754,1,0,13,36,50
23755,0,0,1,4,5
23756,0,1,11,14,26
23757,1,0,13,36,50
23758,0,1,2,10,13
23759,1,0,0,17,18
23761,0,1,5,9,15
23762,2,2,8,34,46
23763,0,1,3,26,30
23764,0,0,7,13,20
23765,0,0,9,26,35
23766,0,0,1,13,14
23767,0,0,5,7,12
23768,2,1,3,7,13
23769,0,0,2,7,9
23770,0,0,5,13,18
23771,0,0,8,25,33
23772,0,0,9,22,31
23773,0,0,7,15,22
23774,0,0,14,24,38
23775,0,0,6,20,26
23777,0,0,8,20,28
23778,0,1,3,26,30
23779,0,0,4,11,15
23780,0,0,4,4,8
23781,0,0,7,13,20
23782,0,0,3,6,9
23783,0,1,1,8,10
23784,0,5,0,18,23
23785,0,1,11,14,26
23786,0,0,11,25,36
23787,0,0,0,4,4
23788,0,1,7,12,20
23789,0,0,3,24,27
23790,0,0,2,4,6
23791,0,0,9,12,21
23792,0,0,7,15,22
23793,0,0,8,10,18
23794,0,0,5,11,16
23795,0,0,4,15,19
23796,0,0,1,9,10
23797,0,1,5,31,37
23799,0,0,8,18,26
23800,0,0,14,13,27
23801,0,0,0,4,4
23802,0,0,0,1,1
23803,0,0,4,5,9
23804,0,0,13,25,38
23805,0,0,0,14,14
23806,0,0,8,22,30
23807,0,0,6,3,9
23808,0,1,11,22,34
23809,0,1,5,20,26
23810,0,0,5,27,32
23811,0,0,5,26,31
23812,0,0,7,11,18
23813,0,2,6,19,27
23814,0,0,6,13,19
23815,0,0,2,0,2
23816,0,0,3,12,15
23817,0,0,0,7,7
23818,0,0,6,13,19
23819,0,0,5,12,17
23820,0,0,4,7,11
23821,0,0,6,18,24
23822,0,1,2,12,15
23823,0,1,3,16,20
23825,0,0,8,11,19
23826,0,0,2,2,4
23827,0,0,7,13,20
23828,0,0,1,0,1
23829,0,1,8,13,22
23830,0,0,0,6,6
23831,0,0,8,13,21
23832,0,0,4,7,11
23833,0,0,13,31,44
23834,0,0,8,12,20
23835,0,0,6,5,11
23836,0,0,3,13,16
23837,0,0,5,9,14
23838,0,1,11,24,36
23839,0,0,3,20,23
23840,0,0,0,5,5
23841,0,0,8,16,24
23842,0,1,5,9,15
23843,0,0,11,16,27
23844,0,0,3,3,6
23845,0,2,13,21,36
23846,0,0,5,7,12
23847,0,0,3,9,12
23848,2,2,8,34,46
23849,0,0,5,14,19
23850,0,0,2,5,7
23851,0,0,9,20,29
23853,0,2,5,12,19
23854,0,0,5,16,21
23855,0,0,4,19,23
23856,0,0,1,6,7
23857,0,0,7,8,15
23858,0,1,4,6,11
23859,2,0,2,15,19
23860,0,0,3,9,12
23861,0,0,1,9,10
23862,0,0,5,7,12
23863,0,0,8,4,12
23864,0,0,3,2,5
23865,0,1,10,5,16
23866,0,0,6,6,12
23867,0,0,0,5,5
23868,0,3,13,30,46
23869,0,0,5,16,21
23870,0,2,5,12,19
23871,0,0,3,12,15
23872,0,1,4,6,11
23873,0,0,3,2,5
23875,0,0,4,7,11
23876,0,0,0,7,7
23877,0,0,11,25,36
23878,0,0,8,25,33
23879,0,0,8,14,22
23880,0,1,8,15,24
23881,0,0,7,16,23
23882,0,0,5,15,20
23883,1,0,6,35,42
23884,0,0,15,23,38
23885,0,0,7,11,18
23886,0,0,10,9,19
23887,0,0,10,38,48
23888,0,0,8,4,12
23889,0,0,18,32,50
23890,0,0,5,9,14
23891,0,0,3,9,12
23892,0,0,16,16,32
23893,0,0,2,4,6
23894,0,0,2,14,16
23895,0,0,2,5,7
23896,0,1,2,7,10
23897,0,0,12,34,46
23898,0,0,1,6,7
23899,0,0,7,9,16
23900,0,0,8,11,19
23901,0,0,7,28,35
23902,0,1,3,26,30
23903,0,1,13,13,27
23904,0,1,11,7,19
23905,0,2,5,12,19
23906,0,0,6,20,26
23907,0,0,8,23,31
23908,0,2,2,11,15
23909,0,0,2,3,5
23910,0,0,9,13,22
23911,0,0,0,8,8
23913,0,1,11,14,26
23914,0,0,3,6,9
23915,0,0,8,25,33
23916,0,0,8,14,22
23917,0,0,6,5,11
23918,3,0,1,2,6
23919,0,0,8,23,31
23920,0,0,15,19,34
23921,1,0,3,17,21
23922,1,0,3,13,17
23924,1,0,5,10,16
23926,0,0,2,13,15
23927,0,0,10,22,32
23928,0,0,5,10,15
23929,0,0,8,19,27
23930,0,0,1,16,17
23931,0,1,12,24,37
23932,0,0,13,23,36
23933,0,0,8,23,31
23934,0,2,15,15,32
23935,0,0,5,27,32
23936,0,0,10,9,19
23937,1,1,3,9,14
23938,0,0,1,5,6
23939,0,1,7,14,22
23940,0,0,3,17,20
23941,0,0,6,13,19
23942,0,0,14,32,46
23943,0,0,3,10,13
23945,0,0,1,16,17
23946,0,0,3,2,5
23947,0,2,5,19,26
23948,0,0,5,8,13
23949,0,0,5,10,15
23950,0,0,4,8,12
23951,0,1,5,20,26
23952,0,0,6,13,19
23953,0,0,3,5,8
23954,0,0,5,5,10
23955,0,0,4,3,7
23956,0,0,1,15,16
23957,0,1,8,11,20
23958,0,0,4,21,25
23959,0,0,9,6,15
23960,0,0,4,19,23
23961,0,0,4,8,12
23962,0,0,2,11,13
23963,0,0,9,17,26
23964,0,0,5,14,19
23965,0,1,6,33,40
23966,1,0,4,10,15
23967,0,0,6,5,11
23968,0,0,6,10,16
23969,0,0,5,21,26
23970,0,0,1,7,8
23971,0,0,4,7,11
23972,0,0,7,20,27
23973,0,0,4,8,12
23975,0,0,7,15,22
23976,0,0,11,16,27
23977,0,0,0,6,6
23978,0,0,3,13,16
23980,0,0,3,8,11
23981,0,1,10,23,34
23983,0,0,3,23,26
23984,3,0,1,2,6
23985,0,0,0,6,6
23986,0,0,4,16,20
23987,0,0,6,9,15
23988,0,0,13,34,47
23989,0,0,2,5,7
23990,0,1,6,17,24
23991,0,1,7,13,21
23992,0,1,6,33,40
23993,0,2,5,19,26
23995,0,0,11,24,35
23996,0,0,3,3,6
23997,0,0,3,23,26
23998,0,0,5,6,11
23999,0,0,4,16,20
24000,0,0,10,12,22
24001,0,1,12,24,37
24002,0,0,12,15,27
24003,0,2,15,15,32
24004,0,0,8,13,21
24005,0,0,1,14,15
24006,0,0,1,20,21
24007,0,0,2,7,9
24008,0,2,7,17,26
24010,1,0,2,12,15
24011,1,0,6,7,14
24012,1,1,8,22,32
24013,0,0,2,3,5
24014,0,0,5,6,11
24015,0,0,3,25,28
24016,1,0,4,7,12
24017,0,0,5,23,28
24018,0,0,5,19,24
24019,0,0,3,15,18
24020,0,1,10,16,27
24021,0,0,5,9,14
24022,0,0,2,3,5
24023,0,0,5,18,23
24024,0,0,2,8,10
24025,0,0,7,8,15
24026,0,0,14,27,41
24027,0,0,1,5,6
24028,0,0,1,4,5
24029,0,0,3,3,6
24030,0,0,5,6,11
24031,0,0,13,31,44
24032,0,0,5,5,10
24033,0,0,6,17,23
24034,0,0,7,10,17
24035,0,0,7,8,15
24036,0,1,6,17,24
24037,0,0,8,14,22
24038,0,0,1,3,4
24039,0,0,15,21,36
24040,0,0,8,7,15
24041,0,0,3,8,11
24042,0,0,4,12,16
24043,0,0,4,7,11
24044,0,0,9,17,26
24045,0,0,3,10,13
24046,0,0,2,9,11
24047,0,0,8,15,23
24049,0,0,7,22,29
24050,0,0,2,3,5
24051,0,0,8,17,25
24052,0,1,15,34,50
24053,0,0,8,12,20
24054,0,0,8,2,10
24055,0,0,10,5,15
24056,1,2,17,30,50
24057,1,0,1,10,12
24059,0,0,5,13,18
24060,0,0,3,10,13
24061,0,0,0,6,6
24062,0,0,1,5,6
24063,0,0,3,16,19
24064,0,0,14,36,50
24065,0,2,7,17,26
24066,0,0,7,22,29
24068,0,0,8,32,40
24069,0,1,4,45,50
24071,0,0,5,25,30
24072,0,2,15,15,32
24073,0,0,7,13,20
24074,0,1,2,8,11
24075,0,0,8,7,15
24076,0,0,4,6,10
24077,0,0,6,19,25
24078,0,0,6,20,26
24079,1,0,1,3,5
24080,0,0,11,17,28
24081,0,0,5,12,17
24082,0,2,6,18,26
24083,0,0,11,33,44
24085,0,0,15,25,40
24086,0,0,2,6,8
24087,0,3,6,36,45
24088,0,0,7,13,20
24089,1,0,16,33,50
24090,0,0,5,14,19
24091,0,1,11,20,32
24092,0,0,6,9,15
24093,0,0,1,15,16
24094,0,1,4,45,50
24095,0,0,1,4,5
24096,0,0,11,17,28
24098,0,0,3,6,9
24099,0,2,15,15,32
24100,0,0,4,9,13
24102,0,0,6,20,26
24104,0,1,3,45,49
24105,0,1,1,34,36
24106,1,0,11,38,50
24107,1,0,3,17,21
24108,0,1,2,47,50
24109,0,0,3,10,13
24110,0,0,2,7,9
24111,0,2,7,17,26
24112,0,0,5,13,18
24113,0,0,0,7,7
24114,0,0,2,3,5
24115,0,1,4,10,15
24116,0,0,8,7,15
24117,0,0,5,15,20
24118,0,0,14,17,31
24119,0,1,15,34,50
24120,0,0,15,32,47
24121,0,0,5,19,24
24122,0,0,5,28,33
24123,0,0,4,16,20
24124,0,0,1,6,7
24125,0,1,9,21,31
24126,0,2,6,24,32
24127,1,4,0,14,19
24128,0,0,9,9,18
24129,0,0,11,23,34
24130,0,0,1,5,6
24131,0,0,6,6,12
24132,0,0,5,6,11
24133,0,0,0,5,5
24134,0,0,4,13,17
24135,0,1,1,20,22
24136,0,1,3,9,13
24137,0,2,3,21,26
24138,0,0,6,12,18
24141,0,0,5,12,17
24142,1,0,13,36,50
24143,0,0,3,4,7
24144,0,0,3,17,20
24145,0,0,21,29,50
24146,0,0,5,9,14
24147,1,1,3,22,27
24148,0,0,2,8,10
24149,0,0,14,27,41
24150,0,0,9,24,33
24151,0,0,0,8,8
24152,0,1,0,3,4
24153,0,0,8,20,28
24154,0,0,11,16,27
24155,0,0,4,1,5
24156,0,0,2,3,5
24157,0,1,0,7,8
24158,0,0,5,18,23
24159,0,0,1,3,4
24160,0,0,5,10,15
24161,0,1,6,13,20
24162,0,0,8,13,21
24163,0,0,5,8,13
24164,0,1,4,12,17
24165,0,0,3,13,16
24166,0,0,4,1,5
24167,0,0,4,17,21
24168,0,0,5,6,11
24169,0,0,6,7,13
24171,0,0,3,7,10
24173,0,0,3,5,8
24174,0,0,4,9,13
24175,0,0,2,8,10
24176,0,1,10,39,50
24177,0,1,4,12,17
24178,0,1,4,4,9
24179,0,0,2,7,9
24180,0,0,2,4,6
24181,0,0,6,19,25
24182,0,0,6,6,12
24183,0,0,6,8,14
24184,0,0,4,9,13
24185,0,0,2,3,5
24186,0,0,4,9,13
24187,0,0,6,2,8
24189,0,1,7,10,18
24190,0,0,2,8,10
24191,0,0,7,13,20
24192,0,0,5,11,16
24193,0,0,2,6,8
24194,0,0,4,24,28
24195,0,1,8,21,30
24196,0,1,4,9,14
24197,0,0,5,7,12
24198,0,0,4,10,14
24199,0,1,6,11,18
24200,0,1,3,8,12
24201,0,0,2,15,17
24202,0,0,11,9,20
24203,0,0,6,20,26
24204,0,0,5,22,27
24206,3,0,4,21,28
24207,0,0,1,15,16
24208,0,0,1,9,10
24209,0,0,1,5,6
24211,0,0,14,16,30
24212,0,0,3,20,23
24213,0,0,1,0,1
24214,0,0,7,6,13
24215,0,0,2,7,9
24216,0,0,12,31,43
24217,0,0,5,19,24
24218,2,4,0,13,19
24219,2,0,1,12,15
24220,0,0,10,12,22
24221,0,1,6,11,18
24222,0,0,1,0,1
24223,0,0,1,7,8
24224,0,0,1,5,6
24226,0,0,2,8,10
24227,0,0,15,26,41
24228,0,0,9,26,35
24229,0,0,8,13,21
24230,0,0,8,2,10
24231,0,1,3,8,12
24232,0,0,9,9,18
24234,0,0,5,12,17
24235,0,0,9,8,17
24236,0,0,11,9,20
24237,0,0,5,11,16
24238,0,0,9,19,28
24239,0,0,3,6,9
24240,0,0,10,6,16
24241,0,0,6,11,17
24242,0,0,1,4,5
24244,0,2,2,12,16
24245,0,0,1,8,9
24246,0,0,7,25,32
24247,0,0,5,7,12
24248,0,0,5,25,30
24249,0,0,5,12,17
24250,0,0,4,7,11
24251,0,0,5,10,15
24253,0,0,9,8,17
24254,0,4,9,11,24
24255,0,0,6,6,12
24256,0,0,1,8,9
24257,0,0,8,18,26
24258,0,0,6,9,15
24259,0,1,1,14,16
24260,0,2,16,30,48
24261,0,0,6,8,14
24263,0,1,3,33,37
24264,0,0,1,10,11
24265,1,0,6,15,22
24266,0,0,1,2,3
24267,0,3,12,32,47
24268,0,0,2,9,11
24269,0,0,0,23,23
24270,1,0,3,12,16
24271,0,0,1,4,5
24272,0,0,3,8,11
24273,0,0,4,8,12
24274,1,0,1,5,7
24275,0,2,6,13,21
24276,0,1,6,39,46
24277,0,1,0,9,10
24278,1,0,6,7,14
24279,0,0,0,7,7
24280,0,2,7,17,26
24281,0,1,3,3,7
24282,0,1,12,37,50
24283,0,0,6,33,39
24284,0,0,11,20,31
24285,1,1,3,12,17
24286,0,0,13,35,48
24288,0,0,4,18,22
24290,0,0,2,30,32
24291,0,0,0,5,5
24292,0,0,15,35,50
24293,0,0,1,12,13
24294,0,0,6,21,27
24295,0,1,10,31,42
24296,0,1,9,16,26
24297,0,0,6,15,21
24298,0,0,9,24,33
24299,0,2,2,39,43
24300,0,0,9,25,34
24301,1,1,6,39,47
24302,0,1,8,14,23
24303,1,1,12,33,47
24304,0,0,0,10,10
24305,0,0,6,12,18
24306,0,1,17,27,45
24307,0,1,5,16,22
24308,1,0,4,11,16
24309,0,0,7,20,27
24310,0,0,8,5,13
24311,0,0,1,18,19
24312,0,2,6,10,18
24313,0,0,0,1,1
24314,1,0,3,3,7
24315,0,0,2,4,6
24316,1,0,0,9,10
24317,0,2,2,12,16
24318,0,1,6,39,46
24319,0,0,8,8,16
24320,0,0,5,13,18
24321,0,0,0,7,7
24322,0,0,10,6,16
24323,0,0,2,3,5
24325,0,0,14,21,35
24326,0,0,0,6,6
24327,0,1,13,22,36
24328,1,1,3,12,17
24329,0,0,10,31,41
24330,0,2,1,12,15
24331,0,0,2,3,5
24332,0,0,8,23,31
24333,0,0,1,18,19
24334,0,0,0,21,21
24337,0,0,6,13,19
24339,1,0,13,36,50
24340,1,4,0,14,19
24342,0,0,5,12,17
24343,1,0,13,36,50
24344,0,0,9,26,35
24345,0,0,0,5,5
24346,0,0,0,7,7
24348,0,0,6,5,11
24349,0,0,1,1,2
24350,0,0,0,5,5
24351,0,0,3,10,13
24352,0,0,12,21,33
24353,0,0,4,15,19
24354,0,0,5,10,15
24355,0,1,4,45,50
24356,0,0,3,11,14
24357,0,0,1,3,4
24358,0,0,1,19,20
24359,0,0,10,5,15
24360,2,3,1,23,29
24361,0,0,1,1,2
24362,0,1,4,5,10
24363,0,0,3,9,12
24364,0,0,2,6,8
24366,0,0,4,23,27
24367,0,1,6,39,46
24368,0,0,5,8,13
24369,0,2,6,14,22
24371,0,0,6,6,12
24372,0,0,6,9,15
24373,0,1,14,34,49
24374,0,0,1,11,12
24375,0,1,2,21,24
24376,0,0,0,2,2
24377,0,0,10,7,17
24378,1,0,7,8,16
24379,0,2,7,37,46
24380,0,0,4,4,8
24381,0,0,0,5,5
24382,0,0,2,8,10
24383,0,0,10,17,27
24384,0,0,5,2,7
24385,0,0,1,8,9
24386,0,0,11,17,28
24387,0,0,3,5,8
24388,0,1,2,5,8
24389,0,0,0,5,5
24390,0,0,6,5,11
24391,0,0,7,9,16
24392,0,0,5,18,23
24394,0,2,5,12,19
24396,0,0,0,7,7
24397,0,0,1,10,11
24398,0,1,14,35,50
24399,1,0,2,14,17
24400,0,1,12,37,50
24401,0,0,3,17,20
24402,0,0,9,15,24
24403,0,1,9,10,20
24404,0,0,5,18,23
24405,0,1,4,45,50
24406,0,0,3,8,11
24407,0,1,5,20,26
24408,0,1,6,28,35
24410,0,0,2,6,8
24411,0,0,2,3,5
24412,0,1,6,39,46
24413,0,5,5,23,33
24414,0,0,3,15,18
24415,0,0,10,26,36
24416,0,0,10,5,15
24418,0,2,5,12,19
24419,0,0,11,17,28
24420,0,0,0,7,7
24421,1,0,2,14,17
24422,0,0,1,13,14
24424,0,0,1,4,5
24425,0,0,3,7,10
24426,1,1,1,17,20
24427,0,0,12,23,35
24428,0,0,8,7,15
24429,0,0,5,28,33
24430,0,0,5,45,50
24431,1,1,8,22,32
24432,0,1,15,34,50
24433,0,0,2,13,15
24434,0,0,6,16,22
24435,1,2,6,40,49
24436,0,0,3,11,14
24437,0,0,5,8,13
24438,1,1,1,17,20
24439,0,0,6,19,25
24440,1,0,6,19,26
24441,0,0,3,16,19
24442,0,1,12,35,48
24443,0,0,1,20,21
24444,1,0,5,23,29
24445,0,0,4,10,14
24446,1,1,11,22,35
24447,0,0,11,21,32
24448,1,0,1,22,24
24449,0,1,2,15,18
24450,2,0,2,27,31
24451,0,1,5,10,16
24452,0,0,5,19,24
24453,0,0,3,11,14
24454,0,0,4,2,6
24455,0,0,2,7,9
24456,0,0,7,24,31
24457,0,0,9,9,18
24458,1,0,5,23,29
24459,0,0,14,24,38
24460,0,1,5,27,33
24461,0,0,4,10,14
24462,0,0,7,14,21
24463,0,0,5,5,10
24464,0,0,4,9,13
24465,0,0,4,9,13
24466,0,0,4,26,30
24467,0,0,3,8,11
24468,0,0,0,7,7
24469,0,0,0,8,8
24470,0,0,4,2,6
24471,0,0,1,11,12
24472,0,0,6,4,10
24473,0,0,9,16,25
24475,0,0,11,24,35
24476,0,0,1,24,25
24477,0,0,5,45,50
24478,0,0,3,6,9
24479,0,0,4,15,19
24480,0,0,0,7,7
24481,0,0,1,10,11
24482,0,0,7,12,19
24483,0,2,2,8,12
24484,0,0,3,7,10
24485,0,0,7,4,11
24486,0,0,12,29,41
24487,0,0,0,7,7
24488,0,0,4,15,19
24489,0,0,8,13,21
24490,0,0,5,14,19
24491,0,0,0,21,21
24492,0,0,0,8,8
24493,0,0,9,16,25
24494,0,0,2,12,14
24495,0,0,7,10,17
24496,0,0,5,9,14
24497,0,0,1,8,9
24498,0,0,7,4,11
24499,0,0,0,6,6
24500,0,0,4,10,14
24501,0,0,3,6,9
24502,0,0,3,7,10
24503,0,0,0,7,7
24504,1,0,1,8,10
24506,0,0,11,19,30
24507,0,0,4,18,22
24508,0,0,4,1,5
24509,0,0,9,14,23
24510,0,0,3,6,9
24511,0,0,14,18,32
24512,0,0,4,17,21
24513,0,0,0,8,8
24514,0,0,7,19,26
24515,0,0,3,4,7
24516,0,0,9,10,19
24517,0,0,11,16,27
24518,0,0,6,15,21
24519,1,0,1,8,10
24522,1,0,1,3,5
24524,0,0,1,9,10
24527,0,0,4,3,7
24528,0,0,5,7,12
24529,0,0,7,4,11
24530,0,0,7,16,23
24532,0,1,4,8,13
24533,0,0,2,3,5
24534,0,0,0,6,6
24535,1,0,3,12,16
24536,0,0,10,6,16
24537,1,1,10,8,20
24538,0,1,6,35,42
24539,0,0,3,10,13
24540,1,1,8,36,46
24541,0,1,4,22,27
24542,0,0,0,5,5
24543,1,3,16,26,46
24544,0,0,5,15,20
24545,0,2,11,35,48
24546,0,0,5,45,50
24548,0,0,8,17,25
24549,0,0,7,12,19
24550,0,0,2,3,5
24551,0,0,6,16,22
24552,0,0,7,24,31
24553,0,0,2,6,8
24554,0,0,3,11,14
24555,1,0,3,22,26
24556,0,0,3,9,12
24557,1,0,5,44,50
24558,0,0,6,14,20
24559,0,0,10,17,27
24560,0,0,1,17,18
24561,0,0,1,9,10
24562,0,0,17,33,50
24563,0,0,4,12,16
24564,0,0,2,15,17
24565,0,0,2,14,16
24567,0,1,6,43,50
24568,0,0,1,5,6
24569,1,0,5,11,17
24570,0,0,3,7,10
24571,1,0,9,26,36
24572,2,0,1,26,29
24573,0,0,7,27,34
24574,1,0,0,7,8
24576,0,0,3,7,10
24578,1,1,1,20,23
24579,0,0,5,1,6
24580,0,0,12,23,35
24581,0,1,2,19,22
24582,0,0,1,3,4
24583,0,0,7,19,26
24585,0,0,5,12,17
24586,1,1,10,8,20
24587,0,0,2,4,6
24588,0,0,7,19,26
24589,0,0,1,0,1
24590,0,0,0,7,7
24591,0,0,13,21,34
24592,0,0,10,18,28
24593,0,0,6,24,30
24594,0,0,2,14,16
24595,0,0,1,12,13
24596,0,0,3,17,20
24597,0,0,1,0,1
24598,0,0,7,10,17
24599,1,2,5,41,49
24600,0,0,5,8,13
24601,1,2,5,41,49
24602,0,0,7,10,17
24603,1,2,5,41,49
24604,1,2,5,41,49
24605,0,0,7,10,17
24606,0,0,8,23,31
24607,0,0,3,12,15
24608,0,0,4,5,9
24610,0,1,11,11,23
24611,0,0,6,13,19
24612,0,0,3,9,12
24613,0,0,6,8,14
24614,0,0,9,16,25
24615,0,0,9,16,25
24616,0,0,0,5,5
24617,0,1,16,33,50
24618,0,1,6,20,27
24619,0,1,9,8,18
24620,0,0,14,14,28
24621,0,2,3,8,13
24622,0,0,6,12,18
24623,0,0,4,3,7
24624,0,1,16,33,50
24625,0,1,8,13,22
24626,0,0,2,21,23
24628,0,0,3,10,13
24629,2,0,7,17,26
24630,0,0,4,5,9
24631,0,0,12,10,22
24632,0,0,3,3,6
24633,0,0,6,2,8
24634,0,0,5,2,7
24635,0,1,6,15,22
24636,0,0,6,5,11
24637,0,0,5,4,9
24638,0,1,18,25,44
24639,0,0,4,5,9
24640,0,1,6,4,11
24641,0,0,3,7,10
24642,0,1,6,20,27
24643,0,0,10,35,45
24644,0,0,7,17,24
24645,0,0,3,10,13
24646,0,1,5,1,7
24647,0,0,5,4,9
24648,0,2,12,33,47
24649,0,0,7,9,16
24650,0,0,2,4,6
24651,0,0,1,10,11
24652,0,0,7,10,17
24653,0,0,3,3,6
24654,0,1,3,5,9
24655,1,0,6,4,11
24656,1,2,5,41,49
24657,0,0,0,2,2
24658,0,0,3,10,13
24659,0,1,2,13,16
24661,0,0,3,8,11
24662,0,1,1,9,11
24664,0,1,17,32,50
24665,0,0,15,20,35
24666,2,1,10,17,30
24667,0,0,7,10,17
24668,0,0,7,9,16
24669,0,0,12,12,24
24670,0,0,6,18,24
24671,0,0,9,16,25
24672,0,0,8,42,50
24673,0,0,9,26,35
24674,0,2,12,33,47
24675,1,2,5,41,49
24677,0,0,8,6,14
24678,0,1,1,9,11
24679,0,0,3,10,13
24680,1,2,5,41,49
24681,0,1,1,9,11
24683,1,2,5,41,49
24685,0,0,3,8,11
24687,0,1,1,9,11
24689,0,0,15,20,35
24690,0,1,2,13,16
24691,0,2,12,33,47
24692,0,0,5,2,7
24693,0,1,17,32,50
24694,0,0,7,10,17
24695,0,0,0,5,5
24697,0,0,12,12,24
24698,0,0,4,4,8
24699,0,0,8,13,21
24701,0,1,3,12,16
24702,0,0,11,30,41
24703,0,0,7,10,17
24704,1,1,15,25,42
24705,0,0,5,5,10
24706,0,3,3,14,20
24707,0,0,7,6,13
24708,0,0,10,7,17
24709,0,2,7,18,27
24710,0,0,8,13,21
24711,0,0,8,13,21
24712,0,0,11,10,21
24713,0,0,16,26,42
24714,1,0,8,25,34
24715,0,2,12,33,47
24716,0,0,4,5,9
24717,1,1,15,25,42
24718,0,0,5,7,12
24719,0,0,8,9,17
24720,0,0,6,13,19
24721,0,0,13,14,27
24722,0,0,2,4,6
24723,0,0,8,2,10
24724,0,0,4,5,9
24725,0,0,8,11,19
24726,0,0,18,31,49
24727,0,0,11,10,21
24728,0,0,2,6,8
24730,0,0,6,6,12
24731,0,0,3,21,24
24732,0,0,3,7,10
24733,0,2,1,5,8
24734,0,0,8,2,10
24735,0,0,2,3,5
24736,0,0,4,8,12
24737,0,0,6,6,12
24738,0,0,6,6,12
24739,0,1,10,13,24
24740,0,0,4,2,6
24741,0,0,8,12,20
24743,0,0,5,7,12
24744,0,0,3,7,10
24745,1,0,22,26,49
24746,0,0,8,12,20
24747,0,0,3,10,13
24748,0,0,6,10,16
24749,2,2,7,35,46
24751,0,0,7,3,10
24752,0,1,10,22,33
24753,0,0,8,15,23
24754,0,1,6,6,13
24755,0,0,3,6,9
24756,0,0,7,3,10
24757,1,0,22,26,49
24758,0,0,3,8,11
24760,0,0,5,18,23
24762,0,0,8,28,36
24763,0,1,0,4,5
24764,0,0,3,12,15
24765,0,1,2,13,16
24766,0,0,5,5,10
24767,0,0,3,10,13
24768,0,0,4,4,8
24769,0,0,11,19,30
24770,2,0,7,17,26
24771,0,0,5,4,9
24772,0,0,3,4,7
24773,0,0,13,23,36
24774,0,0,11,9,20
24775,0,0,3,6,9
24776,0,0,4,9,13
24777,0,0,7,11,18
24779,1,0,4,4,9
24780,0,0,7,10,17
24781,0,0,5,16,21
24782,0,1,8,5,14
24783,0,0,3,4,7
24784,0,0,4,3,7
24785,0,0,7,26,33
24786,0,1,10,24,35
24788,0,0,6,10,16
24789,0,0,2,6,8
24791,0,0,4,3,7
24792,0,0,8,11,19
24793,0,0,2,0,2
24795,1,0,12,17,30
24796,0,0,3,4,7
24797,0,0,4,10,14
24799,0,1,14,31,46
24800,0,0,4,7,11
24801,0,0,11,26,37
24802,0,0,13,18,31
24803,0,0,8,13,21
24804,0,1,9,35,45
24805,1,1,9,11,22
24806,0,0,13,35,48
24807,1,0,15,33,49
24808,0,2,5,1,8
24809,0,1,11,27,39
24810,0,0,10,18,28
24811,0,0,13,35,48
24812,0,0,14,36,50
24813,0,1,8,30,39
24814,0,0,5,15,20
24815,0,0,13,16,29
24816,0,0,6,5,11
24817,0,0,11,31,42
24818,0,1,3,5,9
24819,1,0,8,12,21
24820,0,0,12,37,49
24821,0,0,9,16,25
24822,0,0,12,38,50
24823,0,0,19,25,44
24824,0,0,6,6,12
24825,0,0,15,33,48
24826,0,0,18,32,50
24827,0,0,5,18,23
24828,1,1,9,21,32
24829,0,0,12,26,38
24830,0,0,9,21,30
24831,0,0,8,11,19
24832,0,2,12,33,47
24834,0,0,9,16,25
24835,0,0,7,13,20
24836,1,1,15,25,42
24838,0,0,13,22,35
24839,0,0,12,25,37
24840,0,0,9,14,23
24842,1,0,5,43,49
24843,0,0,1,0,1
24844,0,0,13,35,48
24845,1,0,5,43,49
24846,1,2,10,35,48
24849,0,0,3,8,11
24850,0,0,11,26,37
24853,0,2,12,33,47
24855,0,1,2,13,16
24856,0,0,2,4,6
24857,0,0,3,3,6
24859,0,0,4,4,8
24860,0,0,3,14,17
24861,0,0,7,15,22
24862,0,1,7,14,22
24863,0,2,10,27,39
24864,0,0,8,8,16
24865,0,1,5,6,12
24866,0,1,14,15,30
24867,0,1,6,9,16
24868,0,0,3,2,5
24869,0,0,4,8,12
24870,0,0,4,8,12
24871,0,0,8,10,18
24872,0,0,6,19,25
24873,0,1,9,22,32
24874,0,0,2,4,6
24875,0,0,6,17,23
24876,0,0,3,6,9
24877,0,1,6,6,13
24878,0,1,4,7,12
24879,0,0,1,8,9
24880,0,1,1,3,5
24881,0,1,11,19,31
24882,0,0,1,8,9
24883,0,0,9,5,14
24884,0,1,5,2,8
24885,0,0,5,3,8
24886,0,0,6,2,8
24887,0,1,16,33,50
24888,0,0,6,12,18
24889,0,0,9,21,30
24890,0,0,2,8,10
24891,0,1,6,9,16
24892,0,0,4,1,5
24893,0,2,15,17,34
24894,0,0,9,23,32
24895,0,3,5,15,23
24896,0,1,4,11,16
24897,0,0,6,8,14
24898,0,0,9,17,26
24899,0,0,7,17,24
24900,0,2,9,39,50
24902,1,1,13,34,49
24903,0,0,6,22,28
24904,0,1,4,14,19
24905,0,0,4,2,6
24906,0,1,4,8,13
24907,0,0,2,8,10
24908,0,3,6,18,27
24909,0,0,10,3,13
24910,0,0,4,10,14
24911,0,1,11,11,23
24912,0,2,8,21,31
24913,0,0,4,4,8
24915,0,0,9,21,30
24916,0,0,14,25,39
24917,0,0,7,31,38
24918,0,0,14,24,38
24919,0,0,8,10,18
24920,0,0,12,22,34
24921,0,0,7,14,21
24922,0,0,4,17,21
24923,0,0,6,9,15
24925,0,0,1,14,15
24926,0,0,11,19,30
24927,0,1,1,3,5
24928,0,0,15,35,50
24929,0,0,11,27,38
24930,0,0,8,4,12
24931,0,0,2,13,15
24932,0,0,19,31,50
24933,0,0,7,31,38
24934,0,0,13,14,27
24935,0,1,10,30,41
24936,0,0,12,12,24
24937,0,0,6,8,14
24938,0,2,9,39,50
24939,0,0,6,14,20
24940,0,0,12,25,37
24941,0,2,8,21,31
24942,0,0,15,20,35
24943,0,0,4,10,14
24944,0,0,11,13,24
24945,1,0,17,27,45
24946,0,0,11,19,30
24947,0,0,5,9,14
24948,0,0,11,29,40
24949,1,0,17,27,45
24950,0,0,15,20,35
24951,0,0,8,13,21
24952,1,0,8,21,30
24953,0,0,6,19,25
24954,0,0,2,21,23
24955,0,0,5,4,9
24956,0,0,1,8,9
24957,0,1,6,18,25
24958,0,0,8,6,14
24959,0,0,0,1,1
24960,0,0,6,13,19
24961,0,0,5,7,12
24962,0,0,3,3,6
24963,0,1,7,42,50
24964,1,0,7,23,31
24965,0,0,13,21,34
24966,0,0,5,9,14
24967,0,0,3,8,11
24968,1,0,14,34,49
24969,1,0,8,21,30
24971,0,0,1,14,15
24972,0,0,6,5,11
24973,0,0,1,17,18
24974,0,0,8,30,38
24975,0,0,3,3,6
24976,0,0,13,30,43
24977,0,0,3,12,15
24978,0,0,8,15,23
24979,0,1,7,42,50
24980,0,0,3,8,11
24981,1,2,4,43,50
24982,0,2,4,22,28
24983,0,1,7,9,17
24984,1,1,13,29,44
24985,0,0,6,32,38
24986,0,2,4,7,13
24987,0,0,6,13,19
24988,0,0,3,8,11
24989,0,0,7,13,20
24990,0,0,5,19,24
24991,0,0,4,5,9
24992,0,0,7,10,17
24993,0,0,6,5,11
24994,0,0,4,5,9
24995,0,2,4,7,13
24996,0,0,4,11,15
24997,0,0,4,5,9
24999,0,0,5,1,6
25000,0,0,12,38,50
25001,0,0,2,1,3
25002,0,0,0,4,4
25003,1,1,4,20,26
25004,0,0,6,5,11
25005,0,0,4,5,9
25006,1,0,9,25,35
25007,0,2,4,22,28
25009,0,0,8,13,21
25010,0,0,4,44,48
25011,0,0,1,5,6
25012,0,0,2,6,8
25013,0,0,7,8,15
25014,0,0,12,21,33
25015,0,0,11,11,22
25016,0,0,12,12,24
25017,0,0,9,13,22
25018,1,0,2,6,9
25019,0,0,6,5,11
25020,0,0,6,11,17
25021,0,0,8,33,41
25022,0,0,11,34,45
25023,0,0,12,18,30
25024,0,0,14,30,44
25025,0,0,10,21,31
25026,0,0,13,16,29
25027,0,0,11,19,30
25028,0,0,8,12,20
25029,0,0,7,6,13
25030,0,0,0,8,8
25031,0,0,8,25,33
25032,0,0,2,26,28
25033,0,0,4,10,14
25034,0,0,11,19,30
25035,1,0,7,18,26
25036,0,2,3,25,30
25037,0,0,6,10,16
25038,0,0,8,33,41
25039,1,0,0,20,21
25040,0,0,3,5,8
25041,0,1,17,32,50
25043,0,0,9,15,24
25044,0,1,2,6,9
25045,0,0,1,4,5
25046,0,2,9,39,50
25047,0,1,8,41,50
25048,0,3,3,14,20
25049,0,0,12,19,31
25050,0,0,3,14,17
25051,0,1,4,12,17
25052,0,0,15,17,32
25053,0,0,2,15,17
25054,0,0,5,9,14
25055,0,0,9,7,16
25056,0,0,4,8,12
25057,0,0,5,12,17
25058,0,0,3,7,10
25059,0,0,7,15,22
25060,0,0,1,16,17
25061,0,0,5,27,32
25062,0,0,8,8,16
25063,0,0,3,7,10
25064,0,0,8,7,15
25065,1,1,15,25,42
25066,0,0,10,35,45
25067,0,0,12,20,32
25068,0,0,8,11,19
25069,0,0,3,10,13
25071,1,1,2,23,27
25072,0,0,5,8,13
25073,0,0,18,8,26
25074,0,0,19,25,44
25075,0,0,6,37,43
25076,0,0,4,7,11
25077,0,0,3,14,17
25078,0,0,20,26,46
25079,0,0,9,16,25
25080,0,0,8,11,19
25081,0,0,11,24,35
25082,0,0,9,21,30
25083,0,1,14,24,39
25084,0,0,3,10,13
25085,1,1,15,25,42
25086,0,1,2,6,9
25087,0,0,3,11,14
25088,0,2,9,39,50
25090,0,0,2,13,15
25091,0,0,2,4,6
25092,0,1,12,20,33
25093,0,0,3,6,9
25094,0,2,5,11,18
25095,0,3,4,25,32
25096,0,0,8,27,35
25097,0,0,8,13,21
25098,0,0,12,16,28
25099,0,0,10,17,27
25100,0,0,9,9,18
25101,0,0,17,30,47
25102,0,0,7,8,15
25103,0,1,16,33,50
25104,0,0,2,3,5
25105,0,0,2,7,9
25106,0,0,4,9,13
25107,0,0,7,11,18
25108,0,0,2,25,27
25109,0,0,13,28,41
25110,0,0,18,28,46
25111,0,0,4,1,5
25112,0,1,11,19,31
25114,0,0,1,10,11
25115,0,0,6,8,14
25116,0,0,12,18,30
25117,0,0,7,4,11
25118,0,0,7,16,23
25119,0,0,5,32,37
25120,0,0,14,31,45
25121,0,0,2,3,5
25122,0,0,4,7,11
25123,0,0,9,24,33
25124,0,0,5,21,26
25125,0,0,13,30,43
25126,0,0,1,10,11
25127,0,1,5,17,23
25128,0,0,4,7,11
25129,0,1,5,15,21
25130,0,0,9,23,32
25131,0,0,7,15,22
25132,0,0,7,4,11
25133,0,0,4,8,12
25134,0,0,6,4,10
25135,0,0,2,11,13
25136,0,0,5,17,22
25137,0,0,15,32,47
25138,0,0,8,22,30
25139,0,0,3,3,6
25140,0,0,4,15,19
25141,0,0,5,0,5
25142,0,0,2,15,17
25143,0,0,4,2,6
25144,0,0,6,8,14
25145,0,0,6,6,12
25146,0,0,6,7,13
25147,0,0,7,21,28
25148,0,0,7,16,23
25149,0,1,8,13,22
25150,0,0,8,12,20
25151,0,0,2,2,4
25152,0,1,8,18,27
25153,0,0,3,3,6
25154,0,1,3,15,19
25155,0,0,6,8,14
25156,0,0,7,15,22
25157,0,0,7,9,16
25158,0,0,15,30,45
25159,0,0,4,9,13
25161,0,1,10,22,33
25162,0,0,6,8,14
25163,0,0,7,14,21
25164,0,1,7,13,21
25165,0,0,3,6,9
25166,0,1,11,8,20
25167,0,1,3,15,19
25168,0,0,4,9,13
25169,0,0,3,1,4
25170,0,0,6,8,14
25171,0,0,2,13,15
25172,0,0,7,14,21
25173,0,1,10,22,33
25174,0,0,4,17,21
25175,1,2,6,5,14
25176,0,0,13,20,33
25177,0,1,5,14,20
25178,0,0,1,4,5
25179,0,0,4,8,12
25180,0,0,6,12,18
25181,0,0,3,6,9
25183,0,0,3,6,9
25184,0,0,3,5,8
25185,0,0,8,20,28
25186,0,0,6,9,15
25187,0,0,6,12,18
25188,0,1,15,25,41
25189,0,0,4,17,21
25190,0,0,3,1,4
25191,0,1,1,9,11
25192,0,0,11,28,39
25193,0,0,5,9,14
25194,0,0,5,18,23
25195,0,0,7,19,26
25196,0,0,12,14,26
25197,0,0,8,15,23
25198,0,0,5,2,7
25199,0,1,2,13,16
25200,1,2,12,23,38
25201,0,0,5,16,21
25202,0,0,8,10,18
25204,0,0,6,13,19
25205,0,0,3,1,4
25206,0,0,5,18,23
25207,0,0,9,24,33
25208,0,0,12,14,26
25209,0,0,16,33,49
25210,0,1,8,14,23
25211,0,0,5,24,29
25212,0,0,13,34,47
25213,0,0,7,19,26
25214,2,1,10,17,30
25215,0,2,12,33,47
25216,0,0,7,10,17
25218,0,0,2,4,6
25219,1,0,2,9,12
25220,0,0,8,21,29
25221,0,0,15,21,36
25222,0,2,3,39,44
25223,0,0,8,13,21
25224,0,1,8,13,22
25225,1,1,15,27,44
25226,1,0,6,27,34
25227,0,0,7,13,20
25228,0,0,10,12,22
25229,0,0,14,33,47
25230,0,0,14,19,33
25231,0,0,9,18,27
25232,0,0,17,33,50
25233,0,0,7,12,19
25234,0,0,7,16,23
25235,0,0,6,7,13
25236,0,0,2,10,12
25237,0,0,3,4,7
25239,0,0,13,20,33
25240,0,0,9,31,40
25241,0,0,6,12,18
25242,0,0,9,12,21
25243,0,0,6,6,12
25244,1,1,15,22,39
25245,0,0,4,4,8
25246,0,0,10,23,33
25247,0,1,2,13,16
25248,0,1,10,22,33
25249,0,0,5,2,7
25250,0,0,5,6,11
25251,0,2,16,29,47
25252,0,0,7,9,16
25253,1,0,11,30,42
25254,0,1,7,14,22
25255,0,0,5,15,20
25256,0,0,12,19,31
25257,1,0,7,9,17
25258,0,0,1,3,4
25259,0,1,11,10,22
25260,0,3,12,16,31
25261,0,0,10,23,33
25262,0,0,13,37,50
25263,0,0,1,0,1
25264,0,0,7,10,17
25265,0,0,9,16,25
25266,2,1,10,17,30
25267,0,2,12,33,47
25268,0,0,8,11,19
25269,0,1,1,9,11
25270,2,0,5,18,25
25271,0,1,1,9,11
25272,1,0,11,30,42
25273,0,0,8,31,39
25274,0,1,1,9,11
25275,0,2,12,33,47
25276,0,0,7,10,17
25277,0,1,3,12,16
25278,0,0,2,15,17
25280,0,1,7,21,29
25281,0,1,2,31,34
25282,0,0,2,4,6
25283,0,0,14,31,45
25284,0,1,1,10,12
25285,0,0,5,10,15
25287,0,0,2,5,7
25288,0,0,2,5,7
25289,0,1,18,27,46
25291,0,0,4,7,11
25292,0,0,2,15,17
25293,0,0,3,2,5
25294,0,0,8,33,41
25295,0,0,4,9,13
25296,0,0,4,5,9
25297,0,0,8,2,10
25298,0,0,4,14,18
25299,0,0,3,8,11
25300,0,0,3,1,4
25301,0,0,5,6,11
25302,0,0,2,31,33
25304,0,0,3,6,9
25305,0,0,7,9,16
25306,0,0,0,7,7
25307,0,0,2,5,7
25308,0,0,0,1,1
25309,0,0,6,6,12
25310,0,0,2,4,6
25311,0,2,14,23,39
25312,0,0,15,16,31
25313,0,1,5,12,18
25314,0,0,10,12,22
25315,0,2,11,18,31
25316,0,1,4,5,10
25317,0,2,2,28,32
25319,0,0,5,22,27
25320,0,0,2,25,27
25321,0,0,2,15,17
25322,0,1,3,12,16
25323,0,0,2,15,17
25324,0,0,15,16,31
25325,0,0,3,12,15
25326,0,0,4,14,18
25327,0,0,4,4,8
25329,0,0,8,6,14
25330,0,0,12,24,36
25331,0,0,1,9,10
25332,0,0,9,22,31
25333,0,1,13,32,46
25334,0,0,4,21,25
25335,0,0,8,30,38
25336,0,3,4,14,21
25337,0,0,6,17,23
25338,0,0,6,0,6
25339,0,0,3,34,37
25340,0,0,8,6,14
25341,0,0,12,24,36
25343,0,0,2,14,16
25344,0,0,2,9,11
25345,0,0,3,8,11
25351,0,0,6,9,15
25352,0,2,12,18,32
25353,0,0,1,12,13
25354,0,0,9,9,18
25355,0,0,8,9,17
25356,1,0,1,16,18
25357,0,0,16,11,27
25359,0,0,6,44,50
25361,0,0,5,5,10
25362,1,0,10,21,32
25363,0,0,4,32,36
25364,0,0,9,40,49
25365,0,1,3,19,23
25366,0,0,11,16,27
25367,0,1,7,7,15
25368,1,0,17,32,50
25369,0,0,2,5,7
25370,0,0,1,4,5
25371,0,0,6,12,18
25372,0,2,4,39,45
25373,0,0,4,4,8
25374,0,0,0,1,1
25375,0,1,0,7,8
25376,0,0,10,34,44
25377,0,0,2,3,5
25378,0,1,9,29,39
25379,0,0,9,10,19
25380,0,0,6,4,10
25381,0,0,10,7,17
25382,0,0,8,26,34
25383,0,0,3,9,12
25384,0,0,9,21,30
25385,1,2,12,35,50
25386,0,0,1,3,4
25387,0,0,4,11,15
25389,0,0,4,5,9
25390,0,0,2,4,6
25391,0,0,4,15,19
25392,0,0,6,9,15
25393,0,0,7,6,13
25394,0,0,3,0,3
25395,0,0,7,6,13
25396,0,0,8,12,20
25397,0,1,17,31,49
25398,0,0,8,8,16
25399,0,0,4,3,7
25400,0,1,7,13,21
25401,0,0,3,17,20
25402,0,1,2,5,8
25403,0,0,3,1,4
25404,0,1,4,18,23
25405,0,1,3,7,11
25406,0,1,6,7,14
25407,0,4,2,18,24
25408,0,0,3,12,15
25409,0,0,1,7,8
25410,0,0,11,21,32
25411,0,0,6,13,19
25412,0,0,7,21,28
25413,0,0,8,17,25
25414,0,0,11,15,26
25416,0,0,4,6,10
25417,0,0,7,13,20
25418,0,2,9,14,25
25419,0,0,7,8,15
25420,0,0,2,14,16
25421,0,0,4,4,8
25422,0,0,8,16,24
25423,0,0,5,10,15
25424,0,2,6,18,26
25425,0,0,9,11,20
25426,0,0,4,11,15
25427,0,0,16,20,36
25428,0,0,1,9,10
25429,0,0,6,8,14
25430,0,0,4,6,10
25431,0,0,3,5,8
25432,0,0,12,8,20
25433,0,1,1,9,11
25435,0,0,7,15,22
25436,0,0,5,7,12
25437,0,0,10,11,21
25438,0,1,11,10,22
25439,0,0,4,2,6
25440,0,0,11,21,32
25441,1,1,5,14,21
25443,0,0,17,23,40
25444,0,0,8,5,13
25445,1,0,6,3,10
25446,0,0,2,5,7
25447,0,0,2,13,15
25448,0,0,17,33,50
25449,0,3,7,37,47
25450,0,0,0,9,9
25451,0,0,9,30,39
25452,0,0,4,11,15
25453,0,0,12,14,26
25454,0,2,6,8,16
25455,0,0,13,20,33
25456,1,0,11,17,29
25457,0,0,11,19,30
25458,0,0,10,16,26
25459,0,0,1,8,9
25460,0,1,4,15,20
25461,1,0,7,31,39
25462,0,0,6,11,17
25463,0,0,11,13,24
25464,0,0,7,3,10
25465,0,0,3,5,8
25466,0,0,9,41,50
25467,0,0,3,7,10
25468,1,0,12,14,27
25469,1,0,11,17,29
25470,0,0,1,8,9
25471,0,0,1,15,16
25472,0,0,11,18,29
25473,0,1,1,9,11
25474,0,0,8,32,40
25475,0,0,14,33,47
25477,0,0,12,25,37
25478,0,0,6,23,29
25479,0,0,14,14,28
25480,0,0,7,16,23
25481,2,0,14,34,50
25482,0,1,15,33,49
25483,1,0,11,17,29
25484,0,0,16,33,49
25486,0,1,1,9,11
25489,0,1,1,9,11
25492,1,5,14,30,50
25493,0,0,5,7,12
25494,0,3,16,20,39
25496,1,1,9,24,35
25499,0,0,5,14,19
25500,0,0,0,3,3
25501,0,0,3,8,11
25502,0,0,3,11,14
25503,0,0,4,12,16
25504,0,0,1,6,7
25505,0,0,13,27,40
25506,0,0,4,13,17
25507,0,1,8,10,19
25508,0,0,10,13,23
25509,0,0,3,5,8
25510,0,0,2,7,9
25511,0,0,10,11,21
25512,0,0,8,9,17
25513,0,0,0,9,9
25514,0,2,10,38,50
25515,0,0,3,10,13
25516,0,1,13,14,28
25517,0,0,12,38,50
25518,0,1,10,39,50
25519,0,2,4,1,7
25520,0,0,11,6,17
25521,0,0,7,16,23
25522,0,0,3,4,7
25523,0,0,10,34,44
25524,1,0,8,20,29
25525,0,0,4,5,9
25526,1,0,9,35,45
25527,0,0,5,6,11
25528,0,0,3,6,9
25529,0,0,2,4,6
25530,0,0,2,5,7
25531,0,0,5,4,9
25532,0,0,2,12,14
25533,0,0,11,12,23
25534,0,0,3,6,9
25535,0,1,5,5,11
25536,0,0,2,3,5
25537,0,0,9,3,12
25538,0,1,14,11,26
25539,0,0,6,6,12
25540,0,0,10,10,20
25541,0,0,11,37,48
25542,0,0,9,15,24
25543,1,1,1,6,9
25544,0,0,2,3,5
25545,0,0,15,18,33
25546,0,5,0,4,9
25547,0,0,8,14,22
25548,0,1,5,14,20
25549,0,0,1,6,7
25550,0,0,0,3,3
25551,1,5,14,30,50
25552,2,0,2,10,14
25553,1,1,3,25,30
25554,3,0,5,36,44
25555,0,0,11,11,22
25556,0,0,4,12,16
25557,0,0,11,19,30
25558,0,0,13,21,34
25559,0,1,12,15,28
25560,0,0,13,37,50
25561,3,0,2,6,11
25562,0,0,11,37,48
25563,0,0,17,32,49
25564,1,1,5,40,47
25565,0,0,2,12,14
25566,1,1,3,25,30
25567,0,2,4,1,7
25568,2,0,2,10,14
25569,0,1,8,10,19
25570,2,0,10,37,49
25571,0,0,9,15,24
25572,0,0,6,2,8
25573,2,10,3,18,33
25574,2,0,10,37,49
25575,1,1,4,28,34
25576,3,0,5,36,44
25577,0,0,8,5,13
25578,0,0,6,9,15
25579,0,0,11,37,48
25580,3,0,5,36,44
25581,2,0,2,10,14
25582,1,1,5,40,47
25583,0,0,11,6,17
25584,0,2,6,3,11
25585,0,0,9,15,24
25586,0,0,6,2,8
25587,2,10,3,18,33
25588,0,0,8,14,22
25589,0,0,5,19,24
25590,0,0,6,9,15
25591,0,1,5,3,9
25593,0,1,6,4,11
25594,0,0,5,5,10
25595,0,0,2,12,14
25596,0,2,7,16,25
25597,0,0,9,9,18
25598,0,0,6,9,15
25599,1,0,5,9,15
25600,0,0,1,9,10
25601,0,0,1,12,13
25602,0,1,4,9,14
25603,0,0,9,8,17
25604,0,1,9,28,38
25605,0,0,5,3,8
25606,3,1,5,28,37
25607,0,1,13,14,28
25608,0,0,3,8,11
25609,0,0,5,14,19
25610,0,2,4,1,7
25611,0,0,3,7,10
25612,0,0,9,21,30
25613,0,1,4,10,15
25614,1,0,5,6,12
25615,0,0,2,13,15
25616,0,0,3,16,19
25617,0,0,0,7,7
25618,0,0,8,12,20
25619,0,0,14,15,29
25620,0,0,9,14,23
25621,0,0,2,6,8
25622,0,0,2,1,3
25623,0,0,1,4,5
25624,0,0,0,5,5
25625,0,0,12,16,28
25626,0,0,9,20,29
25627,0,0,4,14,18
25628,0,3,11,19,33
25629,0,0,2,4,6
25630,0,0,5,14,19
25631,0,2,12,22,36
25632,1,0,5,42,48
25633,0,0,8,6,14
25634,0,0,3,8,11
25635,0,1,15,25,41
25636,0,2,4,9,15
25637,4,0,3,6,13
25638,0,0,8,15,23
25639,0,0,8,8,16
25640,0,0,5,19,24
25641,0,0,3,4,7
25642,0,0,3,8,11
25643,0,1,10,5,16
25644,0,1,4,9,14
25645,0,0,9,7,16
25646,0,0,6,6,12
25647,0,1,17,32,50
25648,0,2,13,12,27
25649,0,0,6,14,20
25650,0,0,6,4,10
25651,0,1,5,12,18
25652,0,0,4,7,11
25654,0,0,2,8,10
25655,0,0,11,9,20
25656,0,1,2,6,9
25657,0,0,9,12,21
25658,0,0,9,7,16
25659,0,1,3,13,17
25660,0,1,2,9,12
25661,0,0,4,5,9
25662,1,0,0,8,9
25666,0,5,9,21,35
25667,1,7,0,9,17
25668,0,0,0,2,2
25669,0,0,8,12,20
25671,0,0,6,7,13
25673,0,0,7,11,18
25674,0,0,11,37,48
25675,0,4,9,37,50
25676,1,0,2,12,15
25677,0,1,8,10,19
25678,0,2,4,19,25
25679,0,1,8,40,49
25680,1,1,3,25,30
25681,0,1,5,3,9
25682,0,1,8,3,12
25683,0,0,5,13,18
25684,0,2,11,33,46
25686,0,1,8,40,49
25687,0,2,1,47,50
25688,4,0,1,6,11
25689,1,1,6,22,30
25690,0,1,8,10,19
25691,0,0,1,13,14
25692,0,0,0,5,5
25693,0,0,7,8,15
25694,5,1,6,29,41
25695,0,0,12,14,26
25696,0,0,9,8,17
25697,0,1,14,33,48
25698,0,2,4,19,25
25699,1,1,17,24,43
25700,0,0,18,32,50
25701,0,0,8,9,17
25702,0,0,4,20,24
25703,0,0,11,32,43
25704,0,0,2,2,4
25705,0,0,7,17,24
25706,0,2,4,1,7
25707,0,1,15,32,48
25708,0,0,9,8,17
25709,0,1,1,6,8
25711,0,0,8,17,25
25712,4,3,5,20,32
25714,0,0,11,37,48
25715,1,0,2,12,15
25716,0,4,9,37,50
25717,1,1,3,25,30
25718,0,2,2,16,20
25719,0,3,7,2,12
25720,4,0,3,6,13
25721,0,0,0,8,8
25722,0,1,13,33,47
25723,0,0,1,13,14
25724,0,0,11,26,37
25725,4,0,1,6,11
25727,0,0,5,16,21
25728,0,2,6,8,16
25729,2,10,3,18,33
25730,4,0,3,6,13
25731,1,7,0,9,17
25732,0,0,21,26,47
25733,0,1,1,26,28
25734,0,0,6,9,15
25735,5,1,6,29,41
25736,0,0,13,16,29
25737,0,4,9,37,50
25738,0,3,7,2,12
25739,5,1,6,29,41
25740,0,4,9,37,50
25741,4,0,1,6,11
25742,0,0,21,26,47
25743,0,0,13,16,29
25744,2,10,3,18,33
25745,0,0,11,37,48
25746,0,5,9,21,35
25747,0,2,2,16,20
25748,4,3,5,20,32
25749,0,3,7,2,12
25750,0,0,2,3,5
25751,0,1,5,3,9
25752,5,0,6,31,42
25753,0,1,1,20,22
25754,0,0,8,18,26
25755,0,0,9,20,29
25756,1,2,11,15,29
25757,0,0,7,23,30
25758,0,0,9,20,29
25759,0,1,10,29,40
25761,0,0,1,7,8
25762,0,0,2,13,15
25763,0,0,2,9,11
25764,0,0,1,8,9
25765,1,0,4,15,20
25766,0,1,8,15,24
25767,0,0,12,22,34
25768,0,0,1,4,5
25769,0,0,1,22,23
25770,0,0,6,4,10
25771,1,0,4,2,7
25772,0,0,5,9,14
25773,0,0,6,9,15
25774,0,0,9,11,20
25775,1,0,11,18,30
25776,0,2,14,33,49
25777,0,3,11,19,33
25778,0,0,3,9,12
25779,0,0,10,12,22
25780,0,0,2,3,5
25781,0,0,4,9,13
25782,0,1,6,6,13
25783,3,4,6,37,50
25784,0,0,8,6,14
25785,0,1,6,15,22
25786,0,0,12,10,22
25787,0,0,3,8,11
25788,0,0,7,34,41
25789,0,0,8,19,27
25791,0,2,8,19,29
25792,3,0,5,22,30
25794,0,0,7,11,18
25795,2,0,10,14,26
25796,0,1,6,16,23
25797,0,2,15,32,49
25798,0,0,0,2,2
25799,0,0,9,27,36
25800,0,0,0,3,3
25801,1,1,1,6,9
25802,0,0,11,20,31
25804,0,0,15,8,23
25805,0,0,4,7,11
25806,0,0,1,2,3
25807,0,0,6,10,16
25808,0,0,7,7,14
25809,3,0,5,22,30
25810,0,0,2,3,5
25811,0,0,20,29,49
25812,0,0,2,5,7
25814,0,0,3,17,20
25815,0,0,4,4,8
25816,0,0,4,6,10
25817,0,0,3,3,6
25818,0,0,5,18,23
25819,0,0,10,17,27
25820,0,0,11,20,31
25821,0,1,8,9,18
25822,0,4,9,37,50
25823,2,0,5,8,15
25824,0,1,5,3,9
25825,0,0,12,38,50
25826,0,0,8,15,23
25827,0,0,2,8,10
25828,0,1,4,9,14
25829,5,0,1,13,19
25830,0,0,11,12,23
25831,0,0,6,19,25
25832,0,0,6,14,20
25833,0,0,14,36,50
25834,0,0,12,32,44
25835,0,0,8,18,26
25836,0,3,8,34,45
25837,0,1,14,35,50
25838,0,0,8,21,29
25839,1,0,11,18,30
25840,0,0,12,38,50
25841,2,1,9,34,46
25842,2,0,5,8,15
25843,0,0,13,37,50
25844,0,1,6,12,19
25845,0,0,8,10,18
25846,2,0,13,35,50
25847,0,0,12,38,50
25848,0,0,12,25,37
25849,2,0,9,39,50
25850,0,0,5,25,30
25851,0,0,0,9,9
25852,0,0,7,10,17
25853,0,0,5,7,12
25854,1,0,6,10,17
25855,0,0,6,11,17
25856,0,0,4,6,10
25857,0,0,4,8,12
25858,2,0,4,5,11
25859,0,0,12,33,45
25860,0,2,2,19,23
25861,0,0,2,2,4
25864,0,0,7,7,14
25865,2,0,10,14,26
25866,0,4,9,37,50
25867,0,0,8,19,27
25868,0,0,9,20,29
25869,0,0,0,18,18
25871,0,0,13,37,50
25872,0,0,2,21,23
25873,0,1,4,9,14
25874,0,0,0,7,7
25875,2,0,13,35,50
25876,2,0,2,21,25
25877,0,4,9,37,50
25878,0,4,9,37,50
25879,1,1,6,31,39
25880,0,0,6,9,15
25881,0,0,5,3,8
25882,0,0,2,3,5
25883,0,0,2,3,5
25884,0,0,2,7,9
25885,0,0,8,14,22
25886,0,0,5,28,33
25887,0,0,4,10,14
25888,0,1,6,42,49
25889,0,1,3,11,15
25890,1,0,1,11,13
25891,0,0,1,8,9
25892,0,1,12,37,50
25893,0,0,1,19,20
25895,0,0,2,8,10
25896,0,0,8,41,49
25897,0,4,12,34,50
25898,0,1,10,39,50
25899,3,0,1,11,15
25900,0,1,1,21,23
25901,0,0,9,3,12
25902,0,0,2,14,16
25903,0,1,10,18,29
25904,3,2,6,27,38
25905,0,0,4,2,6
25906,0,0,8,2,10
25907,0,0,11,38,49
25908,0,0,9,11,20
25909,0,0,3,1,4
25910,0,0,8,14,22
25911,0,0,2,5,7
25912,0,0,3,6,9
25913,0,0,8,9,17
25914,1,0,3,13,17
25915,0,0,0,6,6
25916,0,1,1,16,18
25917,1,0,3,13,17
25918,1,2,13,22,38
25919,1,0,6,23,30
25920,0,1,0,5,6
25922,0,0,3,1,4
25923,0,0,4,8,12
25924,0,0,10,40,50
25925,0,1,7,8,16
25926,4,0,3,6,13
25927,0,0,6,9,15
25929,0,0,4,2,6
25930,0,0,14,20,34
25931,0,0,8,14,22
25932,0,0,13,27,40
25933,0,0,4,20,24
25934,0,0,13,18,31
25935,0,0,13,24,37
25936,0,1,3,11,15
25937,0,0,12,18,30
25938,0,0,1,4,5
25939,0,0,6,2,8
25940,0,0,0,6,6
25941,0,0,4,2,6
25942,0,0,10,40,50
25943,1,1,14,27,43
25944,0,0,8,22,30
25945,2,2,13,33,50
25946,0,1,9,20,30
25947,0,0,2,16,18
25948,0,0,1,12,13
25950,1,1,6,31,39
25951,0,0,0,12,12
25952,5,1,6,29,41
25953,0,2,2,21,25
25954,0,1,4,10,15
25955,4,0,3,6,13
25956,0,0,2,22,24
25957,0,0,1,7,8
25958,0,1,4,10,15
25959,0,0,0,12,12
25960,0,0,2,22,24
25961,1,0,1,11,13
25962,0,0,4,34,38
25963,0,2,2,21,25
25964,0,0,0,17,17
25965,4,0,3,6,13
25966,0,0,1,4,5
25967,0,0,1,5,6
25968,0,0,6,9,15
25969,5,1,6,29,41
25970,0,2,2,21,25
25971,5,1,6,29,41
25972,0,0,6,2,8
25973,0,0,3,9,12
25974,0,0,12,26,38
25975,0,1,7,14,22
25976,0,1,16,29,46
25977,0,0,8,18,26
25978,0,0,12,24,36
25979,0,0,8,26,34
25980,0,0,7,3,10
25981,0,0,1,16,17
25982,0,0,11,14,25
25983,0,0,4,4,8
25984,0,0,5,6,11
25985,0,0,7,27,34
25986,0,0,14,36,50
25987,0,2,12,22,36
25988,0,0,4,2,6
25989,0,0,7,14,21
25990,0,0,5,23,28
25991,0,0,7,4,11
25992,1,0,5,28,34
25993,0,0,3,5,8
25994,0,0,4,6,10
25995,0,2,20,28,50
25996,0,0,4,4,8
25997,0,0,10,12,22
25998,0,0,9,10,19
25999,0,0,11,17,28
26000,0,0,9,10,19
26001,0,0,10,10,20
26002,0,4,9,37,50
26003,2,0,3,22,27
26004,0,0,9,24,33
26005,2,0,1,28,31
26006,0,0,12,24,36
26007,0,0,13,25,38
26008,0,0,7,26,33
26009,1,1,10,29,41
26010,0,1,8,13,22
26011,0,0,15,29,44
26012,0,1,12,30,43
26013,0,0,3,7,10
26014,1,0,6,8,15
26015,1,1,13,35,50
26016,3,1,1,16,21
26017,0,0,9,22,31
26018,0,0,6,14,20
26019,1,0,4,20,25
26020,1,0,1,11,13
26021,0,0,4,10,14
26022,0,0,4,9,13
26023,0,0,16,24,40
26024,0,0,12,18,30
26025,0,0,12,38,50
26026,0,0,11,17,28
26027,0,0,14,35,49
26028,0,4,9,37,50
26029,0,0,1,6,7
26030,0,0,15,25,40
26031,3,1,1,16,21
26032,2,0,1,28,31
26033,0,0,1,6,7
26034,0,0,6,10,16
26035,0,0,21,26,47
26036,0,4,9,37,50
26037,0,4,9,37,50
26038,0,0,7,26,33
26039,0,0,21,26,47
26040,1,1,6,31,39
26041,0,1,5,3,9
26042,0,1,11,22,34
26043,0,0,0,3,3
26044,0,0,6,0,6
26045,0,0,1,10,11
26046,0,0,7,23,30
26047,0,0,3,5,8
26048,0,0,6,16,22
26049,0,0,3,18,21
26050,1,0,10,18,29
26051,0,2,8,11,21
26052,0,1,9,30,40
26053,0,0,0,6,6
26054,0,0,7,25,32
26055,0,0,2,6,8
26056,0,1,11,21,33
26057,0,0,3,8,11
26058,0,0,11,17,28
26059,0,0,9,20,29
26060,0,1,15,24,40
26061,0,0,12,30,42
26062,0,0,4,10,14
26063,0,0,9,15,24
26064,0,0,9,5,14
26065,0,1,7,14,22
26066,0,0,8,11,19
26067,0,0,17,14,31
26068,0,1,14,27,42
26069,0,0,1,7,8
26070,1,1,1,13,16
26071,0,0,4,5,9
26072,0,0,4,25,29
26073,0,0,2,1,3
26074,0,0,4,14,18
26076,0,0,6,9,15
26077,0,0,7,5,12
26078,0,0,8,32,40
26079,0,1,5,20,26
26080,0,0,0,11,11
26081,0,0,5,0,5
26082,0,1,9,20,30
26083,0,0,11,36,47
26084,0,0,2,13,15
26085,0,1,5,6,12
26086,0,0,12,16,28
26087,1,0,6,9,16
26088,0,0,4,13,17
26089,2,0,7,30,39
26090,0,0,9,15,24
26091,1,0,5,42,48
26092,0,0,6,8,14
26094,0,0,2,5,7
26095,0,0,8,12,20
26096,0,1,4,13,18
26097,1,0,7,21,29
26098,0,4,6,18,28
26099,0,1,4,35,40
26100,0,0,5,23,28
26101,0,0,6,13,19
26102,0,0,14,25,39
26103,0,1,10,12,23
26104,5,0,0,10,15
26105,0,0,5,19,24
26107,0,6,12,10,28
26108,0,0,8,13,21
26109,1,0,7,39,47
26110,0,0,4,16,20
26112,0,2,7,25,34
26113,0,0,5,7,12
26115,0,0,13,19,32
26116,0,0,2,7,9
26117,0,0,6,13,19
26118,0,1,8,10,19
26119,0,0,1,20,21
26120,3,2,7,25,37
26121,0,0,4,4,8
26122,0,0,1,1,2
26123,0,0,2,11,13
26124,2,0,0,30,32
26125,0,0,5,10,15
26126,0,0,5,12,17
26127,0,0,3,5,8
26128,0,2,11,18,31
26129,0,1,8,13,22
26131,0,1,3,20,24
26133,0,2,0,23,25
26134,0,0,0,5,5
26136,2,3,10,20,35
26137,0,2,5,19,26
26138,0,0,10,40,50
26139,0,2,4,1,7
26140,0,0,9,8,17
26141,0,0,3,4,7
26142,0,0,0,3,3
26143,0,1,11,22,34
26144,0,0,9,20,29
26145,0,0,8,19,27
26146,0,1,5,3,9
26147,0,4,9,37,50
26148,0,0,1,6,7
26149,1,1,7,21,30
26150,0,1,15,33,49
26151,0,0,7,26,33
26152,0,0,7,43,50
26153,0,1,15,22,38
26155,0,1,10,19,30
26156,0,0,7,23,30
26157,0,0,5,12,17
26158,1,1,3,29,34
26159,0,0,12,38,50
26160,0,1,11,37,49
26161,0,1,15,24,40
26162,0,0,10,13,23
26163,0,1,5,15,21
26164,3,0,3,20,26
26165,0,1,8,13,22
26166,0,2,6,11,19
26167,0,0,8,15,23
26168,0,0,14,25,39
26169,0,0,11,15,26
26170,1,1,3,41,46
26171,1,2,18,28,49
26172,1,0,16,20,37
26173,0,2,5,19,26
26174,0,1,2,10,13
26175,0,0,8,22,30
26176,0,0,10,39,49
26177,0,0,5,15,20
26178,1,0,7,12,20
26180,0,0,10,39,49
26181,1,0,3,9,13
26182,1,1,5,40,47
26183,0,0,10,20,30
26184,0,0,4,11,15
26185,2,3,10,20,35
26186,0,0,2,11,13
26187,3,0,1,9,13
26188,2,0,4,21,27
26189,0,1,5,10,16
26190,0,1,4,25,30
26191,0,0,12,25,37
26192,0,0,3,19,22
26193,2,0,4,17,23
26194,0,0,7,7,14
26195,0,0,11,31,42
26196,0,0,0,2,2
26197,0,0,0,18,18
26198,0,0,15,25,40
26199,0,0,8,11,19
26200,0,0,9,12,21
26201,0,0,15,31,46
26202,0,0,13,37,50
26203,0,0,11,18,29
26204,1,1,19,28,49
26205,0,0,10,8,18
26206,0,0,2,0,2
26207,0,0,5,9,14
26208,0,0,3,9,12
26209,0,0,0,5,5
26210,0,0,16,22,38
26211,0,1,3,19,23
26212,0,0,4,11,15
26213,0,0,9,20,29
26214,0,0,5,12,17
26215,0,0,2,4,6
26216,0,1,1,23,25
26217,0,2,4,1,7
26218,0,6,12,10,28
26219,0,1,4,10,15
26220,0,0,10,40,50
26221,1,1,6,31,39
26222,0,0,8,19,27
26223,0,0,9,15,24
26224,0,0,9,8,17
26225,2,0,10,37,49
26226,0,4,9,37,50
26227,5,0,0,10,15
26228,0,0,2,28,30
26229,3,0,1,9,13
26230,0,2,6,11,19
26231,2,0,10,38,50
26232,1,0,3,16,20
26233,0,0,4,11,15
26234,1,0,6,9,16
26235,1,0,8,16,25
26236,0,0,7,23,30
26237,0,0,10,12,22
26239,0,0,5,12,17
26240,0,0,1,9,10
26241,0,1,13,30,44
26242,0,0,7,10,17
26243,2,1,12,30,45
26244,0,1,4,25,30
26245,0,0,10,20,30
26246,0,0,8,17,25
26247,2,0,4,17,23
26248,0,1,4,10,15
26249,0,0,3,18,21
26250,0,0,10,39,49
26251,2,0,10,37,49
26252,0,4,9,37,50
26253,0,0,7,26,33
26254,0,4,9,37,50
26255,1,1,5,40,47
26256,1,0,3,9,13
26257,0,0,9,15,24
26258,0,1,11,22,34
26259,0,1,7,14,22
26260,0,0,1,29,30
26261,0,0,9,38,47
26262,0,0,3,14,17
26263,0,1,16,29,46
26264,0,0,3,47,50
26265,0,0,3,12,15
26266,0,0,0,14,14
26267,0,0,2,7,9
26269,1,7,2,13,23
26270,0,0,0,6,6
26271,1,0,17,26,44
26272,0,1,11,22,34
26273,0,1,14,20,35
26274,1,1,3,25,30
26275,0,0,3,3,6
26276,0,0,8,18,26
26277,0,0,11,17,28
26278,0,0,4,13,17
26279,3,0,0,12,15
26281,3,1,4,31,39
26282,2,0,5,18,25
26283,0,0,5,12,17
26284,0,0,2,4,6
26285,0,0,4,18,22
26286,1,0,8,27,36
26287,1,0,4,24,29
26288,0,0,10,20,30
26289,0,0,11,21,32
26290,1,0,17,31,49
26291,0,0,4,6,10
26292,5,0,1,13,19
26293,0,0,5,11,16
26294,0,0,8,9,17
26295,0,0,6,25,31
26296,1,0,4,24,29
26297,0,0,1,15,16
26298,0,0,7,23,30
26299,0,0,15,34,49
26300,0,0,8,11,19
26301,0,0,3,9,12
26302,1,2,1,10,14
26303,0,0,8,5,13
26304,0,0,4,18,22
26305,0,0,6,15,21
26306,1,1,3,25,30
26307,0,0,0,13,13
26308,0,0,11,17,28
26309,3,1,4,31,39
26310,1,2,1,18,22
26311,0,0,8,1,9
26312,3,0,0,12,15
26313,1,7,2,13,23
26314,0,0,2,11,13
26315,1,0,4,24,29
26316,1,0,4,24,29
26317,3,1,4,31,39
26318,0,0,1,15,16
26319,0,2,0,23,25
26320,0,0,7,8,15
26321,0,0,3,20,23
26322,0,0,5,1,6
26323,0,0,3,13,16
26324,2,0,5,18,25
26325,1,1,6,31,39
26327,0,1,10,31,42
26328,0,0,13,31,44
26329,0,0,14,36,50
26330,0,0,4,22,26
26331,0,0,6,4,10
26332,0,0,3,21,24
26333,0,1,4,19,24
26334,0,0,11,14,25
26335,0,1,8,40,49
26337,0,0,8,29,37
26338,0,0,5,0,5
26339,0,0,4,13,17
26340,0,0,7,19,26
26341,1,0,4,11,16
26342,0,1,5,18,24
26343,1,0,8,33,42
26344,0,1,2,15,18
26345,0,0,10,7,17
26346,0,0,3,10,13
26347,1,0,13,18,32
26348,0,0,9,13,22
26349,1,1,3,24,29
26350,0,0,9,21,30
26351,0,0,8,9,17
26352,0,0,5,2,7
26353,0,0,6,5,11
26355,0,0,12,9,21
26357,0,0,8,14,22
26358,0,0,20,29,49
26359,0,1,4,30,35
26360,0,0,6,9,15
26361,0,0,2,5,7
26362,0,0,9,19,28
26363,0,0,11,18,29
26364,0,1,3,17,21
26365,0,1,4,9,14
26367,1,0,9,9,19
26369,1,2,4,15,22
26370,1,1,5,38,45
26371,0,0,6,11,17
26372,1,2,11,25,39
26373,0,0,11,31,42
26374,2,0,5,8,15
26375,0,0,9,6,15
26376,0,0,11,28,39
26377,0,0,6,17,23
26378,0,0,4,13,17
26379,0,0,8,2,10
26380,0,0,2,12,14
26381,0,0,1,4,5
26382,4,0,5,10,19
26383,0,1,8,11,20
26384,0,0,14,22,36
26385,0,0,5,2,7
26386,0,0,4,9,13
26387,0,0,14,21,35
26388,0,1,10,10,21
26389,0,0,10,13,23
26391,0,1,6,7,14
26392,0,1,0,4,5
26393,0,1,14,13,28
26394,0,0,5,3,8
26395,0,0,0,1,1
26396,0,0,7,4,11
26397,0,0,8,10,18
26398,0,0,7,10,17
26399,0,0,14,23,37
26400,1,0,7,9,17
26402,0,0,4,3,7
26403,0,0,4,22,26
26404,0,0,1,5,6
26405,0,0,2,14,16
26406,0,2,7,5,14
26407,0,0,5,45,50
26408,3,0,0,12,15
26409,0,6,12,10,28
26410,0,0,1,12,13
26411,0,0,4,3,7
26412,2,0,3,8,13
26413,0,3,16,20,39
26414,2,0,2,10,14
26415,0,0,11,35,46
26416,1,8,1,18,28
26417,2,1,4,23,30
26418,0,0,5,19,24
26419,3,0,7,33,43
26420,0,0,1,12,13
26421,0,2,11,29,42
26422,0,0,7,7,14
26423,0,1,17,28,46
26424,0,0,6,4,10
26425,1,0,6,21,28
26426,0,0,4,19,23
26427,1,0,3,8,12
26428,0,0,12,26,38
26429,0,0,5,6,11
26430,0,0,10,16,26
26431,0,1,1,11,13
26432,0,2,2,21,25
26433,0,0,10,13,23
26434,0,0,1,5,6
26435,0,0,8,21,29
26436,0,0,3,9,12
26437,2,1,13,17,33
26438,0,0,11,21,32
26439,0,2,6,28,36
26440,0,0,7,36,43
26441,0,0,5,27,32
26442,1,2,10,18,31
26443,0,0,4,10,14
26444,0,1,11,34,46
26445,0,1,1,17,19
26446,0,0,3,1,4
26447,1,0,1,6,8
26448,0,1,11,19,31
26449,1,0,5,8,14
26450,0,0,9,29,38
26451,0,0,8,5,13
26453,0,0,5,7,12
26454,0,0,0,6,6
26455,3,0,1,12,16
26456,0,2,12,20,34
26457,0,0,0,5,5
26458,0,0,10,38,48
26459,0,0,3,26,29
26460,0,0,4,12,16
26461,0,0,12,19,31
26462,0,0,4,6,10
26463,0,0,14,32,46
26464,3,0,0,12,15
26465,0,0,8,4,12
26466,0,0,0,7,7
26467,1,14,1,28,44
26468,0,0,3,22,25
26469,3,0,2,19,24
26470,2,0,3,8,13
26471,0,0,7,9,16
26472,2,0,1,34,37
26473,0,0,9,15,24
26474,0,2,2,16,20
26475,2,0,0,19,21
26477,0,0,7,12,19
26478,1,0,3,9,13
26479,1,0,2,10,13
26481,0,0,13,21,34
26482,0,1,8,40,49
26483,0,0,4,14,18
26484,0,2,4,19,25
26485,1,1,6,31,39
26486,2,0,2,10,14
26487,0,6,12,10,28
26488,2,0,5,8,15
26489,0,0,9,12,21
26490,0,2,2,21,25
26491,0,2,6,28,36
26492,3,1,2,19,25
26493,0,1,9,36,46
26494,2,0,0,19,21
26495,0,0,0,4,4
26496,0,0,0,8,8
26497,0,0,13,21,34
26498,1,0,5,15,21
26499,2,0,0,19,21
26500,3,0,7,33,43
26501,0,1,11,25,37
26502,3,1,2,19,25
26503,0,2,2,21,25
26504,2,0,2,10,14
26505,1,0,3,9,13
26506,0,2,2,16,20
26507,0,0,10,12,22
26508,0,0,0,1,1
26509,0,0,0,14,14
26510,0,1,11,25,37
26511,0,0,10,30,40
26512,2,1,5,19,27
26513,2,1,5,38,46
26514,0,0,11,19,30
26515,1,0,13,34,48
26516,0,1,4,18,23
26517,0,2,9,36,47
26518,0,0,1,2,3
26519,1,0,3,10,14
26520,2,3,1,13,19
26521,0,0,6,16,22
26522,0,0,1,4,5
26523,0,0,6,3,9
26524,0,0,4,19,23
26525,0,0,0,10,10
26526,5,0,1,10,16
26527,1,3,6,40,50
26528,0,0,6,38,44
26529,2,1,5,38,46
26530,3,0,14,33,50
26531,2,0,9,35,46
26532,0,1,6,7,14
26533,0,2,10,33,45
26534,0,1,14,35,50
26535,0,0,13,18,31
26536,2,3,1,13,19
26537,1,0,10,30,41
26538,0,0,10,30,40
26539,0,2,10,33,45
26540,1,0,10,30,41
26541,0,0,10,30,40
26542,5,0,1,10,16
26543,0,2,10,33,45
26544,0,0,10,30,40
26545,3,0,14,33,50
26546,0,0,10,12,22
26547,0,0,6,16,22
26548,0,2,6,7,15
26549,0,0,7,10,17
26550,0,0,5,15,20
26551,0,0,7,8,15
26552,0,1,7,4,12
26553,0,0,8,11,19
26554,0,0,2,4,6
26555,0,1,4,10,15
26556,0,0,10,12,22
26557,1,1,4,28,34
26558,0,0,4,2,6
26559,0,3,12,29,44
26560,0,0,3,4,7
26561,0,0,11,12,23
26562,0,0,4,4,8
26563,0,0,3,11,14
26564,2,1,8,28,39
26565,0,0,12,27,39
26566,0,0,6,13,19
26567,0,0,6,15,21
26568,0,0,6,12,18
26569,0,0,13,27,40
26570,0,1,1,16,18
26571,0,1,6,8,15
26572,0,0,5,15,20
26573,0,0,17,31,48
26574,0,0,9,12,21
26575,1,0,10,12,23
26576,0,0,2,14,16
26577,0,1,5,10,16
26578,0,0,1,0,1
26579,0,0,8,11,19
26580,0,0,13,18,31
26581,0,0,4,4,8
26582,0,0,8,12,20
26583,0,0,10,17,27
26584,0,0,4,4,8
26585,0,0,3,30,33
26586,1,1,12,29,43
26587,0,4,4,14,22
26588,0,0,6,7,13
26589,0,0,12,27,39
26591,1,3,1,25,30
26592,3,0,6,15,24
26593,0,0,5,10,15
26594,0,1,9,10,20
26595,0,0,7,23,30
26596,0,0,5,8,13
26597,0,0,3,15,18
26598,1,1,9,18,29
26599,0,1,4,4,9
26600,0,1,10,25,36
26601,0,0,7,10,17
26602,0,0,4,11,15
26603,0,3,10,37,50
26604,0,0,16,23,39
26605,0,0,14,17,31
26606,0,0,5,9,14
26607,0,0,8,17,25
26608,0,0,4,20,24
26609,0,1,6,13,20
26610,0,2,3,10,15
26611,0,1,8,12,21
26612,0,0,0,5,5
26613,0,0,2,3,5
26614,0,7,1,10,18
26615,0,0,8,22,30
26616,0,0,3,1,4
26617,0,0,6,12,18
26618,0,0,0,8,8
26619,0,1,5,15,21
26620,0,0,2,14,16
26621,0,0,4,4,8
26622,0,0,8,14,22
26623,0,0,9,14,23
26624,0,0,9,22,31
26625,0,0,6,4,10
26626,0,1,8,9,18
26627,0,0,3,3,6
26628,2,4,6,23,35
26629,0,0,1,4,5
26630,0,0,4,9,13
26631,0,1,9,22,32
26632,0,0,2,11,13
26633,0,2,15,33,50
26634,0,2,0,11,13
26635,0,0,3,3,6
26636,0,0,2,2,4
26637,0,0,2,5,7
26638,0,0,7,8,15
26639,0,0,16,32,48
26640,0,0,4,10,14
26641,0,0,9,7,16
26643,0,0,13,12,25
26644,0,1,5,13,19
26645,0,0,4,23,27
26646,0,0,9,9,18
26647,0,0,12,14,26
26648,0,0,8,9,17
26649,0,0,2,14,16
26650,0,0,2,3,5
26651,0,1,5,19,25
26652,0,1,8,16,25
26653,0,4,7,38,49
26654,0,0,3,17,20
26655,2,0,4,12,18
26656,0,1,13,16,30
26657,0,0,4,4,8
26658,0,0,8,14,22
26659,0,2,1,3,6
26660,0,0,4,2,6
26661,0,0,2,16,18
26662,0,0,3,4,7
26663,1,1,2,12,16
26664,0,1,5,16,22
26665,0,1,3,5,9
26666,0,1,4,31,36
26667,0,0,9,10,19
26668,0,0,2,10,12
26669,0,1,5,14,20
26670,0,0,7,6,13
26671,0,0,2,9,11
26672,0,0,1,5,6
26673,0,0,2,4,6
26674,0,0,3,2,5
26675,0,0,9,24,33
26676,0,0,15,25,40
26677,0,0,4,7,11
26678,0,3,10,12,25
26679,0,0,6,5,11
26680,0,0,4,4,8
26681,0,1,1,3,5
26682,0,1,9,32,42
26683,0,0,6,4,10
26684,1,2,12,35,50
26685,0,0,3,12,15
26686,0,0,1,4,5
26687,0,1,1,11,13
26688,0,0,3,7,10
26689,0,0,2,13,15
26690,0,1,1,3,5
26691,1,1,6,11,19
26693,3,2,4,22,31
26694,0,0,5,7,12
26695,0,0,9,18,27
26696,0,0,2,9,11
26697,0,0,6,18,24
26698,0,0,6,8,14
26699,0,1,7,9,17
26700,0,1,7,18,26
26701,3,0,1,8,12
26702,0,0,4,2,6
26706,1,0,2,5,8
26707,0,0,4,2,6
26708,1,2,2,3,8
26709,0,1,4,1,6
26710,0,0,1,7,8
26711,1,2,14,33,50
26712,0,0,3,4,7
26713,0,2,17,26,45
26714,0,1,4,33,38
26715,2,0,0,18,20
26716,0,1,9,10,20
26717,0,0,2,0,2
26718,0,1,3,6,10
26719,0,0,3,3,6
26721,0,0,8,16,24
26722,0,2,13,18,33
26723,1,1,9,39,50
26724,0,1,5,7,13
26725,2,1,9,38,50
26726,1,1,1,17,20
26727,1,0,10,39,50
26728,0,1,5,19,25
26729,0,1,5,26,32
26730,0,0,4,4,8
26731,0,3,3,6,12
26732,0,0,9,14,23
26733,0,1,7,12,20
26734,2,0,1,26,29
26735,1,5,3,21,30
26736,4,0,8,24,36
26737,0,0,0,6,6
26738,0,1,10,13,24
26739,0,0,3,8,11
26740,0,0,5,15,20
26741,2,0,1,16,19
26742,0,1,6,27,34
26743,2,1,5,38,46
26744,0,0,7,40,47
26745,0,3,12,29,44
26746,0,1,1,9,11
26747,0,2,6,7,15
26748,0,0,7,10,17
26749,2,0,2,10,14
26750,0,0,3,4,7
26751,0,0,11,9,20
26752,1,1,3,12,17
26753,1,0,3,33,37
26754,0,0,3,5,8
26755,0,1,17,32,50
26756,1,0,6,24,31
26757,0,1,8,14,23
26758,0,0,4,4,8
26759,0,1,3,14,18
26760,0,0,2,3,5
26761,0,0,15,35,50
26762,0,3,2,10,15
26763,0,0,17,24,41
26764,0,0,8,19,27
26765,2,1,9,38,50
26766,0,0,8,18,26
26767,0,0,12,23,35
26768,1,0,12,33,46
26769,0,0,5,17,22
26770,0,1,7,11,19
26771,0,0,11,16,27
26772,0,0,7,10,17
26773,0,2,14,26,42
26774,5,0,1,23,29
26775,0,0,1,9,10
26776,0,0,11,38,49
26777,0,1,7,12,20
26778,0,0,9,14,23
26779,0,1,6,19,26
26780,0,0,9,6,15
26782,6,1,6,10,23
26783,2,0,7,23,32
26784,2,0,9,26,37
26785,1,0,5,23,29
26786,0,1,11,23,35
26787,1,1,10,19,31
26788,2,1,3,26,32
26789,0,0,12,38,50
26790,0,1,0,36,37
26791,0,0,0,7,7
26792,0,1,0,9,10
26794,0,0,8,13,21
26795,0,0,7,40,47
26796,0,12,4,26,42
26797,0,0,14,30,44
26798,0,0,2,6,8
26799,1,0,5,12,18
26800,0,0,7,15,22
26801,0,1,6,23,30
26803,0,0,3,4,7
26804,0,0,2,20,22
26805,0,0,17,19,36
26806,0,0,6,17,23
26807,0,0,6,13,19
26808,0,2,10,33,45
26809,0,0,8,11,19
26810,0,0,12,27,39
26811,0,2,17,26,45
26812,0,2,13,30,45
26813,0,1,3,11,15
26814,2,0,9,8,19
26815,1,3,6,39,49
26816,0,0,0,6,6
26817,1,1,1,17,20
26818,0,0,8,12,20
26819,1,1,4,28,34
26820,0,0,7,10,17
26821,0,0,4,11,15
26822,0,1,4,4,9
26823,0,0,12,38,50
26824,2,0,4,12,18
26825,0,2,0,11,13
26826,1,0,16,33,50
26827,0,1,10,13,24
26828,0,1,4,27,32
26829,0,1,1,9,11
26830,0,0,6,8,14
26831,2,0,1,8,11
26832,0,1,0,9,10
26833,0,1,6,27,34
26834,2,1,5,38,46
26835,2,0,2,10,14
26836,0,1,7,9,17
26837,1,2,12,35,50
26838,2,0,1,16,19
26839,0,1,1,11,13
26840,0,1,5,16,22
26841,0,2,10,33,45
26842,2,0,0,18,20
26843,1,0,10,30,41
26844,0,2,13,30,45
26847,2,0,1,8,11
26848,0,0,3,15,18
26849,1,0,10,26,37
26850,0,0,8,11,19
26851,0,0,4,7,11
26852,0,0,2,20,22
26853,0,3,10,37,50
26854,0,3,12,29,44
26855,0,0,10,19,29
26857,1,0,10,30,41
26858,2,0,0,18,20
26859,0,1,1,9,11
26860,0,2,13,30,45
26861,0,0,4,4,8
26862,0,1,10,13,24
26863,1,3,6,39,49
26864,0,1,0,9,10
26865,0,1,6,23,30
26866,2,0,1,16,19
26867,0,1,3,11,15
26868,4,0,8,24,36
26869,1,0,16,33,50
26870,0,2,14,26,42
26871,1,1,1,17,20
26872,0,0,8,19,27
26873,0,4,7,38,49
26874,0,1,4,27,32
26875,0,1,0,9,10
26876,0,1,1,9,11
26877,1,1,10,19,31
26878,0,0,12,38,50
26879,0,2,15,33,50
26880,0,0,17,22,39
26881,0,1,4,27,32
26882,0,1,5,26,32
26883,1,1,1,17,20
26884,2,0,4,12,18
26885,1,3,1,25,30
26886,0,0,7,10,17
26887,1,0,16,33,50
26888,0,0,2,6,8
26889,2,0,9,8,19
26890,0,1,6,4,11
26891,0,0,17,22,39
26892,1,1,10,19,31
26893,1,1,9,39,50
26894,0,0,5,17,22
26895,0,1,9,10,20
26896,0,1,4,33,38
26897,0,2,13,30,45
26898,0,0,10,12,22
26899,1,0,3,3,7
26900,0,2,8,12,22
26901,0,2,17,26,45
26902,0,1,6,23,30
26903,0,0,17,19,36
26904,0,1,4,18,23
26905,1,3,6,39,49
26906,0,0,6,13,19
26907,0,2,10,33,45
26908,0,0,8,13,21
26909,0,2,13,18,33
26910,0,0,8,19,27
26911,1,1,9,18,29
26912,1,2,14,33,50
26913,1,1,1,17,20
26914,0,1,5,26,32
26915,0,7,1,10,18
26916,0,0,7,10,17
26917,1,0,10,39,50
26918,0,1,5,19,25
26919,4,0,8,24,36
26920,0,0,9,14,23
26921,0,1,10,13,24
26922,0,1,5,7,13
26923,1,5,3,21,30
26924,2,4,6,23,35
26925,0,0,8,16,24
26926,0,0,1,4,5
26927,0,0,3,8,11
26928,0,2,0,11,13
26929,0,0,3,4,7
26930,0,1,1,11,13
26931,2,0,1,26,29
26932,0,0,13,12,25
26933,0,1,0,9,10
26934,0,0,6,8,14
26935,1,0,16,33,50
26936,0,3,12,29,44
26937,0,4,7,38,49
26938,2,0,2,10,14
26939,1,1,3,12,17
26940,0,0,4,14,18
26941,0,2,6,7,15
26942,0,0,3,2,5
26943,0,0,7,5,12
26944,0,0,9,28,37
26945,0,0,4,3,7
26947,0,1,5,10,16
26948,0,0,0,5,5
26949,0,0,3,2,5
26950,0,0,7,18,25
26951,0,0,12,38,50
26952,0,0,10,24,34
26953,0,1,2,10,13
26954,0,0,4,8,12
26955,0,0,2,6,8
26956,0,1,8,12,21
26957,0,0,1,7,8
26958,0,3,3,2,8
26959,0,0,2,3,5
26960,0,1,5,10,16
26961,0,1,2,4,7
26962,1,0,9,8,18
26963,0,0,4,2,6
26964,1,2,5,34,42
26965,0,1,8,11,20
26966,0,1,3,11,15
26967,0,0,3,6,9
26968,0,0,7,10,17
26969,0,0,8,10,18
26970,1,0,3,12,16
26971,0,1,5,6,12
26972,1,2,4,11,18
26973,0,0,1,6,7
26974,0,0,3,8,11
26975,0,0,3,4,7
26976,0,1,5,5,11
26977,0,0,4,3,7
26979,0,0,12,26,38
26980,0,0,2,10,12
26981,4,0,0,8,12
26982,0,0,14,33,47
26983,0,0,6,8,14
26984,0,0,18,31,49
26985,1,0,6,14,21
26986,0,1,1,7,9
26987,0,0,6,12,18
26988,0,5,7,14,26
26989,0,0,2,17,19
26990,0,0,13,11,24
26991,0,0,9,14,23
26992,0,0,12,35,47
26993,0,1,5,12,18
26994,0,0,1,7,8
26995,0,1,4,33,38
26996,0,0,13,14,27
26997,0,0,4,5,9
26998,0,0,3,8,11
26999,0,0,10,30,40
27000,0,0,9,14,23
27001,2,0,2,14,18
27002,0,1,21,28,50
27003,0,0,5,14,19
27004,0,1,8,12,21
27005,1,0,0,16,17
27006,0,0,4,11,15
27007,0,0,8,35,43
27008,0,0,15,21,36
27009,0,0,2,9,11
27010,0,0,5,17,22
27011,0,0,10,11,21
27012,0,0,16,23,39
27013,0,0,15,25,40
27014,0,3,17,22,42
27015,0,0,6,6,12
27016,0,0,23,26,49
27017,0,0,3,2,5
27018,0,1,6,13,20
27019,0,1,11,29,41
27020,0,0,6,8,14
27021,0,1,9,18,28
27022,0,0,2,5,7
27023,0,0,7,20,27
27024,0,0,3,11,14
27025,0,1,9,10,20
27026,0,1,5,9,15
27028,0,0,12,30,42
27029,0,0,5,8,13
27030,0,0,4,5,9
27031,0,0,12,38,50
27032,0,1,2,3,6
27033,0,0,3,11,14
27034,0,0,3,16,19
27035,0,0,4,3,7
27036,0,0,4,8,12
27037,0,0,4,6,10
27038,0,2,3,32,37
27039,0,0,7,18,25
27040,0,0,4,5,9
27041,0,3,17,17,37
27042,1,1,7,41,50
27043,1,2,13,32,48
27044,0,0,12,27,39
27045,0,1,9,6,16
27046,0,0,7,21,28
27047,0,1,2,2,5
27048,0,1,8,22,31
27049,0,0,1,12,13
27050,0,0,7,7,14
27051,0,1,2,10,13
27052,0,0,12,16,28
27053,0,0,8,3,11
27054,1,1,9,17,28
27055,0,0,5,15,20
27056,0,0,7,11,18
27057,0,0,3,4,7
27058,0,0,1,9,10
27059,0,0,4,6,10
27060,0,0,10,11,21
27061,0,0,7,25,32
27062,0,0,10,6,16
27063,2,1,9,38,50
27064,0,0,4,12,16
27065,0,0,7,25,32
27066,0,0,3,10,13
27067,0,0,5,13,18
27068,0,0,3,6,9
27069,0,0,6,18,24
27070,0,0,3,13,16
27071,0,1,11,35,47
27072,0,0,10,23,33
27073,0,0,7,5,12
27074,0,0,4,13,17
27075,0,0,9,7,16
27076,0,0,5,10,15
27077,0,0,1,1,2
27078,0,0,5,6,11
27079,0,0,6,14,20
27080,0,0,11,24,35
27081,0,0,2,3,5
27082,0,0,6,11,17
27083,0,0,13,17,30
27084,0,0,5,10,15
27085,0,0,2,6,8
27086,0,0,2,2,4
27087,0,0,7,10,17
27088,0,0,5,12,17
27089,0,0,7,17,24
27090,0,0,5,19,24
27091,0,1,9,6,16
27092,0,1,5,19,25
27094,0,0,4,14,18
27095,0,0,7,26,33
27096,0,0,9,21,30
27097,0,0,7,15,22
27098,0,0,4,18,22
27099,0,0,2,18,20
27101,0,0,2,3,5
27102,0,0,10,7,17
27103,0,0,2,8,10
27104,0,0,15,24,39
27105,0,0,2,13,15
27106,0,1,17,18,36
27108,0,0,5,12,17
27109,0,1,13,22,36
27110,0,0,5,5,10
27111,0,0,5,0,5
27112,0,1,8,8,17
27113,1,1,4,22,28
27114,0,1,5,5,11
27115,0,0,3,12,15
27116,0,0,7,8,15
27117,0,1,3,26,30
27118,0,0,2,8,10
27119,0,1,5,13,19
27120,0,0,11,10,21
27121,0,1,6,7,14
27122,0,1,13,32,46
27123,0,0,5,17,22
27124,0,1,8,9,18
27125,0,0,7,5,12
27126,0,0,15,33,48
27127,0,0,7,15,22
27128,0,1,5,26,32
27129,0,0,3,3,6
27130,0,0,2,3,5
27131,0,0,7,13,20
27132,0,0,7,20,27
27133,0,0,10,14,24
27134,0,1,7,13,21
27135,1,0,7,11,19
27136,1,0,9,11,21
27137,0,0,2,6,8
27138,0,0,16,23,39
27139,0,0,1,5,6
27140,0,0,3,6,9
27141,0,1,5,21,27
27142,0,4,12,23,39
27143,0,0,3,1,4
27144,0,0,5,6,11
27145,0,0,2,1,3
27146,0,0,5,1,6
27147,0,1,5,17,23
27148,0,0,4,4,8
27150,0,0,0,11,11
27151,0,0,1,6,7
27152,0,7,1,10,18
27154,0,1,7,38,46
27155,0,1,4,26,31
27156,0,1,12,28,41
27157,0,0,0,5,5
27159,0,0,10,7,17
27160,0,0,10,23,33
27161,0,1,11,22,34
27162,0,0,4,11,15
27163,0,0,3,9,12
27164,0,2,13,18,33
27165,0,1,4,0,5
27166,0,1,8,12,21
27167,1,0,11,15,27
27168,0,0,0,5,5
27169,0,0,2,8,10
27170,0,0,2,2,4
27171,0,0,8,12,20
27172,0,0,5,6,11
27173,0,0,4,1,5
27174,0,0,7,36,43
27175,0,0,4,4,8
27176,0,0,7,4,11
27177,0,0,4,7,11
27178,0,0,10,32,42
27179,0,0,4,4,8
27180,1,0,7,39,47
27181,0,3,19,22,44
27182,0,0,6,7,13
27183,0,0,3,14,17
27184,0,1,5,7,13
27185,0,0,19,30,49
27186,0,0,5,15,20
27187,0,1,8,11,20
27189,0,0,6,8,14
27190,0,2,2,1,5
27191,0,0,11,12,23
27192,0,1,2,8,11
27193,0,0,7,11,18
27194,0,1,3,6,10
27195,0,0,8,18,26
27196,0,0,2,3,5
27197,0,0,5,7,12
27198,0,0,5,18,23
27199,0,2,6,20,28
27200,0,0,5,9,14
27202,0,1,3,7,11
27203,1,0,5,13,19
27204,1,0,1,3,5
27205,0,1,4,23,28
27207,0,0,6,6,12
27208,0,0,7,3,10
27209,0,0,4,4,8
27210,0,1,0,9,10
27211,0,0,5,21,26
27212,0,0,0,6,6
27213,0,1,4,2,7
27215,0,0,6,4,10
27216,0,0,8,4,12
27217,0,0,5,11,16
27218,0,0,6,9,15
27219,0,0,1,8,9
27220,0,0,6,6,12
27221,0,0,9,11,20
27222,0,0,1,3,4
27223,0,1,10,32,43
27224,0,0,7,10,17
27225,1,2,5,34,42
27226,0,1,5,6,12
27228,0,0,2,17,19
27229,0,0,6,13,19
27230,0,1,21,28,50
27231,0,0,9,5,14
27232,0,0,7,17,24
27233,0,2,3,7,12
27234,0,0,4,10,14
27235,0,0,1,9,10
27236,0,0,4,13,17
27237,0,0,2,15,17
27238,0,0,3,6,9
27239,0,0,19,23,42
27241,2,0,1,26,29
27242,0,0,1,5,6
27243,0,0,5,12,17
27244,0,1,3,12,16
27245,0,2,2,6,10
27246,1,0,10,24,35
27247,0,0,20,26,46
27248,0,0,3,8,11
27249,0,0,9,5,14
27250,0,0,4,9,13
27251,0,0,8,14,22
27252,0,1,4,12,17
27253,0,1,5,6,12
27254,0,0,1,4,5
27255,0,0,11,11,22
27256,0,0,1,2,3
27258,0,0,9,9,18
27259,0,1,5,12,18
27260,0,0,4,2,6
27262,0,0,6,6,12
27263,0,0,4,11,15
27264,1,0,2,12,15
27265,0,0,2,4,6
27266,0,2,1,3,6
27267,0,0,5,6,11
27268,0,0,1,9,10
27269,0,0,10,4,14
27271,0,0,3,8,11
27272,0,1,13,21,35
27273,0,0,1,19,20
27274,0,0,3,2,5
27275,0,0,1,2,3
27276,0,0,3,6,9
27277,0,0,1,2,3
27280,0,0,12,31,43
27281,0,0,5,7,12
27282,0,1,10,13,24
27283,0,0,7,9,16
27284,0,0,0,11,11
27285,0,0,11,19,30
27286,0,1,6,9,16
27287,0,0,10,6,16
27288,0,0,5,11,16
27289,1,0,2,18,21
27290,0,1,1,3,5
27291,0,1,8,15,24
27292,0,0,4,6,10
27293,0,0,7,18,25
27294,0,0,3,3,6
27295,0,0,6,4,10
27297,0,0,7,10,17
27298,0,0,2,8,10
27299,0,0,8,8,16
27300,0,0,10,18,28
27301,0,0,8,25,33
27302,0,0,6,8,14
27303,0,1,3,11,15
27304,0,0,4,2,6
27305,0,0,1,4,5
27306,0,5,7,36,48
27307,0,0,5,15,20
27308,1,0,9,8,18
27309,0,0,3,2,5
27310,0,0,6,19,25
27311,0,0,7,10,17
27312,0,0,6,13,19
27313,0,0,11,26,37
27314,1,0,7,6,14
27315,0,0,8,4,12
27316,0,0,6,4,10
27317,0,0,3,3,6
27318,1,0,3,3,7
27319,0,1,3,4,8
27320,0,0,1,9,10
27321,0,0,0,5,5
27322,0,1,0,4,5
27323,0,1,7,18,26
27324,0,2,6,7,15
27325,0,0,1,6,7
27326,0,2,1,10,13
27327,0,0,3,2,5
27328,0,0,4,3,7
27330,0,0,5,3,8
27331,0,0,9,1,10
27332,0,0,5,7,12
27333,0,0,3,6,9
27334,0,1,12,21,34
27335,0,2,5,11,18
27337,0,2,2,10,14
27338,0,3,3,8,14
27339,0,3,1,6,10
27340,0,1,2,5,8
27341,0,0,4,10,14
27343,0,1,5,8,14
27344,0,3,0,7,10
27346,1,0,2,22,25
27347,0,0,3,7,10
27348,0,1,0,5,6
27349,0,1,4,15,20
27350,0,1,6,22,29
27351,0,2,9,31,42
27352,0,0,5,16,21
27353,0,0,8,9,17
27354,0,0,3,1,4
27355,0,1,7,12,20
27356,0,1,2,7,10
27357,0,0,6,11,17
27358,0,0,6,13,19
27359,0,0,4,5,9
27360,0,1,1,3,5
27361,0,0,1,4,5
27362,0,0,5,6,11
27363,0,1,8,10,19
27364,0,0,10,9,19
27365,0,0,11,13,24
27366,0,0,5,5,10
27367,0,0,9,8,17
27368,0,0,4,7,11
27369,0,0,10,8,18
27370,0,0,6,9,15
27372,0,0,9,4,13
27373,0,1,4,8,13
27374,3,0,2,7,12
27375,0,0,6,2,8
27376,0,0,2,2,4
27377,0,0,5,5,10
27378,0,1,3,4,8
27379,0,0,1,4,5
27380,0,0,2,3,5
27381,0,0,12,34,46
27382,0,0,3,4,7
27383,0,1,3,7,11
27384,0,1,5,5,11
27385,0,1,6,6,13
27386,0,0,3,8,11
27387,0,0,3,7,10
27388,0,0,4,6,10
27389,0,0,13,36,49
27390,0,0,3,3,6
27391,0,0,5,4,9
27392,0,0,2,5,7
27394,0,0,5,3,8
27395,0,0,1,7,8
27396,0,1,4,8,13
27397,0,1,8,7,16
27398,0,1,6,21,28
27399,0,0,3,3,6
27400,0,1,4,14,19
27401,0,1,7,9,17
27402,0,0,2,4,6
27403,0,0,1,8,9
27404,0,0,4,6,10
27405,0,0,5,8,13
27406,0,0,3,4,7
27407,0,0,8,12,20
27408,0,0,3,11,14
27410,0,0,7,12,19
27411,0,1,13,15,29
27412,0,0,2,6,8
27413,0,1,16,11,28
27414,0,1,2,5,8
27416,0,0,10,16,26
27417,0,0,4,3,7
27419,0,0,1,4,5
27420,2,4,0,25,31
27421,0,0,12,9,21
27422,0,0,4,7,11
27423,0,0,5,11,16
27424,0,2,1,23,26
27425,0,0,5,16,21
27426,0,0,3,2,5
27427,1,2,4,11,18
27431,0,1,8,25,34
27432,0,1,6,18,25
27433,0,0,0,13,13
27434,0,0,18,23,41
27435,0,0,4,3,7
27436,0,0,1,6,7
27437,0,1,10,20,31
27438,0,0,2,7,9
27439,0,1,3,19,23
27440,0,0,2,15,17
27441,0,1,5,44,50
27442,0,0,5,10,15
27443,0,0,10,24,34
27444,0,0,8,12,20
27445,0,0,2,6,8
27446,1,0,4,12,17
27447,0,0,2,3,5
27448,0,0,4,14,18
27449,0,0,2,3,5
27450,0,0,5,3,8
27451,1,0,4,14,19
27452,0,0,0,6,6
27453,0,1,4,4,9
27454,1,1,10,27,39
27455,0,0,10,18,28
27456,0,0,9,28,37
27457,0,0,10,30,40
27458,1,1,1,17,20
27459,0,0,5,3,8
27460,0,1,6,21,28
27461,0,4,6,30,40
27462,2,0,4,12,18
27463,0,1,7,12,20
27464,0,0,9,14,23
27465,0,1,2,26,29
27466,0,0,2,3,5
27467,0,1,5,10,16
27468,0,0,7,30,37
27469,1,2,3,39,45
27470,2,6,2,20,30
27471,0,0,7,7,14
27472,1,1,3,12,17
27473,0,0,4,13,17
27474,0,0,8,10,18
27475,0,0,0,1,1
27476,0,1,5,30,36
27477,2,0,1,16,19
27478,2,3,1,13,19
27479,0,0,7,8,15
27481,0,0,5,10,15
27482,0,0,5,22,27
27483,0,1,8,25,34
27484,0,0,2,15,17
27485,0,0,12,35,47
27486,0,0,6,9,15
27487,0,0,13,20,33
27488,0,1,2,6,9
27489,0,0,3,3,6
27490,0,0,6,9,15
27491,0,0,1,3,4
27492,3,1,1,12,17
27493,0,0,13,17,30
27494,0,0,11,17,28
27495,0,0,9,6,15
27496,0,1,6,12,19
27497,0,1,15,12,28
27498,0,0,1,7,8
27499,0,0,4,3,7
27500,0,0,3,3,6
27501,0,0,8,6,14
27502,0,0,14,27,41
27503,0,1,5,9,15
27504,0,1,14,33,48
27505,0,0,5,22,27
27506,0,1,11,29,41
27507,0,1,2,3,6
27508,0,2,14,34,50
27509,0,0,4,6,10
27510,0,0,3,5,8
27511,0,0,11,30,41
27512,0,0,12,17,29
27513,0,2,1,28,31
27514,0,0,8,18,26
27515,0,3,17,17,37
27516,0,1,11,38,50
27517,0,0,10,14,24
27518,0,0,8,8,16
27520,0,0,2,3,5
27521,1,0,10,10,21
27522,0,0,7,11,18
27523,1,1,5,31,38
27524,5,1,6,29,41
27525,0,0,8,26,34
27526,0,0,3,17,20
27527,0,0,8,12,20
27528,0,1,10,11,22
27529,0,0,8,14,22
27531,0,0,13,10,23
27532,0,0,9,18,27
27533,0,5,3,19,27
27534,0,1,4,4,9
27535,0,0,11,14,25
27536,0,0,4,7,11
27537,0,0,5,19,24
27538,0,0,5,12,17
27539,0,0,0,7,7
27541,0,2,4,6,12
27542,0,0,6,14,20
27543,0,1,16,30,47
27544,0,0,8,23,31
27546,1,0,8,10,19
27547,0,1,16,16,33
27548,1,0,4,14,19
27549,0,0,10,14,24
27551,0,0,1,2,3
27552,0,0,3,7,10
27553,0,1,4,14,19
27554,0,0,10,14,24
27555,0,0,10,32,42
27556,0,0,9,7,16
27557,0,0,8,4,12
27558,0,0,15,32,47
27559,0,0,16,34,50
27560,0,0,1,6,7
27561,0,0,13,16,29
27562,0,0,0,10,10
27563,0,0,12,17,29
27564,0,0,5,18,23
27565,0,0,2,3,5
27566,0,0,12,17,29
27567,0,0,4,4,8
27568,0,1,0,7,8
27569,0,0,7,30,37
27570,1,0,14,34,49
27572,0,0,5,12,17
27573,0,0,5,21,26
27574,0,0,9,19,28
27575,0,0,12,20,32
27576,0,0,13,33,46
27577,0,0,8,23,31
27578,0,0,2,2,4
27579,0,0,11,19,30
27581,1,1,5,23,30
27582,0,0,3,3,6
27583,1,0,3,19,23
27584,0,1,15,33,49
27585,0,3,12,19,34
27586,0,1,6,14,21
27587,0,0,3,6,9
27588,0,0,14,23,37
27589,0,2,3,7,12
27590,0,0,9,23,32
27591,0,0,15,35,50
27592,0,0,5,14,19
27593,1,0,7,28,36
27594,0,0,2,3,5
27595,0,0,5,3,8
27596,1,0,6,37,44
27597,0,0,2,10,12
27598,0,0,12,17,29
27599,1,0,3,23,27
27600,0,0,6,6,12
27601,0,0,10,30,40
27602,0,0,9,11,20
27603,0,0,5,8,13
27604,0,0,6,6,12
27605,0,0,6,8,14
27606,0,0,5,6,11
27607,0,0,11,10,21
27608,0,0,6,38,44
27609,0,0,6,13,19
27610,0,1,7,14,22
27612,1,1,6,22,30
27613,0,0,20,27,47
27614,0,2,12,28,42
27615,0,0,10,14,24
27616,0,0,2,11,13
27617,0,0,5,12,17
27618,2,0,1,16,19
27619,0,1,7,9,17
27620,0,0,6,5,11
27622,0,0,1,6,7
27623,1,1,6,13,21
27624,0,0,5,9,14
27625,2,0,7,41,50
27626,2,2,6,14,24
27627,0,0,6,13,19
27628,2,2,16,25,45
27629,0,0,7,8,15
27630,2,0,1,6,9
27631,0,0,9,13,22
27632,0,0,1,12,13
27633,0,1,5,44,50
27634,1,3,6,39,49
27635,0,0,7,21,28
27636,1,0,4,12,17
27637,0,2,13,30,45
27638,0,0,7,10,17
27639,0,0,1,9,10
27640,0,1,5,10,16
27641,0,1,2,11,14
27642,1,0,3,14,18
27643,0,0,3,6,9
27644,0,0,2,3,5
27645,0,1,7,38,46
27646,0,0,0,6,6
27647,0,0,8,19,27
27648,1,1,1,17,20
27649,0,0,10,18,28
27650,0,0,5,3,8
27651,0,1,6,21,28
27652,0,4,6,30,40
27653,0,1,7,12,20
27654,0,1,10,31,42
27655,0,0,9,14,23
27656,0,1,10,32,43
27657,0,1,2,8,11
27658,2,0,4,12,18
27659,0,0,15,35,50
27660,0,1,2,26,29
27661,0,0,2,14,16
27662,0,1,5,30,36
27663,1,0,2,18,21
27664,0,1,5,5,11
27665,0,0,0,1,1
27666,1,0,3,12,16
27667,0,0,1,6,7
27668,0,0,3,3,6
27669,0,1,2,7,10
27670,0,0,2,6,8
27671,0,0,4,3,7
27673,0,0,2,7,9
27674,2,3,1,13,19
27675,0,0,2,11,13
27676,0,0,9,13,22
27677,0,2,13,30,45
27678,0,1,10,38,49
27679,0,2,3,7,12
27680,1,0,3,19,23
27681,0,0,2,8,10
27682,0,0,5,22,27
27683,0,0,1,6,7
27684,0,0,9,6,15
27685,0,0,13,25,38
27686,0,0,5,15,20
27687,0,1,5,44,50
27688,0,0,10,30,40
27689,0,0,5,5,10
27690,2,0,4,32,38
27691,0,0,6,5,11
27693,0,0,20,30,50
27694,0,0,2,7,9
27695,1,0,2,18,21
27696,1,0,3,23,27
27697,0,0,5,21,26
27698,1,1,19,29,50
27699,0,0,7,14,21
27700,0,3,3,28,34
27701,0,2,1,28,31
27702,0,1,11,38,50
27703,0,2,13,30,45
27704,1,0,14,35,50
27706,1,3,6,39,49
27707,0,0,6,5,11
27708,0,0,15,35,50
27709,0,0,13,25,38
27710,0,0,10,30,40
27711,1,0,3,14,18
27712,0,0,4,4,8
27713,0,0,2,3,5
27714,0,0,1,4,5
27715,1,0,6,37,44
27716,3,1,17,29,50
27717,0,0,2,14,16
27718,2,0,1,16,19
27719,0,0,13,25,38
27720,0,0,20,30,50
27721,0,1,5,44,50
27722,0,0,9,13,22
27723,2,2,16,25,45
27724,5,1,6,29,41
27725,0,1,10,31,42
27726,0,0,9,6,15
27727,1,0,10,10,21
27728,1,1,1,17,20
27729,0,0,5,21,26
27730,0,0,8,19,27
27731,4,1,0,21,26
27732,0,0,2,3,5
27733,0,1,2,3,6
27734,0,0,7,10,17
27735,4,1,0,21,26
27736,0,0,2,7,9
27737,5,1,6,29,41
27738,7,4,2,18,31
27739,2,2,16,25,45
27740,0,1,5,26,32
27741,1,1,1,17,20
27742,0,0,5,21,26
27743,4,2,1,35,42
27744,0,2,2,1,5
27745,0,0,15,32,47
27746,2,6,2,20,30
27747,2,0,4,12,18
27748,0,0,2,6,8
27749,0,0,5,15,20
27750,0,0,9,13,22
27751,0,0,6,15,21
27752,7,4,2,18,31
27753,0,0,12,19,31
27754,0,0,5,12,17
27755,0,1,8,25,34
27756,2,2,16,25,45
27757,0,0,5,12,17
27758,0,2,13,30,45
27759,0,0,13,25,38
27760,1,0,10,10,21
27761,0,1,4,33,38
27762,0,1,5,19,25
27763,1,3,6,39,49
27764,0,1,5,26,32
27765,0,0,3,10,13
27766,0,0,7,10,17
27767,0,1,9,10,20
27768,1,1,1,17,20
27769,1,1,10,27,39
27770,0,0,2,3,5
27771,0,7,1,10,18
27772,4,2,1,35,42
27773,0,1,2,26,29
27774,0,0,10,30,40
27775,0,2,13,18,33
27776,0,1,5,7,13
27777,0,0,9,14,23
27778,0,0,8,19,27
27779,0,0,10,14,24
27780,1,1,6,22,30
27781,0,0,1,6,7
27782,0,0,3,4,7
27783,0,0,1,4,5
27784,2,6,2,20,30
27785,0,0,6,8,14
27786,1,2,4,11,18
27787,2,0,1,26,29
27788,0,0,3,8,11
27789,1,1,3,12,17
27790,0,0,7,8,15
27791,0,2,3,9,14
27792,0,0,4,20,24
27793,0,0,0,5,5
27794,0,0,4,1,5
27795,0,0,6,35,41
27796,0,0,1,7,8
27797,0,0,5,10,15
27798,0,0,4,6,10
27799,0,0,2,3,5
27800,0,0,4,6,10
27801,0,0,8,11,19
27802,0,1,5,10,16
27803,0,0,7,16,23
27804,0,4,5,23,32
27805,0,0,5,4,9
27806,0,0,3,6,9
27807,0,1,5,5,11
27808,1,0,9,8,18
27809,0,0,0,5,5
27810,0,0,1,6,7
27811,1,0,3,12,16
27812,0,3,12,29,44
27813,0,0,4,3,7
27814,1,2,4,11,18
27815,0,2,4,14,20
27816,0,1,8,34,43
27817,2,1,7,36,46
27818,0,0,2,16,18
27819,0,0,6,17,23
27820,0,1,9,10,20
27821,0,0,6,31,37
27822,0,0,8,10,18
27823,0,0,5,16,21
27824,0,0,12,27,39
27825,0,1,4,18,23
27826,0,0,13,26,39
27827,0,0,14,16,30
27828,0,0,4,12,16
27829,0,2,17,26,45
27830,0,0,8,11,19
27831,0,0,2,5,7
27832,0,0,10,8,18
27833,0,1,2,11,14
27834,0,1,10,14,25
27835,0,0,6,14,20
27836,0,0,11,21,32
27837,0,0,12,30,42
27838,0,0,22,20,42
27839,0,0,9,15,24
27840,0,1,16,31,48
27841,0,0,15,33,48
27842,0,0,3,9,12
27843,0,0,4,8,12
27844,0,0,5,21,26
27845,0,0,0,5,5
27846,0,0,7,17,24
27847,0,0,10,32,42
27848,0,2,13,21,36
27849,0,0,18,22,40
27850,0,1,8,22,31
27851,0,0,5,1,6
27852,0,0,6,10,16
27853,0,0,2,1,3
27854,0,1,10,17,28
27855,0,1,4,27,32
27856,0,1,4,13,18
27857,0,0,6,27,33
27858,0,0,8,15,23
27859,0,0,9,10,19
27860,0,0,8,18,26
27861,0,1,12,27,40
27862,0,0,0,8,8
27863,0,2,5,23,30
27864,0,0,7,8,15
27865,1,1,0,20,22
27866,0,1,6,7,14
27867,0,0,1,6,7
27868,0,0,10,31,41
27869,0,0,1,9,10
27870,0,0,7,21,28
27871,0,0,13,10,23
27872,0,0,15,34,49
27873,0,0,10,6,16
27874,0,0,0,6,6
27875,0,0,6,1,7
27877,1,2,14,33,50
27878,0,0,7,12,19
27879,0,1,3,10,14
27880,0,0,4,2,6
27881,0,1,2,14,17
27882,0,1,1,9,11
27883,1,0,13,23,37
27884,0,0,4,1,5
27885,0,0,7,15,22
27886,1,0,13,23,37
27887,0,0,3,9,12
27888,1,0,17,32,50
27889,0,0,5,14,19
27890,0,0,14,23,37
27891,0,0,10,9,19
27892,0,0,4,4,8
27894,0,0,3,8,11
27895,0,0,4,22,26
27896,0,0,5,9,14
27897,0,0,5,4,9
27898,0,0,1,11,12
27899,0,0,1,4,5
27900,0,1,3,18,22
27901,1,0,3,10,14
27902,0,0,3,8,11
27903,0,1,7,29,37
27904,0,0,6,15,21
27905,0,0,4,15,19
27906,0,1,6,3,10
27907,0,2,10,19,31
27908,0,0,14,24,38
27909,1,0,4,30,35
27910,0,0,5,11,16
27911,0,0,21,29,50
27912,0,0,9,10,19
27913,0,0,1,5,6
27914,0,0,14,9,23
27915,0,0,4,1,5
27916,0,0,6,6,12
27917,0,0,18,29,47
27918,0,1,6,22,29
27919,0,1,5,18,24
27920,0,0,6,4,10
27921,0,0,7,8,15
27922,0,0,12,8,20
27923,0,1,5,18,24
27926,0,0,5,1,6
27927,0,0,7,13,20
27928,0,2,10,17,29
27929,0,0,9,10,19
27930,0,0,7,17,24
27931,0,0,2,10,12
27932,0,0,6,19,25
27933,0,0,7,14,21
27934,1,0,3,31,35
27936,0,0,4,9,13
27937,1,1,5,18,25
27938,1,2,16,31,50
27939,0,0,0,10,10
27940,0,0,7,17,24
27941,0,0,2,11,13
27942,0,1,4,26,31
27943,0,0,12,27,39
27944,0,0,0,1,1
27945,0,0,1,11,12
27946,0,0,4,9,13
27947,0,0,6,37,43
27948,0,0,7,2,9
27949,0,0,2,9,11
27950,0,0,7,28,35
27951,0,0,6,2,8
27952,0,0,1,11,12
27953,0,0,1,4,5
27954,0,0,7,7,14
27955,0,0,7,15,22
27956,0,0,1,2,3
27957,0,0,2,11,13
27958,0,0,0,36,36
27959,0,0,3,3,6
27960,1,3,7,39,50
27961,0,0,4,11,15
27962,0,0,11,25,36
27963,0,0,0,8,8
27964,0,0,5,3,8
27965,0,1,8,14,23
27966,0,1,16,24,41
27967,0,0,8,13,21
27968,0,0,17,33,50
27969,0,3,2,37,42
27970,0,0,5,15,20
27971,0,0,9,12,21
27972,0,0,11,24,35
27973,0,0,8,8,16
27974,0,0,4,8,12
27975,0,0,11,15,26
27976,0,0,3,7,10
27977,0,0,17,33,50
27978,0,0,6,11,17
27979,0,1,3,17,21
27980,1,0,3,12,16
27981,0,0,4,6,10
27982,0,0,4,23,27
27983,0,0,5,7,12
27984,0,0,8,16,24
27985,0,0,5,20,25
27986,0,1,13,21,35
27987,0,0,16,31,47
27988,1,1,9,39,50
27989,0,0,3,8,11
27990,0,0,12,18,30
27991,0,0,14,19,33
27992,0,0,6,3,9
27993,0,0,1,1,2
27995,0,2,0,9,11
27996,0,1,11,21,33
27997,0,0,5,7,12
27998,0,2,2,18,22
27999,1,0,5,8,14
28000,0,2,7,28,37
28001,0,0,12,10,22
28002,0,0,9,14,23
28003,0,0,6,11,17
28004,0,0,2,7,9
28005,0,0,7,4,11
28006,0,0,6,31,37
28007,0,1,4,7,12
28008,0,2,7,10,19
28009,0,0,3,20,23
28010,0,0,1,2,3
28011,0,1,10,13,24
28012,0,0,7,30,37
28013,0,2,3,14,19
28014,0,0,21,29,50
28015,0,0,4,9,13
28016,0,0,0,7,7
28018,0,1,5,4,10
28020,0,0,7,6,13
28021,0,4,6,30,40
28022,4,6,10,27,47
28023,0,0,6,10,16
28024,0,0,5,8,13
28025,0,0,4,6,10
28026,3,0,11,36,50
28027,1,1,2,17,21
28028,0,0,4,2,6
28029,0,0,5,2,7
28030,0,0,5,3,8
28031,0,0,6,1,7
28032,0,0,6,11,17
28033,0,3,2,7,12
28034,0,0,7,13,20
28035,0,1,4,5,10
28037,0,0,13,10,23
28038,0,6,4,22,32
28039,0,0,20,29,49
28040,0,1,4,18,23
28041,0,0,5,17,22
28042,0,0,3,3,6
28043,0,0,9,35,44
28044,0,0,13,12,25
28045,0,0,4,10,14
28046,0,0,5,8,13
28047,0,0,10,23,33
28049,0,0,6,3,9
28050,0,0,5,5,10
28051,0,1,5,4,10
28052,0,0,12,17,29
28053,0,0,7,10,17
28054,0,2,2,12,16
28055,0,0,7,9,16
28056,0,0,4,11,15
28057,0,0,4,21,25
28058,0,0,1,3,4
28059,0,0,6,10,16
28060,0,4,5,23,32
28061,0,0,2,5,7
28062,0,0,4,9,13
28063,0,0,7,10,17
28064,0,0,6,9,15
28065,1,0,4,16,21
28067,0,0,13,17,30
28068,0,0,6,17,23
28069,0,1,7,17,25
28070,0,5,4,15,24
28071,0,0,9,9,18
28072,0,1,6,11,18
28073,0,1,5,14,20
28074,0,0,4,5,9
28075,0,0,5,9,14
28076,0,1,2,7,10
28077,0,0,9,5,14
28078,0,1,3,5,9
28079,0,0,6,20,26
28080,0,1,2,11,14
28081,0,0,1,7,8
28082,0,0,7,6,13
28084,0,0,6,4,10
28085,0,0,0,5,5
28086,0,0,4,9,13
28087,0,0,1,22,23
28088,0,0,7,11,18
28089,0,0,6,7,13
28090,1,0,4,4,9
28091,0,0,6,29,35
28092,1,0,4,5,10
28093,0,0,8,1,9
28094,0,3,12,29,44
28095,0,0,4,13,17
28096,0,1,10,20,31
28097,0,0,11,2,13
28098,0,0,7,8,15
28099,0,0,6,13,19
28100,0,0,3,6,9
28101,0,0,11,10,21
28102,0,0,7,2,9
28103,0,0,4,7,11
28104,0,0,5,8,13
28105,0,2,5,24,31
28106,1,0,6,10,17
28107,0,0,4,10,14
28108,0,1,0,4,5
28109,0,0,17,23,40
28110,0,0,15,35,50
28111,0,0,2,14,16
28112,0,2,3,10,15
28113,0,0,13,15,28
28114,0,0,2,4,6
28115,0,0,4,13,17
28116,0,0,0,7,7
28117,0,1,9,12,22
28118,0,0,4,8,12
28119,2,0,3,9,14
28120,0,0,5,3,8
28121,0,0,2,5,7
28122,0,0,6,8,14
28123,0,0,14,36,50
28124,0,2,7,4,13
28125,0,0,5,11,16
28126,0,0,5,0,5
28127,0,0,10,17,27
28128,0,1,8,10,19
28129,0,0,8,14,22
28130,0,3,10,14,27
28131,0,0,11,31,42
28132,0,0,3,6,9
28133,0,0,8,13,21
28134,0,0,6,4,10
28135,0,0,13,14,27
28136,0,1,5,29,35
28137,0,0,14,11,25
28138,0,0,9,17,26
28139,0,0,3,18,21
28140,0,0,16,16,32
28141,0,0,7,10,17
28143,0,1,9,9,19
28145,0,0,1,9,10
28146,0,0,4,9,13
28147,0,1,5,4,10
28148,0,0,1,5,6
28149,0,1,5,5,11
28150,0,0,7,15,22
28151,0,0,15,30,45
28154,0,0,4,8,12
28156,0,0,5,15,20
28158,0,2,11,12,25
28159,0,0,2,5,7
28161,0,0,1,3,4
28165,0,0,2,3,5
28167,0,0,0,5,5
28169,0,0,0,5,5
28173,0,0,0,5,5
28175,0,0,2,15,17
28176,0,0,6,5,11
28177,0,0,2,3,5
28178,1,2,10,36,49
28179,0,0,12,27,39
28180,1,0,9,8,18
28181,0,1,2,26,29
28182,0,1,2,3,6
28183,0,0,0,5,5
28184,0,0,2,3,5
28185,0,2,3,9,14
28186,0,0,1,4,5
28187,2,1,5,19,27
28188,0,1,1,11,13
28189,0,0,1,6,7
28190,0,0,3,3,6
28191,0,0,6,16,22
28192,0,1,5,5,11
28193,0,0,7,40,47
28194,0,0,12,21,33
28195,0,0,4,3,7
28196,1,2,4,11,18
28197,0,1,4,1,6
28198,0,1,2,23,26
28199,0,1,7,41,49
28200,0,0,8,10,18
28201,0,1,9,10,20
28202,0,2,4,14,20
28203,0,0,0,5,5
28204,0,0,5,3,8
28205,0,1,7,9,17
28206,0,0,12,27,39
28207,0,0,18,32,50
28208,0,4,7,16,27
28209,0,0,17,19,36
28210,0,0,16,34,50
28211,1,1,7,27,36
28212,0,0,1,7,8
28213,0,1,4,40,45
28214,0,0,8,3,11
28215,0,0,0,5,5
28216,0,1,8,8,17
28217,0,0,10,17,27
28218,0,0,11,26,37
28219,1,3,6,39,49
28220,0,0,13,29,42
28221,0,0,1,9,10
28222,0,0,6,14,20
28223,0,2,11,37,50
28224,0,1,11,13,25
28225,0,2,14,34,50
28226,0,1,11,19,31
28227,0,2,12,31,45
28228,0,2,8,32,42
28229,1,0,8,40,49
28230,2,0,8,40,50
28231,0,0,4,15,19
28232,0,1,4,12,17
28233,0,0,6,44,50
28234,0,0,6,5,11
28235,0,0,1,8,9
28236,0,0,10,11,21
28237,0,0,0,2,2
28238,0,0,12,27,39
28239,0,0,6,22,28
28240,1,0,4,13,18
28241,0,1,5,10,16
28242,0,0,12,21,33
28243,0,0,8,29,37
28244,0,1,8,32,41
28245,0,0,3,22,25
28246,0,2,11,29,42
28247,0,0,1,9,10
28248,0,0,11,39,50
28249,0,0,13,10,23
28250,0,1,13,12,26
28251,0,1,10,25,36
28252,0,0,13,16,29
28253,0,0,17,31,48
28254,0,1,4,9,14
28255,2,0,12,14,28
28256,0,0,6,8,14
28257,0,0,9,5,14
28258,0,0,7,5,12
28259,0,0,15,34,49
28260,0,0,11,37,48
28261,0,0,8,25,33
28262,0,0,8,14,22
28263,3,1,11,30,45
28264,0,0,5,24,29
28265,0,0,4,7,11
28266,1,2,2,18,23
28267,0,2,11,26,39
28268,0,0,5,20,25
28269,0,0,9,41,50
28270,1,0,2,15,18
28271,0,1,13,35,49
28272,1,0,6,12,19
28273,0,0,1,4,5
28275,0,0,11,12,23
28276,0,2,11,31,44
28277,0,0,4,24,28
28278,0,1,5,16,22
28279,0,0,5,8,13
28280,0,1,2,7,10
28281,0,0,8,5,13
28282,0,1,5,24,30
28283,0,0,18,14,32
28284,0,0,8,7,15
28285,0,0,5,8,13
28286,0,0,3,5,8
28287,0,1,9,14,24
28288,0,1,4,45,50
28289,0,3,7,39,49
28290,1,0,4,22,27
28291,0,2,2,14,18
28292,0,0,2,3,5
28293,0,1,1,6,8
28294,0,0,13,26,39
28295,0,0,8,12,20
28296,0,1,16,33,50
28297,1,0,11,30,42
28298,0,0,7,8,15
28299,1,1,10,38,50
28300,0,0,0,11,11
28302,0,1,6,12,19
28303,0,1,2,26,29
28304,0,0,11,22,33
28305,0,0,1,9,10
28306,3,1,3,19,26
28307,1,0,21,28,50
28308,0,1,9,40,50
28309,0,0,4,6,10
28310,0,0,12,22,34
28311,0,0,20,30,50
28312,0,0,9,16,25
28313,0,1,25,23,49
28314,1,0,14,27,42
28315,0,0,2,11,13
28316,1,0,7,41,49
28317,0,1,13,32,46
28318,0,0,8,16,24
28319,0,1,14,21,36
28320,0,0,13,21,34
28321,0,0,14,30,44
28322,1,1,3,15,20
28323,0,0,2,15,17
28324,0,0,23,24,47
28325,0,0,12,20,32
28326,0,0,2,15,17
28327,0,0,2,3,5
28328,0,1,15,31,47
28329,0,2,2,19,23
28330,2,0,17,29,48
28331,0,0,2,12,14
28332,2,0,5,16,23
28333,0,0,1,4,5
28335,0,0,5,9,14
28336,0,0,2,5,7
28337,0,0,2,9,11
28338,0,0,15,35,50
28339,1,0,1,12,14
28340,0,0,12,21,33
28341,0,1,6,11,18
28344,0,0,5,6,11
28345,0,0,10,12,22
28346,0,0,2,4,6
28348,0,0,5,8,13
28349,0,0,8,11,19
28350,0,2,10,33,45
28351,0,0,14,16,30
28352,0,0,2,3,5
28353,1,0,3,14,18
28354,0,1,2,3,6
28355,0,0,3,4,7
28356,0,2,17,26,45
28357,0,0,1,5,6
28358,0,0,3,13,16
28359,0,0,2,3,5
28360,0,1,10,13,24
28361,0,0,0,36,36
28362,0,4,6,30,40
28363,0,0,21,29,50
28364,0,0,7,30,37
28365,0,0,8,8,16
28367,0,0,4,7,11
28368,0,0,3,3,6
28369,0,0,7,40,47
28370,0,0,4,25,29
28371,0,0,4,20,24
28372,1,0,16,33,50
28373,1,0,3,12,16
28374,0,0,1,6,7
28375,0,0,6,16,22
28376,0,1,4,18,23
28377,0,1,1,11,13
28378,0,0,4,3,7
28379,0,1,5,5,11
28381,0,0,4,9,13
28382,1,2,7,28,38
28383,0,2,1,29,32
28384,1,0,6,33,40
28385,0,2,10,33,45
28386,0,1,2,23,26
28387,1,0,16,33,50
28388,0,0,8,11,19
28389,0,0,13,25,38
28390,1,0,8,20,29
28391,0,0,0,6,6
28393,1,0,3,8,12
28394,0,0,14,36,50
28395,0,0,3,35,38
28396,0,1,5,24,30
28397,0,0,1,7,8
28398,1,1,0,8,10
28399,1,0,6,12,19
28400,0,0,1,13,14
28401,1,2,2,18,23
28402,3,2,1,14,20
28403,0,0,0,5,5
28404,0,0,1,4,5
28405,0,1,4,45,50
28406,0,0,1,13,14
28407,0,0,16,34,50
28408,3,1,3,19,26
28409,0,2,6,9,17
28410,0,0,2,13,15
28411,0,0,3,10,13
28412,0,0,9,23,32
28413,0,0,3,7,10
28414,0,0,9,37,46
28415,1,0,5,44,50
28416,0,0,13,29,42
28418,1,1,3,15,20
28419,0,0,20,30,50
28420,0,0,18,31,49
28421,0,0,2,7,9
28422,1,0,10,30,41
28423,4,0,9,37,50
28424,0,3,12,29,44
28425,0,0,5,24,29
28426,0,0,4,25,29
28427,0,0,0,2,2
28428,4,0,1,25,30
28429,0,2,2,12,16
28430,1,0,2,16,19
28431,1,1,7,36,45
28432,0,0,5,8,13
28433,1,0,3,14,18
28434,1,0,10,30,41
28435,4,0,1,25,30
28436,1,3,6,39,49
28437,0,1,4,30,35
28438,1,0,8,34,43
28439,0,0,13,25,38
28440,0,0,4,25,29
28441,0,0,9,25,34
28442,1,0,17,29,47
28443,0,0,9,16,25
28444,1,0,8,9,18
28445,0,0,10,19,29
28446,3,1,3,19,26
28447,0,0,3,16,19
28448,1,0,14,35,50
28449,0,0,2,3,5
28450,0,1,4,40,45
28451,0,0,11,19,30
28452,1,0,5,44,50
28453,0,0,1,4,5
28454,1,2,6,41,50
28455,0,0,6,15,21
28456,0,1,10,13,24
28457,0,0,3,16,19
28458,0,0,2,15,17
28459,5,0,2,14,21
28460,0,0,20,30,50
28461,1,0,16,33,50
28462,5,0,2,14,21
28463,0,0,13,25,38
28464,1,0,16,33,50
28465,4,0,9,37,50
28466,0,0,3,13,16
28467,4,2,1,35,42
28468,0,1,2,3,6
28469,0,0,13,25,38
28470,1,3,6,39,49
28471,1,1,9,39,50
28472,0,0,17,19,36
28473,1,2,14,33,50
28474,0,0,9,3,12
28475,0,2,10,33,45
28476,1,2,10,36,49
28477,0,0,8,16,24
28478,0,2,17,26,45
28479,0,0,3,13,16
28480,0,0,1,4,5
28481,0,1,10,13,24
28482,0,1,1,11,13
28483,0,0,13,12,25
28484,0,0,1,6,7
28485,0,3,12,29,44
28486,0,1,2,26,29
28487,4,2,1,35,42
28488,1,0,16,33,50
28489,1,2,4,11,18
28490,0,0,0,5,5
28491,0,0,4,14,18
28492,0,0,5,13,18
28493,0,0,5,15,20
28494,0,0,8,11,19
28495,0,0,9,28,37
28496,0,1,5,10,16
28498,0,1,2,10,13
28499,0,0,0,5,5
28500,0,0,5,14,19
28501,0,0,6,0,6
28502,1,0,11,23,35
28503,0,0,4,5,9
28504,0,0,9,12,21
28505,0,0,6,21,27
28506,0,1,2,3,6
28507,0,0,4,15,19
28508,0,1,8,25,34
28509,0,0,11,35,46
28510,0,2,11,30,43
28511,0,0,11,18,29
28512,0,1,14,21,36
28513,0,0,8,11,19
28514,0,0,11,17,28
28515,0,0,10,11,21
28516,0,0,2,19,21
28517,0,0,4,9,13
28518,2,0,6,37,45
28519,3,0,7,21,31
28520,0,0,5,4,9
28522,0,0,1,5,6
28523,0,0,7,17,24
28524,0,0,5,14,19
28525,0,1,5,7,13
28526,0,0,4,14,18
28527,1,0,3,6,10
28528,0,0,7,17,24
28529,0,1,16,31,48
28530,0,0,4,18,22
28531,0,0,14,20,34
28532,0,0,2,16,18
28534,0,0,6,11,17
28535,0,0,3,5,8
28536,0,0,6,4,10
28537,0,0,1,6,7
28538,0,0,14,21,35
28539,0,2,6,38,46
28540,0,1,11,15,27
28541,0,0,2,35,37
28542,1,0,8,24,33
28543,0,0,5,11,16
28544,1,0,7,10,18
28545,0,0,10,9,19
28546,0,0,10,5,15
28547,0,0,6,6,12
28548,0,1,1,21,23
28549,0,0,4,2,6
28550,0,0,3,10,13
28551,0,0,7,28,35
28552,0,0,3,24,27
28553,0,0,8,12,20
28554,0,0,14,12,26
28555,0,0,0,11,11
28556,0,2,17,20,39
28557,0,0,9,14,23
28558,0,2,8,14,24
28559,0,1,10,7,18
28560,0,1,13,21,35
28561,0,0,7,11,18
28562,0,0,4,24,28
28563,0,0,1,4,5
28564,0,0,3,6,9
28565,0,1,13,22,36
28566,0,0,8,42,50
28567,0,0,7,14,21
28568,0,0,1,9,10
28569,2,0,8,26,36
28570,0,0,6,8,14
28571,0,1,1,7,9
28572,0,1,6,13,20
28573,0,0,8,9,17
28574,0,0,6,7,13
28575,0,0,6,22,28
28576,0,0,12,6,18
28577,0,0,9,28,37
28578,1,0,4,15,20
28579,0,0,3,16,19
28580,0,0,5,19,24
28582,0,0,5,3,8
28583,0,0,6,11,17
28584,0,0,5,10,15
28585,0,0,4,12,16
28587,0,1,5,19,25
28588,0,0,10,21,31
28590,0,0,2,4,6
28591,0,0,0,7,7
28592,1,1,17,25,44
28593,0,0,6,10,16
28595,0,0,5,6,11
28596,0,0,7,19,26
28597,0,0,13,21,34
28598,0,0,4,4,8
28599,0,0,6,3,9
28600,0,1,6,14,21
28601,0,0,3,5,8
28602,0,0,13,12,25
28603,2,0,9,13,24
28604,0,1,1,19,21
28605,0,2,4,32,38
28606,0,0,2,6,8
28607,0,0,4,6,10
28608,0,0,11,26,37
28609,0,1,5,10,16
28610,0,0,10,15,25
28611,0,0,1,5,6
28612,0,0,5,15,20
28613,4,0,8,24,36
28614,0,0,1,4,5
28615,0,0,12,23,35
28616,0,0,9,14,23
28617,0,0,3,18,21
28618,1,0,8,6,15
28619,1,0,4,19,24
28620,0,0,4,4,8
28621,0,0,13,29,42
28622,1,0,0,13,14
28623,0,0,3,2,5
28624,1,2,12,28,43
28626,0,2,10,38,50
28627,0,0,5,13,18
28628,0,0,6,5,11
28629,0,0,1,5,6
28630,0,0,1,13,14
28631,0,1,4,29,34
28632,1,16,3,30,50
28633,0,0,8,5,13
28634,0,0,4,4,8
28635,0,0,10,15,25
28636,0,0,9,26,35
28637,0,1,2,26,29
28638,1,0,1,9,11
28639,1,1,6,25,33
28640,0,0,3,12,15
28641,0,0,1,12,13
28642,0,5,6,22,33
28643,0,0,2,6,8
28644,0,0,1,5,6
28645,0,0,5,14,19
28646,0,0,3,9,12
28648,0,0,9,18,27
28649,0,0,6,5,11
28650,0,0,0,1,1
28651,0,0,4,7,11
28652,0,0,6,4,10
28653,0,0,12,22,34
28654,0,1,4,7,12
28655,0,0,2,7,9
28656,0,0,9,17,26
28657,0,1,13,27,41
28658,0,0,1,4,5
28659,1,0,3,13,17
28660,0,0,7,13,20
28661,0,0,6,18,24
28662,0,0,7,12,19
28663,0,0,9,22,31
28664,0,0,7,6,13
28665,0,0,7,7,14
28666,0,0,1,5,6
28667,0,0,5,8,13
28668,0,0,5,4,9
28669,0,0,4,12,16
28670,0,0,8,14,22
28671,0,0,5,15,20
28672,0,0,3,16,19
28673,0,0,1,28,29
28674,0,0,8,13,21
28675,0,0,1,15,16
28678,0,0,8,12,20
28680,1,2,2,15,20
28681,0,0,7,21,28
28682,2,0,0,18,20
28683,0,1,3,13,17
28684,0,0,1,9,10
28685,0,1,2,10,13
28686,0,0,8,8,16
28687,0,0,5,5,10
28688,0,0,1,6,7
28689,0,0,0,5,5
28690,0,0,0,6,6
28691,0,0,5,21,26
28692,5,0,4,37,46
28693,0,0,0,5,5
28694,0,0,2,15,17
28695,0,0,10,16,26
28696,0,0,5,15,20
28697,0,2,9,36,47
28698,0,2,2,12,16
28699,0,0,4,13,17
28700,1,4,9,33,47
28701,0,0,6,7,13
28702,0,0,9,34,43
28703,0,0,15,27,42
28704,0,0,14,36,50
28705,1,0,2,18,21
28706,0,0,9,33,42
28707,0,0,7,21,28
28708,2,0,8,40,50
28709,0,0,7,11,18
28710,0,2,18,30,50
28711,0,1,13,31,45
28712,0,0,10,33,43
28713,0,0,15,14,29
28714,0,0,0,9,9
28715,0,1,5,7,13
28716,1,0,12,33,46
28717,0,0,18,30,48
28718,1,0,4,45,50
28719,1,0,2,14,17
28720,0,0,14,5,19
28721,0,0,9,6,15
28722,0,3,8,38,49
28723,1,0,7,21,29
28724,0,0,2,19,21
28725,0,0,14,21,35
28726,1,0,13,11,25
28728,0,0,2,16,18
28729,0,0,3,19,22
28730,1,0,19,19,39
28731,0,0,1,10,11
28732,0,1,12,16,29
28733,0,0,4,16,20
28734,0,0,12,9,21
28735,0,0,10,3,13
28736,0,1,9,14,24
28737,0,0,13,16,29
28738,0,0,16,32,48
28739,1,0,11,23,35
28740,0,0,6,7,13
28741,0,0,3,4,7
28742,0,1,15,18,34
28744,0,0,23,22,45
28745,0,1,3,6,10
28746,0,0,7,28,35
28747,0,0,9,27,36
28748,0,0,3,25,28
28750,0,0,7,17,24
28751,0,2,11,25,38
28752,0,0,7,14,21
28753,0,1,12,35,48
28754,0,0,11,16,27
28755,0,0,12,13,25
28756,0,1,9,20,30
28757,0,1,17,31,49
28758,1,0,15,26,42
28759,0,0,9,7,16
28760,0,0,1,8,9
28761,0,0,1,0,1
28763,0,0,8,8,16
28764,0,1,6,21,28
28765,0,0,12,21,33
28766,0,0,11,22,33
28767,0,1,6,30,37
28768,0,0,4,15,19
28769,0,0,11,17,28
28770,0,1,8,19,28
28771,0,0,0,3,3
28772,2,0,12,35,49
28773,0,0,9,19,28
28774,0,1,3,13,17
28776,1,0,8,6,15
28777,0,3,11,24,38
28778,0,0,2,19,21
28779,2,2,1,25,30
28780,0,1,12,12,25
28781,0,0,11,23,34
28782,0,1,7,41,49
28783,0,0,7,43,50
28784,0,1,13,22,36
28785,0,0,7,24,31
28786,0,0,2,2,4
28787,0,0,2,7,9
28788,0,0,7,9,16
28789,0,0,3,25,28
28790,0,0,13,35,48
28791,0,0,9,41,50
28792,1,1,7,17,26
28793,0,0,10,17,27
28794,0,0,6,12,18
28795,1,1,2,35,39
28796,0,0,0,9,9
28798,0,2,2,8,12
28799,0,0,14,6,20
28801,0,0,0,4,4
28802,0,0,9,11,20
28803,3,0,4,22,29
28804,0,0,0,1,1
28805,0,0,7,6,13
28807,0,0,7,25,32
28809,0,0,17,31,48
28810,0,0,12,4,16
28811,0,0,13,20,33
28812,0,0,5,11,16
28813,0,1,8,25,34
28814,0,0,8,11,19
28815,0,0,5,14,19
28816,0,0,7,12,19
28817,0,0,8,7,15
28818,0,0,10,16,26
28819,0,0,0,7,7
28820,0,0,0,6,6
28821,1,0,8,24,33
28822,0,0,5,21,26
28824,0,0,15,32,47
28825,0,0,2,15,17
28826,6,1,6,10,23
28827,5,1,6,29,41
28828,1,2,2,15,20
28829,0,0,2,7,9
28830,0,2,1,13,16
28831,2,0,0,18,20
28832,0,0,1,10,11
28833,0,0,3,9,12
28834,0,0,14,36,50
28835,0,0,2,33,35
28836,0,3,0,19,22
28838,0,0,1,21,22
28839,0,0,13,32,45
28840,0,0,10,7,17
28841,1,2,8,25,36
28842,0,3,8,38,49
28843,0,0,7,11,18
28844,2,0,12,35,49
28845,0,0,0,2,2
28846,0,0,6,44,50
28847,0,0,2,23,25
28848,0,1,8,19,28
28849,0,0,5,21,26
28850,0,1,2,13,16
28851,0,0,8,11,19
28852,0,2,2,12,16
28853,0,0,15,35,50
28855,0,0,0,7,7
28856,0,0,15,29,44
28857,0,0,1,5,6
28858,1,0,2,18,21
28859,0,0,0,5,5
28860,2,0,0,18,20
28861,0,1,2,13,16
28862,0,0,14,6,20
28864,0,0,5,10,15
28865,0,0,17,31,48
28866,0,0,2,15,17
28867,5,0,2,14,21
28868,4,0,8,24,36
28869,5,1,6,29,41
28870,0,0,5,21,26
28871,5,0,2,14,21
28872,0,0,5,21,26
28873,5,1,6,29,41
28874,0,0,15,32,47
28875,0,1,8,25,34
28876,4,0,8,24,36
28877,0,0,17,31,48
28878,0,0,10,13,23
28879,0,0,2,6,8
28880,0,0,3,7,10
28881,0,0,6,4,10
28882,0,0,1,4,5
28883,1,0,10,22,33
28884,0,0,11,14,25
28885,0,0,8,26,34
28886,0,0,6,16,22
28887,0,0,8,11,19
28888,0,0,5,3,8
28889,0,1,5,12,18
28890,0,1,16,33,50
28891,0,0,7,13,20
28892,0,0,5,17,22
28893,0,0,10,33,43
28894,0,0,1,5,6
28896,0,0,1,10,11
28897,0,0,3,3,6
28898,0,0,5,27,32
28899,0,0,4,9,13
28900,0,0,2,20,22
28901,0,0,4,10,14
28902,0,0,10,18,28
28903,0,1,3,19,23
28904,0,0,1,7,8
28905,0,0,5,5,10
28906,0,0,6,7,13
28908,0,0,6,7,13
28909,0,0,8,29,37
28910,1,1,3,29,34
28911,0,0,4,7,11
28912,0,0,8,11,19
28913,1,0,15,19,35
28914,0,0,0,24,24
28915,0,0,2,6,8
28916,0,0,3,5,8
28917,0,0,10,11,21
28918,0,1,2,26,29
28919,0,0,14,13,27
28920,0,0,1,17,18
28921,0,0,3,4,7
28922,0,0,0,5,5
28923,0,0,6,5,11
28924,0,0,4,6,10
28925,0,1,2,13,16
28926,0,0,2,9,11
28927,0,0,5,6,11
28928,0,1,13,11,25
28929,0,0,10,10,20
28930,0,0,10,30,40
28931,0,3,3,13,19
28932,0,0,1,6,7
28933,0,0,13,35,48
28934,3,0,4,25,32
28935,0,0,2,16,18
28936,0,0,5,25,30
28937,0,0,17,30,47
28938,0,0,2,8,10
28939,0,1,14,31,46
28940,0,0,2,6,8
28941,0,0,1,5,6
28942,1,0,15,28,44
28943,0,0,5,7,12
28944,0,0,1,4,5
28945,0,1,5,8,14
28946,0,2,3,27,32
28947,0,0,6,6,12
28948,0,0,5,5,10
28949,0,0,2,6,8
28950,0,0,9,35,44
28951,0,0,4,9,13
28952,2,0,15,28,45
28953,0,0,7,17,24
28954,0,0,12,13,25
28955,0,1,3,16,20
28956,0,0,4,2,6
28957,0,0,5,17,22
28958,1,0,11,23,35
28959,0,0,9,33,42
28960,0,1,11,10,22
28961,0,0,16,34,50
28962,0,0,9,18,27
28963,0,1,6,28,35
28964,0,1,2,28,31
28965,1,1,9,37,48
28966,1,0,9,14,24
28967,0,0,5,2,7
28968,0,0,16,31,47
28969,0,0,4,23,27
28970,0,2,18,30,50
28971,1,0,2,16,19
28972,0,0,6,4,10
28973,0,1,1,9,11
28974,0,0,7,19,26
28975,0,0,1,6,7
28976,0,1,6,30,37
28977,1,0,5,11,17
28979,0,0,8,21,29
28980,0,2,5,8,15
28981,0,1,7,22,30
28982,0,0,4,5,9
28983,0,0,3,14,17
28984,0,2,3,8,13
28985,0,0,2,3,5
28986,0,0,5,8,13
28987,0,0,3,15,18
28988,1,0,6,23,30
28989,0,0,3,13,16
28990,0,1,2,13,16
28992,1,1,1,5,8
28993,0,1,4,14,19
28994,0,1,5,11,17
28995,0,0,2,9,11
28996,0,0,11,13,24
28997,0,0,6,3,9
28998,0,1,6,12,19
28999,1,0,12,27,40
29000,0,0,0,5,5
29001,0,0,13,35,48
29002,0,0,2,7,9
29003,0,1,5,20,26
29004,0,0,2,3,5
29005,0,0,2,6,8
29006,0,0,8,14,22
29007,0,0,5,6,11
29008,0,0,0,5,5
29009,0,0,4,9,13
29011,2,0,2,30,34
29013,1,1,15,33,50
29014,0,0,5,15,20
29015,0,0,6,2,8
29016,0,0,5,9,14
29017,0,1,2,3,6
29018,0,0,21,29,50
29019,0,0,7,6,13
29021,0,0,12,28,40
29022,0,1,2,1,4
29023,0,0,7,40,47
29024,0,1,6,27,34
29025,0,0,2,7,9
29026,0,1,2,7,10
29028,0,1,4,25,30
29029,0,0,5,23,28
29030,0,1,4,18,23
29031,0,2,4,11,17
29032,1,1,9,38,49
29033,0,0,11,14,25
29034,0,1,0,25,26
29035,0,0,11,11,22
29036,0,2,10,21,33
29037,0,0,0,10,10
29038,0,2,4,28,34
29039,0,1,3,14,18
29040,0,0,9,13,22
29041,5,1,2,17,25
29042,0,0,9,17,26
29043,2,1,9,37,49
29044,0,0,5,6,11
29045,1,0,3,33,37
29046,0,0,1,8,9
29047,0,0,17,31,48
29048,0,0,9,20,29
29049,0,0,8,18,26
29050,0,3,0,11,14
29051,0,0,7,15,22
29052,0,0,5,10,15
29053,0,1,5,13,19
29054,0,0,18,32,50
29055,2,0,2,30,34
29056,0,0,18,32,50
29057,0,0,7,17,24
29058,0,0,7,5,12
29059,0,0,10,19,29
29060,0,0,12,19,31
29061,0,1,5,9,15
29062,0,0,2,11,13
29063,0,0,3,14,17
29064,1,0,16,33,50
29065,1,0,4,20,25
29066,0,0,8,8,16
29067,0,1,1,12,14
29068,0,0,7,22,29
29069,0,0,4,14,18
29070,0,0,6,22,28
29071,0,0,8,10,18
29072,0,0,10,33,43
29073,0,1,13,36,50
29074,0,1,9,15,25
29075,0,1,3,13,17
29076,0,0,13,31,44
29077,1,1,6,17,25
29078,0,1,9,24,34
29079,0,0,9,9,18
29080,0,1,8,41,50
29081,0,0,20,25,45
29082,0,0,7,18,25
29083,0,1,0,11,12
29084,1,1,13,35,50
29085,1,0,3,15,19
29086,0,0,12,36,48
29087,0,0,0,3,3
29088,0,0,6,2,8
29089,0,3,15,19,37
29090,0,0,13,27,40
29091,0,0,2,8,10
29092,0,3,9,22,34
29093,0,0,15,35,50
29094,0,0,16,34,50
29095,0,0,7,11,18
29096,0,1,16,22,39
29097,0,0,5,2,7
29098,0,0,5,7,12
29099,0,0,5,23,28
29100,0,0,6,8,14
29101,1,1,10,25,37
29102,0,0,3,13,16
29103,2,1,2,8,13
29104,0,0,7,10,17
29105,1,0,2,5,8
29106,4,0,9,24,37
29107,0,0,2,9,11
29108,1,0,1,15,17
29109,0,0,10,17,27
29110,0,0,5,4,9
29111,1,0,5,6,12
29112,1,0,15,34,50
29113,0,0,15,30,45
29114,2,1,6,18,27
29115,0,0,12,38,50
29116,0,0,13,37,50
29117,0,0,7,15,22
29118,1,0,5,11,17
29119,0,0,12,5,17
29120,1,0,8,10,19
29122,0,0,6,7,13
29123,0,0,6,6,12
29125,0,0,4,14,18
29126,0,0,9,18,27
29127,0,0,0,10,10
29128,2,0,5,14,21
29129,0,0,0,8,8
29130,0,0,3,3,6
29131,0,0,6,10,16
29132,0,2,3,27,32
29133,1,1,15,33,50
29134,0,0,21,29,50
29135,0,1,4,18,23
29136,3,0,14,33,50
29137,3,0,4,25,32
29138,0,1,2,3,6
29139,0,0,2,9,11
29141,0,0,7,40,47
29142,0,1,2,7,10
29143,0,1,4,25,30
29144,0,0,12,28,40
29145,1,0,3,23,27
29146,0,1,6,27,34
29147,0,1,4,27,32
29148,0,1,2,18,21
29149,0,0,12,29,41
29150,0,0,3,8,11
29151,0,0,0,13,13
29152,0,3,0,11,14
29153,2,1,9,37,49
29154,0,0,0,10,10
29155,0,0,2,4,6
29156,1,1,3,45,50
29157,0,0,7,11,18
29158,2,0,5,10,17
29159,4,0,3,28,35
29160,4,0,9,24,37
29161,1,0,5,16,22
29162,1,0,2,5,8
29163,0,1,2,18,21
29164,0,0,7,9,16
29165,0,0,5,23,28
29166,0,0,9,16,25
29168,1,0,3,23,27
29169,0,1,2,13,16
29170,3,2,2,23,30
29171,1,0,5,14,20
29172,0,2,4,11,17
29173,0,0,6,10,16
29174,1,0,9,21,31
29175,0,1,2,13,16
29176,0,0,11,31,42
29177,0,3,0,11,14
29178,0,0,1,4,5
29179,1,1,3,45,50
29180,2,1,2,8,13
29181,4,1,0,21,26
29182,0,0,9,13,22
29183,0,1,4,27,32
29184,4,1,0,21,26
29185,0,0,12,38,50
29186,0,1,4,27,32
29187,0,0,7,13,20
29188,0,1,2,3,6
29189,0,0,8,8,16
29190,0,0,9,13,22
29191,0,0,6,16,22
29192,3,0,14,33,50
29193,3,0,4,25,32
29194,0,0,5,13,18
29195,0,0,4,9,13
29196,0,1,11,25,37
29197,0,0,8,11,19
29198,0,0,10,12,22
29199,0,0,1,7,8
29200,0,0,8,13,21
29201,0,0,7,8,15
29202,0,0,6,20,26
29203,0,1,3,20,24
29204,0,0,2,3,5
29205,1,2,5,34,42
29206,0,0,3,6,9
29207,0,0,4,6,10
29208,0,0,4,2,6
29209,0,0,2,4,6
29210,0,0,3,8,11
29211,0,1,3,15,19
29212,0,0,1,3,4
29213,0,0,7,23,30
29214,0,0,1,21,22
29215,0,1,6,18,25
29216,0,0,5,5,10
29217,0,0,4,11,15
29218,0,0,10,5,15
29219,0,1,4,19,24
29220,0,0,4,15,19
29221,0,3,2,13,18
29222,0,0,1,6,7
29223,0,1,5,33,39
29224,0,0,2,15,17
29226,0,1,3,21,25
29227,0,0,4,14,18
29228,0,0,21,17,38
29229,0,0,0,9,9
29231,0,0,2,14,16
29232,0,0,7,6,13
29233,1,0,4,44,49
29234,0,0,16,23,39
29235,0,1,11,23,35
29236,1,1,1,12,15
29237,0,0,7,21,28
29239,1,1,9,7,18
29240,0,0,5,6,11
29241,0,0,3,9,12
29242,0,0,7,43,50
29243,0,0,6,11,17
29244,0,0,4,10,14
29245,0,1,3,18,22
29246,1,0,2,11,14
29247,0,0,3,7,10
29248,0,0,3,7,10
29249,0,0,9,9,18
29251,0,0,2,10,12
29252,0,3,8,21,32
29253,0,0,9,11,20
29254,0,0,2,3,5
29255,0,0,10,32,42
29256,3,3,4,35,45
29257,2,0,3,10,15
29258,0,1,1,15,17
29259,0,0,5,21,26
29260,2,2,3,11,18
29261,0,0,4,9,13
29262,0,0,0,1,1
29263,0,0,10,22,32
29264,0,0,4,12,16
29265,0,0,1,8,9
29266,0,0,2,9,11
29267,0,1,1,9,11
29268,1,0,7,13,21
29269,0,0,9,11,20
29270,0,0,10,10,20
29271,0,0,12,29,41
29272,0,0,7,10,17
29273,0,1,15,34,50
29274,0,0,9,15,24
29275,0,1,7,24,32
29276,0,0,4,16,20
29277,0,1,3,19,23
29278,0,0,6,11,17
29279,0,0,1,4,5
29280,0,0,6,24,30
29281,0,1,6,22,29
29282,0,0,3,3,6
29284,0,0,4,6,10
29285,0,0,7,42,49
29286,0,0,8,17,25
29287,0,0,3,8,11
29288,0,0,2,3,5
29289,0,1,7,19,27
29290,0,0,4,8,12
29291,0,1,19,30,50
29292,0,1,8,21,30
29293,0,1,3,24,28
29294,0,1,8,37,46
29295,0,0,7,11,18
29296,0,1,11,35,47
29297,0,2,19,28,49
29298,0,0,9,26,35
29299,0,1,4,16,21
29300,0,1,3,13,17
29301,0,0,3,15,18
29302,0,0,3,3,6
29303,0,0,4,8,12
29304,0,0,10,22,32
29305,0,0,4,4,8
29306,0,1,9,22,32
29307,0,0,5,10,15
29308,0,0,18,32,50
29309,0,0,13,31,44
29310,0,0,3,9,12
29311,0,0,7,15,22
29312,0,0,4,11,15
29313,0,3,5,14,22
29314,0,0,2,4,6
29315,0,0,5,10,15
29316,0,0,2,7,9
29317,0,0,15,13,28
29318,0,1,2,27,30
29319,0,0,7,13,20
29322,0,0,5,1,6
29323,0,1,6,9,16
29324,0,0,5,10,15
29325,0,0,4,10,14
29326,0,1,6,17,24
29327,0,0,16,15,31
29328,0,4,3,15,22
29329,0,0,3,20,23
29330,0,0,2,17,19
29332,0,0,2,15,17
29333,0,1,14,28,43
29334,0,0,5,43,48
29335,0,0,1,6,7
29336,0,1,3,19,23
29337,0,0,3,12,15
29338,0,0,4,9,13
29339,0,0,4,5,9
29340,0,0,7,11,18
29342,0,0,9,14,23
29343,1,2,11,24,38
29344,0,1,4,8,13
29345,0,0,4,6,10
29346,0,1,2,10,13
29347,0,0,10,22,32
29348,0,0,19,14,33
29349,0,0,2,6,8
29350,1,0,5,19,25
29351,0,0,6,9,15
29352,0,0,4,7,11
29353,0,0,7,23,30
29354,0,0,5,5,10
29355,0,0,2,7,9
29356,0,0,5,3,8
29357,0,0,6,5,11
29358,0,0,3,24,27
29359,0,1,8,12,21
29360,0,0,4,2,6
29361,0,0,4,4,8
29362,0,0,9,5,14
29363,0,0,7,9,16
29364,0,0,2,1,3
29365,0,0,5,3,8
29366,0,0,3,14,17
29367,0,0,2,13,15
29368,0,1,9,8,18
29369,0,0,13,35,48
29370,0,1,8,11,20
29371,0,1,7,17,25
29372,0,4,2,15,21
29374,1,0,0,4,5
29375,0,0,7,11,18
29376,0,0,8,28,36
29377,1,0,3,15,19
29378,0,0,7,25,32
29379,0,0,5,6,11
29380,0,2,7,13,22
29381,0,0,6,4,10
29382,0,2,9,10,21
29383,0,0,6,14,20
29384,0,0,8,17,25
29385,1,1,8,12,22
29386,0,0,3,6,9
29387,0,0,4,21,25
29388,0,1,3,27,31
29389,0,2,7,15,24
29390,0,1,1,12,14
29391,0,0,4,14,18
29392,0,0,5,3,8
29393,0,0,6,5,11
29394,0,1,3,34,38
29395,0,1,5,7,13
29396,0,0,5,3,8
29397,0,1,2,13,16
29398,0,0,5,15,20
29399,0,0,3,4,7
29400,0,4,7,22,33
29401,0,0,7,8,15
29402,0,0,2,7,9
29403,0,0,4,7,11
29404,0,0,17,32,49
29405,0,0,1,8,9
29406,0,1,7,10,18
29407,0,0,2,8,10
29408,0,1,14,22,37
29409,1,0,6,11,18
29410,0,0,6,14,20
29411,0,0,3,2,5
29412,0,0,8,12,20
29413,0,0,3,2,5
29414,1,2,11,33,47
29415,0,0,5,7,12
29416,0,2,13,35,50
29417,0,0,2,6,8
29418,0,0,7,10,17
29419,0,0,2,11,13
29420,0,0,3,12,15
29422,0,1,11,27,39
29423,0,0,9,35,44
29424,0,0,9,11,20
29425,0,0,4,14,18
29426,0,0,9,18,27
29427,0,0,8,18,26
29428,0,0,10,7,17
29429,0,0,5,19,24
29430,2,0,5,9,16
29431,0,0,6,9,15
29432,0,0,1,10,11
29433,1,0,11,36,48
29434,0,0,11,9,20
29435,1,0,9,17,27
29436,0,0,3,40,43
29437,0,2,11,22,35
29438,0,0,6,2,8
29439,0,1,8,9,18
29440,0,0,8,7,15
29441,0,0,1,5,6
29442,0,0,8,4,12
29443,0,0,5,7,12
29444,1,0,11,30,42
29445,0,0,2,1,3
29446,0,0,5,15,20
29448,1,0,3,5,9
29449,2,0,7,30,39
29450,0,0,2,5,7
29452,0,0,6,3,9
29453,0,1,10,39,50
29454,0,2,12,36,50
29455,0,0,4,25,29
29456,0,0,3,10,13
29457,0,1,7,13,21
29458,0,1,13,25,39
29459,0,0,4,9,13
29460,0,0,3,9,12
29461,0,0,3,13,16
29462,0,0,11,23,34
29463,0,0,4,7,11
29464,0,0,5,8,13
29465,0,0,3,15,18
29466,0,0,11,19,30
29467,1,0,6,13,20
29468,0,0,5,7,12
29469,0,1,12,29,42
29470,0,1,2,26,29
29471,0,0,5,11,16
29472,0,1,4,19,24
29473,0,0,6,23,29
29474,1,0,2,4,7
29475,0,0,7,24,31
29476,0,0,7,6,13
29477,0,0,7,10,17
29478,0,0,10,32,42
29479,1,0,4,24,29
29480,0,0,3,4,7
29481,0,2,3,8,13
29482,0,1,7,11,19
29483,0,1,6,6,13
29484,1,1,3,34,39
29485,0,4,6,18,28
29486,0,0,5,17,22
29487,0,0,3,16,19
29488,0,0,12,18,30
29489,0,0,8,9,17
29490,0,1,8,20,29
29492,0,1,12,10,23
29493,0,0,0,5,5
29494,0,0,5,10,15
29495,0,1,7,28,36
29497,0,0,6,8,14
29498,0,0,6,20,26
29499,0,0,1,10,11
29500,0,0,0,1,1
29501,0,0,3,8,11
29503,0,0,2,6,8
29504,0,0,7,14,21
29505,0,0,5,13,18
29506,0,0,2,11,13
29507,0,2,1,7,10
29508,0,0,5,5,10
29509,0,1,6,21,28
29510,1,1,3,11,16
29511,1,0,6,8,15
29512,0,0,5,17,22
29513,0,1,1,15,17
29514,0,0,8,12,20
29515,0,0,6,14,20
29516,0,0,6,9,15
29517,0,0,12,14,26
29518,0,0,2,2,4
29519,0,0,9,19,28
29520,0,0,13,9,22
29521,0,3,3,6,12
29522,0,1,15,20,36
29523,0,0,9,7,16
29524,0,0,9,14,23
29525,0,2,8,8,18
29526,0,0,12,23,35
29527,0,0,8,19,27
29528,0,0,5,11,16
29529,0,0,5,6,11
29530,0,0,13,16,29
29531,0,3,3,24,30
29532,0,1,2,12,15
29533,0,0,0,22,22
29534,0,0,2,9,11
29535,1,0,9,20,30
29536,0,0,2,15,17
29537,0,0,6,10,16
29538,1,1,13,23,38
29539,1,0,8,29,38
29540,0,0,5,2,7
29541,0,1,3,45,49
29542,0,0,6,10,16
29543,0,0,8,4,12
29544,0,1,5,18,24
29545,0,0,0,1,1
29546,1,0,11,14,26
29547,0,1,1,9,11
29548,0,0,2,8,10
29549,0,0,7,12,19
29550,0,0,5,9,14
29551,0,0,4,23,27
29552,2,0,3,23,28
29553,0,0,7,12,19
29555,0,0,10,8,18
29556,0,2,9,15,26
29557,0,0,7,11,18
29558,0,1,5,20,26
29559,0,0,8,4,12
29560,0,0,3,13,16
29561,0,0,8,11,19
29562,0,0,5,3,8
29563,0,0,5,10,15
29564,1,0,11,24,36
29565,1,0,2,14,17
29566,0,0,8,10,18
29567,1,0,6,9,16
29568,1,0,4,12,17
29569,0,0,11,8,19
29570,0,0,5,8,13
29571,0,1,4,18,23
29572,1,0,7,39,47
29574,0,0,5,5,10
29575,1,1,5,13,20
29576,0,0,3,42,45
29577,1,1,21,24,47
29579,0,0,15,15,30
29580,0,0,8,11,19
29581,0,0,3,7,10
29582,0,0,5,7,12
29583,0,2,10,10,22
29584,0,2,11,28,41
29585,0,0,2,2,4
29586,0,0,2,4,6
29587,0,0,4,4,8
29588,0,0,7,8,15
29589,0,0,12,12,24
29590,0,0,4,7,11
29591,0,1,19,18,38
29592,1,0,7,29,37
29593,0,0,6,8,14
29594,0,0,3,10,13
29595,0,0,7,40,47
29596,0,0,0,27,27
29597,0,0,3,4,7
29599,0,0,9,12,21
29602,0,0,4,7,11
29603,0,0,9,12,21
29604,0,0,11,33,44
29605,1,0,9,27,37
29606,0,0,4,13,17
29607,2,1,3,9,15
29609,0,0,2,3,5
29610,0,1,13,18,32
29611,0,0,1,11,12
29612,0,0,7,15,22
29613,1,0,7,29,37
29614,0,0,2,4,6
29615,0,2,16,30,48
29616,0,1,3,15,19
29617,0,0,4,3,7
29618,0,1,5,30,36
29619,1,0,17,25,43
29620,0,0,7,5,12
29622,0,1,12,22,35
29623,0,0,11,17,28
29624,0,0,13,20,33
29625,0,1,4,25,30
29626,0,3,8,18,29
29627,1,1,6,17,25
29628,0,0,4,3,7
29630,0,1,7,27,35
29631,0,0,12,26,38
29633,0,0,6,15,21
29634,0,0,8,10,18
29635,1,2,13,34,50
29636,0,0,2,5,7
29637,0,0,13,32,45
29638,0,0,7,4,11
29639,0,0,7,5,12
29641,0,1,0,4,5
29642,0,0,7,6,13
29643,0,0,4,8,12
29644,0,0,11,10,21
29645,1,0,2,8,11
29646,0,0,9,7,16
29648,0,0,5,5,10
29649,0,0,11,19,30
29650,0,0,1,12,13
29651,0,0,2,11,13
29653,0,0,1,1,2
29654,0,1,5,17,23
29657,0,1,7,14,22
29658,0,0,2,4,6
29660,0,0,7,16,23
29661,0,0,10,16,26
29668,0,0,4,1,5
29672,0,0,0,7,7
29673,0,0,1,6,7
29674,0,1,11,25,37
29675,0,2,17,26,45
29676,0,0,1,9,10
29677,0,0,5,14,19
29678,0,0,7,21,28
29679,0,0,1,12,13
29680,0,0,8,11,19
29682,0,0,5,5,10
29683,0,0,4,15,19
29684,0,0,0,36,36
29685,0,0,4,4,8
29686,0,0,8,15,23
29687,1,0,12,28,41
29688,0,3,19,22,44
29689,1,1,5,18,25
29690,1,1,15,33,50
29691,0,0,3,6,9
29692,0,0,3,2,5
29693,0,0,4,9,13
29694,0,2,15,33,50
29695,0,0,17,27,44
29696,0,0,2,15,17
29697,0,2,0,11,13
29698,0,1,12,37,50
29699,1,2,5,34,42
29700,0,0,5,13,18
29701,0,0,7,8,15
29702,0,0,7,19,26
29703,0,0,6,20,26
29704,0,1,4,29,34
29705,0,0,3,6,9
29706,2,0,2,12,16
29707,0,0,3,8,11
29708,0,1,8,15,24
29709,0,1,0,4,5
29710,0,0,4,2,6
29711,0,0,4,7,11
29712,0,0,4,5,9
29713,0,0,4,9,13
29714,2,0,1,16,19
29715,1,0,5,10,16
29716,1,0,2,14,17
29717,0,1,2,17,20
29718,1,1,6,12,20
29719,0,1,11,27,39
29720,1,0,10,38,49
29721,0,0,13,31,44
29722,0,3,4,18,25
29723,0,0,2,13,15
29724,0,1,7,16,24
29725,0,0,0,12,12
29726,0,0,8,22,30
29727,0,0,2,15,17
29728,0,1,2,27,30
29729,0,1,13,10,24
29730,0,1,13,36,50
29731,0,0,4,10,14
29732,0,0,5,16,21
29733,0,0,15,11,26
29734,0,1,2,6,9
29735,0,0,4,22,26
29736,0,1,6,43,50
29737,0,1,6,12,19
29738,1,0,12,37,50
29739,0,0,14,29,43
29740,0,0,3,11,14
29741,0,2,17,26,45
29742,1,2,16,19,38
29743,0,0,7,13,20
29744,0,0,16,34,50
29745,0,2,15,23,40
29746,0,0,11,26,37
29747,0,0,5,45,50
29748,0,1,3,18,22
29749,0,0,12,10,22
29750,0,0,8,5,13
29751,0,0,0,7,7
29752,0,0,7,7,14
29753,0,0,10,32,42
29754,0,1,13,33,47
29755,0,0,7,14,21
29756,0,0,4,17,21
29757,0,0,7,43,50
29758,1,0,10,27,38
29759,0,0,6,44,50
29760,0,0,17,26,43
29761,0,0,8,14,22
29762,2,0,5,13,20
29763,0,1,10,13,24
29764,0,0,9,39,48
29765,0,0,0,7,7
29766,0,0,6,0,6
29767,0,0,20,30,50
29768,0,0,20,29,49
29769,0,0,4,15,19
29770,0,0,3,4,7
29771,0,0,8,18,26
29772,0,1,7,31,39
29773,0,0,14,22,36
29774,0,0,2,9,11
29775,0,1,3,7,11
29776,0,2,5,21,28
29777,0,0,15,33,48
29778,0,0,3,22,25
29779,1,0,14,35,50
29780,0,0,1,9,10
29781,1,1,13,22,37
29782,2,1,7,40,50
29783,0,0,8,9,17
29784,0,1,4,13,18
29785,0,0,13,28,41
29786,0,0,13,32,45
29787,0,0,3,15,18
29788,0,0,1,12,13
29789,0,5,5,30,40
29790,0,0,9,14,23
29791,0,1,2,8,11
29792,1,0,15,34,50
29793,0,0,6,21,27
29795,1,0,5,8,14
29796,0,0,8,22,30
29797,0,0,9,10,19
29798,0,0,11,21,32
29799,1,1,10,18,30
29800,0,0,5,21,26
29801,0,0,8,10,18
29802,0,0,9,38,47
29803,0,0,3,6,9
29804,0,0,6,10,16
29805,0,3,1,9,13
29806,0,2,7,38,47
29807,0,1,12,19,32
29808,0,2,16,32,50
29809,1,0,16,20,37
29810,0,0,6,7,13
29811,0,0,17,33,50
29812,1,0,12,28,41
29813,0,1,5,6,12
29815,0,1,9,16,26
29816,0,0,4,19,23
29817,0,0,14,33,47
29818,0,0,13,27,40
29819,1,0,19,18,38
29820,0,0,5,7,12
29821,0,0,10,40,50
29822,0,0,5,9,14
29823,0,0,2,4,6
29825,0,1,14,24,39
29826,0,0,20,29,49
29827,0,0,6,22,28
29828,0,0,7,9,16
29829,0,1,5,14,20
29830,0,0,6,15,21
29831,0,0,4,15,19
29832,0,0,5,9,14
29833,0,1,5,22,28
29834,0,1,4,2,7
29835,1,0,12,32,45
29836,0,0,12,22,34
29837,0,0,9,6,15
29838,0,1,1,16,18
29839,1,0,0,12,13
29840,0,0,4,14,18
29841,0,0,5,5,10
29842,0,0,7,26,33
29843,0,0,9,14,23
29844,0,1,12,37,50
29845,0,0,8,11,19
29846,0,0,1,9,10
29848,0,0,12,22,34
29849,0,2,9,27,38
29850,0,0,10,15,25
29851,0,0,9,16,25
29852,0,0,9,6,15
29853,0,0,3,2,5
29854,0,0,16,34,50
29856,0,0,11,25,36
29857,0,0,15,23,38
29858,1,0,12,34,47
29859,0,0,8,9,17
29860,3,1,1,25,30
29861,1,0,8,32,41
29862,0,0,11,12,23
29863,0,0,6,12,18
29864,0,0,4,13,17
29865,0,0,11,30,41
29866,0,0,5,12,17
29867,0,0,18,16,34
29868,0,0,0,5,5
29869,0,2,9,39,50
29870,0,0,9,19,28
29872,1,0,9,38,48
29873,0,0,15,32,47
29874,0,0,7,32,39
29875,0,0,9,19,28
29876,0,1,9,23,33
29877,0,0,9,26,35
29878,0,0,8,1,9
29879,0,0,12,21,33
29880,2,0,3,19,24
29881,0,0,14,35,49
29882,0,0,4,11,15
29885,0,0,7,22,29
29886,0,1,0,11,12
29887,0,0,13,6,19
29888,0,0,9,9,18
29889,0,0,12,18,30
29890,0,0,9,27,36
29891,0,1,10,20,31
29892,0,1,6,11,18
29893,0,0,13,31,44
29894,0,0,2,6,8
29895,0,0,4,11,15
29896,0,0,0,2,2
29897,0,0,8,7,15
29898,0,0,10,5,15
29899,1,0,15,33,49
29900,1,1,4,15,21
29901,1,0,2,11,14
29902,0,1,8,19,28
29903,0,0,8,15,23
29904,0,0,9,37,46
29905,1,1,9,24,35
29906,0,0,5,20,25
29907,0,1,10,31,42
29908,0,0,10,23,33
29909,0,1,12,31,44
29911,0,0,12,29,41
29912,1,0,10,38,49
29913,0,0,0,5,5
29914,1,1,5,11,18
29915,0,1,3,15,19
29916,0,0,5,7,12
29917,0,1,1,33,35
29918,0,0,6,33,39
29919,0,0,15,29,44
29920,0,0,4,4,8
29921,1,0,4,12,17
29922,0,1,5,18,24
29923,0,0,1,16,17
29924,0,0,4,10,14
29925,0,0,2,11,13
29926,0,1,2,1,4
29927,0,0,11,26,37
29928,0,0,17,28,45
29929,0,0,14,25,39
29930,1,0,6,30,37
29931,0,0,1,4,5
29932,1,0,1,9,11
29933,0,0,4,7,11
29934,0,0,8,13,21
29935,0,0,3,18,21
29936,0,1,15,28,44
29937,0,0,9,8,17
29938,0,0,8,32,40
29939,0,1,14,33,48
29940,0,0,6,9,15
29941,0,2,2,12,16
29942,0,0,4,8,12
29943,0,0,8,22,30
29944,0,0,13,28,41
29945,0,0,4,3,7
29946,1,0,10,15,26
29947,0,0,0,27,27
29948,0,2,9,17,28
29949,5,1,8,36,50
29950,0,0,2,7,9
29951,1,0,15,16,32
29952,0,0,6,13,19
29953,0,0,2,17,19
29954,0,0,7,19,26
29955,1,0,4,16,21
29956,0,0,18,32,50
29957,0,0,0,8,8
29958,1,0,9,40,50
29959,0,0,2,3,5
29960,1,0,4,2,7
29961,0,0,2,13,15
29962,0,1,1,6,8
29963,2,0,2,12,16
29964,0,1,11,18,30
29965,0,0,1,6,7
29966,0,1,8,21,30
29967,1,0,21,26,48
29968,1,0,4,4,9
29969,0,3,10,16,29
29970,1,1,7,35,44
29972,0,0,15,27,42
29973,0,1,18,23,42
29974,0,1,3,11,15
29975,0,0,1,5,6
29976,0,0,6,13,19
29977,0,0,0,9,9
29978,0,0,1,7,8
29979,2,2,16,25,45
29980,0,0,7,21,28
29982,0,0,4,1,5
29983,0,1,4,40,45
29984,0,0,8,11,19
29985,0,0,4,7,11
29986,0,0,4,8,12
29987,0,0,0,36,36
29988,0,0,5,14,19
29989,0,0,4,4,8
29990,0,0,2,3,5
29991,0,3,10,19,32
29992,0,1,3,20,24
29993,0,0,1,8,9
29995,0,0,3,2,5
29996,0,1,9,40,50
29997,0,0,0,1,1
29998,0,0,4,9,13
29999,0,0,15,35,50
30000,1,1,15,33,50
30001,0,2,0,11,13
30002,0,0,2,15,17
30003,0,1,5,28,34
30004,0,1,2,26,29
30005,0,0,10,16,26
30006,0,0,4,9,13
30007,0,1,4,25,30
30008,0,1,5,30,36
30009,0,0,7,40,47
30010,0,0,4,7,11
30011,2,0,1,16,19
30012,1,0,2,8,11
30013,0,1,4,29,34
30014,0,1,1,9,11
30015,0,0,4,5,9
30016,1,1,9,39,50
30017,0,1,12,37,50
30018,0,1,2,16,19
30020,0,0,10,31,41
30021,0,0,13,31,44
30022,0,0,7,43,50
30023,0,0,5,45,50
30024,0,0,4,22,26
30025,2,2,3,11,18
30026,0,0,11,17,28
30027,0,1,0,18,19
30028,0,1,8,41,50
30029,0,0,2,16,18
30030,0,0,10,15,25
30031,0,1,5,20,26
30032,0,0,12,22,34
30033,0,0,9,19,28
30035,0,0,3,11,14
30036,0,0,4,22,26
30037,1,2,13,33,49
30038,0,0,2,26,28
30039,0,1,15,33,49
30040,0,0,9,16,25
30041,2,0,6,15,23
30042,0,0,4,11,15
30044,1,0,7,35,43
30045,0,0,18,16,34
30046,0,1,12,37,50
30047,3,1,1,19,24
30048,0,0,13,6,19
30049,0,0,12,20,32
30050,0,1,8,19,28
30051,1,0,1,16,18
30052,0,0,0,10,10
30053,2,0,3,19,24
30054,0,1,10,20,31
30056,0,1,10,21,32
30057,2,0,8,40,50
30058,0,1,13,32,46
30059,1,1,9,24,35
30060,0,1,5,28,34
30061,0,0,6,33,39
30062,1,0,18,31,50
30063,0,0,9,15,24
30064,0,0,9,14,23
30065,0,0,6,10,16
30066,4,0,9,37,50
30067,1,0,6,17,24
30068,0,0,8,11,19
30069,0,1,1,9,11
30070,0,0,7,6,13
30071,7,0,1,34,42
30072,0,1,7,31,39
30073,0,2,7,29,38
30074,0,0,2,19,21
30075,0,1,12,19,32
30076,0,1,2,17,20
30077,0,1,1,16,18
30078,0,0,5,45,50
30079,0,0,0,15,15
30080,0,0,13,31,44
30081,0,0,2,26,28
30082,0,0,16,34,50
30083,0,0,8,12,20
30084,0,0,14,32,46
30085,2,1,0,9,12
30086,1,2,7,22,32
30087,0,0,2,31,33
30088,1,1,7,36,45
30089,3,2,2,23,30
30090,0,1,8,41,50
30091,0,1,5,28,34
30092,0,1,11,18,30
30093,0,0,15,35,50
30094,0,1,4,40,45
30095,0,0,6,13,19
30097,0,1,1,9,11
30098,0,0,8,12,20
30099,0,0,2,15,17
30100,0,1,7,16,24
30101,0,1,7,26,34
30102,2,0,1,16,19
30104,0,1,10,31,42
30105,0,1,1,9,11
30106,2,2,16,25,45
30107,0,2,15,33,50
30108,0,0,15,32,47
30109,2,2,16,25,45
30110,4,2,1,35,42
30111,4,0,9,37,50
30112,0,2,17,26,45
30113,0,2,0,11,13
30114,4,2,1,35,42
30115,0,3,10,19,32
30116,2,2,16,25,45
30117,0,0,10,12,22
30118,0,1,2,26,29
30119,0,0,4,9,13
30120,0,3,12,29,44
30121,0,0,2,6,8
30122,0,1,3,20,24
30123,0,0,1,11,12
30124,0,1,6,12,19
30125,0,0,6,20,26
30126,0,0,4,11,15
30127,0,0,2,14,16
30128,0,0,1,16,17
30130,0,1,9,4,14
30132,0,0,5,12,17
30133,0,0,13,22,35
30134,0,1,0,0,1
30135,1,2,9,38,50
30136,0,1,2,18,21
30137,0,0,2,10,12
30138,0,0,1,10,11
30140,0,0,3,11,14
30141,0,0,3,2,5
30142,0,0,5,15,20
30143,0,1,0,3,4
30144,0,0,0,5,5
30145,0,0,4,16,20
30146,0,1,7,6,14
30147,0,1,4,14,19
30148,0,0,2,9,11
30149,1,2,13,32,48
30150,0,0,6,16,22
30151,0,0,4,1,5
30153,0,1,4,20,25
30154,0,3,3,39,45
30155,0,0,4,16,20
30156,0,1,2,17,20
30157,0,0,1,6,7
30158,0,0,2,15,17
30159,0,0,1,9,10
30160,0,0,14,7,21
30161,0,0,5,5,10
30162,0,0,3,19,22
30163,0,0,3,8,11
30164,0,0,3,0,3
30165,0,0,14,26,40
30166,0,1,5,41,47
30167,0,0,2,10,12
30168,1,0,1,4,6
30169,0,0,14,31,45
30171,0,0,2,27,29
30173,0,0,3,10,13
30174,0,0,6,20,26
30175,0,0,3,11,14
30176,0,0,6,8,14
30177,0,2,3,16,21
30178,0,0,7,8,15
30179,0,0,7,4,11
30180,0,2,6,21,29
30181,0,0,3,17,20
30182,0,0,1,5,6
30183,0,1,5,10,16
30184,0,2,9,35,46
30185,0,0,5,9,14
30186,0,0,5,15,20
30187,0,0,7,9,16
30188,0,0,5,19,24
30189,0,0,3,4,7
30190,0,0,3,17,20
30191,0,0,3,7,10
30193,0,1,11,20,32
30194,0,0,2,12,14
30195,0,0,2,11,13
30196,1,0,8,20,29
30197,1,2,9,19,31
30198,0,0,2,8,10
30199,0,0,8,14,22
30200,0,1,12,26,39
30201,0,0,6,4,10
30202,0,0,12,10,22
30203,0,0,5,9,14
30204,0,0,4,6,10
30205,0,0,6,12,18
30206,0,1,3,11,15
30207,0,0,3,15,18
30208,0,0,3,7,10
30209,0,0,3,0,3
30211,0,0,2,3,5
30212,0,0,7,12,19
30213,0,0,3,9,12
30214,0,0,6,2,8
30215,0,2,4,17,23
30216,0,1,5,20,26
30217,0,0,7,12,19
30218,0,0,6,3,9
30220,0,1,9,6,16
30221,0,0,4,9,13
30222,0,0,7,26,33
30223,0,5,5,38,48
30224,0,0,0,6,6
30225,0,1,7,41,49
30226,0,2,2,20,24
30227,0,1,2,14,17
30228,0,0,13,37,50
30229,0,0,9,8,17
30230,1,0,10,39,50
30231,0,6,4,13,23
30233,1,3,2,24,30
30234,0,0,7,9,16
30235,0,0,0,12,12
30236,0,0,9,38,47
30237,0,0,3,8,11
30238,0,0,10,8,18
30239,0,1,1,7,9
30240,0,0,4,12,16
30241,0,0,2,3,5
30242,1,0,5,7,13
30243,0,0,2,15,17
30245,0,1,8,28,37
30246,0,0,4,7,11
30247,0,1,4,26,31
30248,1,0,2,7,10
30249,0,1,3,4,8
30250,0,0,3,21,24
30251,0,1,4,3,8
30252,0,0,6,3,9
30253,0,0,3,8,11
30254,0,1,12,24,37
30255,0,3,2,11,16
30256,0,0,4,8,12
30257,0,0,8,18,26
30258,0,1,14,30,45
30259,0,0,6,15,21
30260,0,0,2,6,8
30261,0,0,2,4,6
30263,0,0,3,2,5
30264,0,0,3,2,5
30265,0,0,4,1,5
30266,0,0,0,2,2
30267,0,2,0,11,13
30268,0,1,5,12,18
30269,0,0,9,10,19
30270,0,0,1,8,9
30271,0,0,7,2,9
30272,0,0,8,35,43
30273,0,0,18,19,37
30274,0,1,6,10,17
30275,0,2,5,15,22
30276,0,0,4,7,11
30277,0,0,2,2,4
30278,0,1,1,3,5
30279,0,1,3,23,27
30280,0,0,6,10,16
30281,0,1,6,3,10
30282,0,0,1,4,5
30283,0,0,4,18,22
30284,0,0,8,10,18
30285,0,2,11,18,31
30286,0,0,1,9,10
30287,0,0,5,0,5
30288,0,0,1,12,13
30289,0,0,3,15,18
30290,0,1,11,28,40
30291,0,2,3,6,11
30293,0,0,3,5,8
30294,0,0,6,18,24
30295,0,0,7,22,29
30296,0,0,4,9,13
30297,0,0,10,11,21
30298,0,0,1,7,8
30299,0,0,4,4,8
30300,0,0,10,10,20
30301,1,0,5,5,11
30303,1,0,7,25,33
30304,2,0,7,25,34
30305,0,2,12,36,50
30306,0,0,2,19,21
30307,0,1,5,37,43
30308,0,0,6,18,24
30309,0,0,10,21,31
30310,1,0,5,16,22
30311,0,0,4,1,5
30312,0,1,3,14,18
30313,0,0,7,25,32
30314,0,0,1,8,9
30315,0,1,7,27,35
30316,0,0,6,19,25
30317,0,0,2,0,2
30318,0,0,1,19,20
30319,1,1,7,9,18
30320,0,1,1,11,13
30321,0,0,1,1,2
30322,0,0,4,3,7
30323,0,1,3,9,13
30325,0,1,6,7,14
30326,0,0,9,4,13
30327,0,1,14,20,35
30328,0,0,17,27,44
30329,0,0,6,5,11
30330,0,1,0,6,7
30331,0,0,9,23,32
30332,0,0,1,4,5
30333,0,0,7,10,17
30334,0,0,4,6,10
30335,0,0,7,24,31
30336,0,0,3,18,21
30337,0,1,4,24,29
30338,0,0,3,2,5
30339,0,1,5,14,20
30340,0,0,6,12,18
30341,0,0,4,9,13
30342,0,0,6,5,11
30343,0,0,11,9,20
30344,0,0,4,2,6
30345,0,0,13,17,30
30346,0,0,2,8,10
30347,0,3,0,3,6
30348,0,0,10,8,18
30349,0,0,0,4,4
30351,0,0,2,6,8
30352,0,0,7,10,17
30353,0,0,4,4,8
30354,0,1,3,6,10
30355,0,0,7,6,13
30356,0,0,0,5,5
30357,0,0,2,17,19
30358,0,0,3,8,11
30360,0,0,1,10,11
30362,0,0,3,6,9
30363,1,0,5,26,32
30364,0,0,5,9,14
30365,0,0,2,5,7
30366,0,2,3,28,33
30367,0,1,3,22,26
30368,0,0,6,25,31
30369,0,1,14,8,23
30370,0,0,1,9,10
30371,0,0,4,12,16
30372,0,1,6,21,28
30373,0,0,1,8,9
30375,0,0,12,16,28
30376,0,0,5,10,15
30377,0,1,9,26,36
30378,0,1,10,24,35
30379,0,0,9,10,19
30380,0,1,4,10,15
30382,0,0,3,3,6
30383,0,1,5,5,11
30384,1,0,9,25,35
30385,0,0,7,22,29
30386,0,2,19,28,49
30387,0,2,1,19,22
30388,0,0,3,6,9
30389,0,0,1,3,4
30390,0,0,2,5,7
30391,0,1,4,11,16
30392,0,0,6,6,12
30393,0,1,18,25,44
30395,0,0,6,4,10
30396,0,0,0,5,5
30397,0,1,1,11,13
30398,0,1,4,10,15
30399,0,0,7,8,15
30400,0,0,4,3,7
30401,0,0,2,5,7
30402,0,0,0,5,5
30403,0,0,4,28,32
30404,0,0,4,3,7
30405,0,0,4,14,18
30406,0,0,2,7,9
30407,0,0,5,4,9
30408,0,0,5,8,13
30409,1,0,5,31,37
30410,0,0,4,13,17
30412,0,0,7,9,16
30413,0,1,4,5,10
30414,1,0,5,9,15
30416,0,0,6,9,15
30417,0,0,2,8,10
30418,0,1,7,23,31
30419,0,1,3,11,15
30420,0,0,1,4,5
30421,0,0,3,6,9
30423,0,0,8,7,15
30424,0,0,1,5,6
30425,0,0,12,7,19
30426,0,5,2,21,28
30427,0,0,1,7,8
30428,0,1,17,30,48
30429,0,0,2,25,27
30430,0,0,0,5,5
30431,1,0,6,32,39
30432,0,0,6,18,24
30433,0,0,5,14,19
30434,0,0,12,13,25
30435,0,0,6,7,13
30436,0,0,0,26,26
30437,1,7,2,13,23
30438,0,0,4,14,18
30439,0,2,2,17,21
30440,0,0,5,13,18
30441,0,0,2,8,10
30442,0,2,2,3,7
30443,0,0,7,17,24
30444,0,0,8,8,16
30445,0,0,0,12,12
30446,0,0,1,10,11
30447,0,0,2,6,8
30448,0,0,8,13,21
30449,1,0,12,37,50
30451,0,0,1,9,10
30452,0,0,1,0,1
30455,0,0,4,13,17
30457,0,0,3,6,9
30458,0,0,3,11,14
30459,0,0,5,11,16
30460,0,0,4,15,19
30461,0,0,3,11,14
30464,0,0,2,34,36
30465,0,0,3,4,7
30466,0,0,0,9,9
30467,0,1,1,11,13
30469,0,0,7,16,23
30470,0,3,12,29,44
30471,0,0,4,8,12
30473,1,0,4,29,34
30474,0,0,12,27,39
30475,0,0,11,32,43
30476,0,0,6,26,32
30477,0,1,4,29,34
30478,0,0,2,34,36
30479,0,0,12,32,44
30480,0,0,0,9,9
30481,0,0,3,19,22
30482,0,0,1,24,25
30483,0,0,10,18,28
30484,0,0,3,10,13
30485,0,0,0,5,5
30486,0,0,17,30,47
30487,0,0,4,27,31
30488,0,2,8,16,26
30489,0,0,5,13,18
30490,0,0,0,9,9
30491,1,0,11,35,47
30492,0,1,1,9,11
30493,0,0,5,20,25
30494,3,0,12,35,50
30495,0,1,12,28,41
30496,0,0,9,41,50
30497,1,0,2,19,22
30498,0,0,14,36,50
30499,0,0,7,10,17
30502,0,1,4,14,19
30503,0,0,1,9,10
30504,0,0,1,17,18
30505,0,0,0,5,5
30506,0,0,8,10,18
30507,0,0,6,25,31
30508,0,1,7,11,19
30509,0,0,20,27,47
30510,0,1,0,11,12
30511,0,0,3,13,16
30512,0,0,16,27,43
30513,0,0,7,8,15
30514,1,0,0,2,3
30516,0,0,9,15,24
30517,0,0,9,21,30
30518,0,0,6,5,11
30519,0,1,5,4,10
30520,0,0,9,40,49
30521,0,0,5,6,11
30522,0,0,1,8,9
30523,0,0,5,18,23
30525,0,1,18,28,47
30526,0,0,3,41,44
30527,0,0,8,24,32
30528,0,0,9,9,18
30529,1,0,5,25,31
30530,0,0,3,17,20
30531,0,0,5,13,18
30532,0,0,7,16,23
30533,0,1,14,26,41
30534,0,0,2,7,9
30535,0,1,12,22,35
30536,0,0,8,10,18
30537,0,0,17,30,47
30538,0,0,7,2,9
30539,0,0,4,8,12
30540,0,0,6,9,15
30541,1,0,0,5,6
30542,0,0,7,8,15
30543,1,0,14,35,50
30544,0,0,5,3,8
30545,1,0,8,20,29
30546,0,0,11,37,48
30547,0,0,2,9,11
30548,2,0,9,8,19
30549,0,0,3,6,9
30550,0,0,2,12,14
30551,0,0,1,8,9
30552,0,2,3,8,13
30553,0,1,9,6,16
30554,0,0,3,7,10
30555,0,0,3,3,6
30556,0,1,3,20,24
30557,0,1,2,9,12
30558,0,2,13,28,43
30559,0,0,3,34,37
30560,1,0,7,19,27
30561,0,0,5,6,11
30562,0,1,1,3,5
30563,0,2,1,18,21
30564,1,0,3,6,10
30565,0,0,9,15,24
30566,1,0,16,33,50
30567,0,1,3,11,15
30568,0,2,4,19,25
30569,0,0,1,8,9
30570,0,0,2,9,11
30571,0,1,2,11,14
30572,0,0,5,6,11
30573,0,1,14,35,50
30574,0,1,6,12,19
30575,0,0,14,28,42
30576,0,0,3,13,16
30577,0,0,2,9,11
30578,0,0,15,35,50
30579,0,0,9,20,29
30580,0,0,4,7,11
30581,1,5,6,34,46
30582,0,0,9,17,26
30583,0,0,3,11,14
30584,1,0,9,40,50
30585,1,3,13,33,50
30586,0,0,9,41,50
30587,1,0,3,13,17
30588,0,0,6,17,23
30589,1,1,6,21,29
30590,0,0,5,6,11
30591,1,0,8,17,26
30592,0,0,9,11,20
30593,0,0,7,15,22
30594,0,0,6,13,19
30595,0,0,7,23,30
30596,0,0,2,15,17
30597,0,0,4,7,11
30598,0,0,10,15,25
30599,0,0,1,4,5
30600,0,1,3,14,18
30601,0,0,6,1,7
30602,0,0,11,24,35
30603,1,0,10,15,26
30605,0,0,3,24,27
30606,0,1,10,33,44
30607,0,2,3,5,10
30608,0,1,6,16,23
30609,0,2,3,27,32
30610,0,0,1,2,3
30611,0,0,0,5,5
30612,0,0,0,1,1
30613,0,0,5,45,50
30614,0,0,0,17,17
30615,4,0,4,24,32
30616,0,0,5,11,16
30617,1,0,10,39,50
30618,0,0,12,29,41
30619,0,0,9,5,14
30620,0,0,1,15,16
30621,0,1,10,24,35
30622,0,0,5,4,9
30624,0,0,9,22,31
30625,0,0,1,8,9
30626,0,0,7,22,29
30627,0,1,3,12,16
30628,0,1,3,9,13
30629,0,0,2,6,8
30630,1,0,5,26,32
30631,1,0,4,16,21
30632,0,0,8,18,26
30633,0,0,1,15,16
30634,0,0,2,11,13
30635,0,0,6,19,25
30636,0,0,0,11,11
30637,0,1,18,10,29
30638,0,0,0,13,13
30639,0,0,10,36,46
30640,0,0,3,8,11
30641,0,0,6,17,23
30644,0,1,16,28,45
30645,0,0,9,19,28
30646,1,0,2,8,11
30647,0,0,9,13,22
30649,0,0,2,12,14
30650,0,0,9,17,26
30651,0,1,2,6,9
30652,0,0,5,12,17
30653,0,0,16,34,50
30654,0,1,0,9,10
30655,0,0,8,15,23
30656,1,0,16,33,50
30657,0,5,2,21,28
30658,0,1,1,11,13
30659,1,7,2,13,23
30660,0,0,8,22,30
30661,1,0,6,10,17
30662,0,0,9,17,26
30663,0,0,6,16,22
30664,0,0,0,5,5
30665,1,0,3,11,15
30666,0,1,3,15,19
30667,0,1,5,34,40
30670,0,0,1,11,12
30672,0,0,16,33,49
30673,0,0,2,15,17
30674,1,0,12,37,50
30675,0,1,3,14,18
30676,0,0,0,1,1
30678,1,5,6,34,46
30679,1,0,3,13,17
30680,0,0,8,15,23
30681,0,0,4,22,26
30682,1,0,4,16,21
30683,0,0,10,36,46
30684,0,0,2,11,13
30685,0,0,1,15,16
30686,0,0,5,18,23
30687,0,0,10,22,32
30688,0,0,1,8,9
30689,0,0,1,15,16
30690,0,0,6,13,19
30691,0,0,2,19,21
30692,0,3,12,29,44
30693,0,1,2,29,32
30694,0,0,8,9,17
30695,0,0,3,31,34
30696,1,0,8,22,31
30697,0,1,2,27,30
30698,0,0,1,5,6
30699,0,0,3,39,42
30700,1,0,6,24,31
30701,0,0,6,20,26
30702,0,0,14,17,31
30703,0,1,10,33,44
30704,0,1,7,25,33
30705,0,1,0,9,10
30706,0,0,4,4,8
30707,0,0,1,8,9
30708,0,0,2,9,11
30709,0,3,1,13,17
30710,0,1,3,11,15
30711,0,1,0,9,10
30712,1,0,16,33,50
30713,0,0,1,8,9
30714,0,0,3,13,16
30715,1,0,16,33,50
30716,0,0,7,10,17
30717,0,3,12,29,44
30718,0,0,3,13,16
30719,2,0,9,8,19
30720,0,1,1,11,13
30721,0,1,0,9,10
30722,1,0,10,39,50
30723,1,0,16,33,50
30724,0,0,7,10,17
30725,0,0,6,6,12
30726,0,0,5,6,11
30727,0,0,2,12,14
30728,1,0,3,12,16
30729,0,0,5,4,9
30730,0,0,8,11,19
30731,0,0,6,11,17
30732,0,0,4,0,4
30734,0,0,1,6,7
30735,0,0,0,5,5
30736,0,0,3,4,7
30737,0,0,6,20,26
30738,0,0,6,1,7
30739,0,1,11,25,37
30740,0,0,3,6,9
30741,0,0,4,6,10
30742,1,1,4,28,34
30743,0,1,11,27,39
30744,0,0,1,18,19
30745,0,1,4,11,16
30746,0,0,2,37,39
30747,0,0,9,20,29
30748,0,0,1,12,13
30749,0,0,8,15,23
30750,0,1,9,38,48
30751,1,0,8,14,23
30752,0,0,4,4,8
30754,0,0,14,21,35
30755,0,1,5,44,50
30756,0,2,4,27,33
30757,0,0,3,17,20
30758,0,0,15,21,36
30759,0,0,6,11,17
30760,0,0,7,7,14
30761,0,0,13,13,26
30763,0,1,6,14,21
30764,0,0,5,30,35
30765,0,0,6,13,19
30766,2,2,1,30,35
30767,0,0,2,15,17
30768,0,2,3,45,50
30769,0,0,3,21,24
30770,0,2,15,23,40
30771,0,0,1,5,6
30773,0,1,3,14,18
30774,0,0,1,5,6
30775,0,1,5,15,21
30776,0,0,14,29,43
30777,0,2,5,20,27
30778,0,0,2,12,14
30779,0,0,2,17,19
30780,0,0,7,9,16
30781,0,0,3,6,9
30782,1,0,11,18,30
30783,0,0,1,6,7
30784,0,0,9,6,15
30785,0,0,7,7,14
30786,0,0,11,28,39
30788,0,0,6,16,22
30789,0,0,2,8,10
30790,0,3,6,16,25
30791,0,0,0,12,12
30792,0,2,12,30,44
30793,0,1,3,20,24
30794,0,1,6,14,21
30795,0,1,3,12,16
30796,0,2,9,37,48
30797,0,0,17,11,28
30798,1,0,0,5,6
30799,1,2,3,37,43
30800,0,0,5,13,18
30801,0,0,6,5,11
30802,1,0,0,14,15
30803,0,0,5,22,27
30804,1,0,3,7,11
30805,0,0,9,15,24
30806,0,1,7,41,49
30807,1,0,8,33,42
30808,0,1,7,11,19
30809,1,0,3,36,40
30810,0,0,5,1,6
30811,0,0,10,18,28
30812,1,0,6,15,22
30813,0,0,4,20,24
30814,0,0,5,12,17
30815,0,0,10,17,27
30816,1,0,4,10,15
30817,0,1,0,9,10
30818,0,0,4,11,15
30819,0,1,11,25,37
30820,0,0,0,17,17
30821,0,1,5,37,43
30822,0,1,10,14,25
30823,0,1,6,22,29
30824,1,0,10,35,46
30825,0,0,7,10,17
30826,0,0,6,38,44
30827,0,0,14,14,28
30828,0,0,7,25,32
30829,0,0,1,7,8
30830,0,0,2,29,31
30831,0,0,7,16,23
30832,0,0,3,10,13
30833,0,0,3,7,10
30834,0,0,4,22,26
30835,1,2,7,34,44
30836,0,0,12,31,43
30837,0,0,2,6,8
30838,0,0,5,10,15
30839,0,1,3,7,11
30840,0,0,6,10,16
30841,0,0,5,19,24
30842,1,1,3,31,36
30843,0,1,1,25,27
30844,0,0,6,9,15
30845,0,0,4,3,7
30846,0,0,8,29,37
30848,0,0,9,11,20
30849,0,0,6,5,11
30850,0,1,2,20,23
30852,0,0,4,19,23
30853,0,0,5,14,19
30854,0,0,2,7,9
30855,0,0,0,4,4
30856,0,4,8,9,21
30857,0,0,8,13,21
30858,1,0,2,11,14
30859,0,1,4,18,23
30860,0,0,8,9,17
30861,0,0,7,16,23
30863,1,0,8,41,50
30864,0,0,2,8,10
30865,0,0,8,10,18
30866,0,0,11,16,27
30867,0,0,8,10,18
30868,0,0,5,14,19
30869,0,1,6,13,20
30870,0,0,11,28,39
30871,0,1,3,16,20
30872,0,1,11,26,38
30873,2,5,4,39,50
30874,0,0,0,5,5
30875,0,1,6,39,46
30876,1,0,5,44,50
30877,0,0,9,34,43
30878,0,1,1,9,11
30879,0,0,1,17,18
30880,0,1,20,29,50
30881,0,1,5,27,33
30882,0,0,1,7,8
30883,0,0,9,10,19
30884,0,0,1,5,6
30885,0,0,12,12,24
30886,0,2,6,14,22
30887,0,0,10,21,31
30888,0,0,12,29,41
30889,0,0,2,3,5
30891,0,1,3,24,28
30892,0,0,10,40,50
30893,0,1,8,17,26
30894,0,0,4,9,13
30895,0,0,12,24,36
30896,0,0,5,10,15
30897,0,1,6,22,29
30898,1,0,0,7,8
30899,0,3,10,29,42
30900,0,0,5,5,10
30901,1,1,8,21,31
30902,0,0,6,4,10
30903,0,0,5,15,20
30904,1,0,10,39,50
30905,0,0,2,7,9
30906,0,0,2,1,3
30907,0,0,3,2,5
30908,0,0,6,23,29
30909,0,0,4,1,5
30910,1,0,6,12,19
30911,0,0,6,21,27
30912,0,0,2,3,5
30913,0,0,7,7,14
30914,0,0,2,4,6
30915,2,1,4,9,16
30916,0,1,10,21,32
30917,0,0,6,12,18
30918,0,0,7,14,21
30919,0,0,10,10,20
30921,0,0,14,35,49
30922,0,0,2,3,5
30923,0,0,3,15,18
30924,0,0,2,2,4
30925,1,0,6,14,21
30926,1,0,12,15,28
30927,0,0,11,33,44
30928,0,0,9,15,24
30929,0,0,6,25,31
30930,0,1,6,18,25
30931,1,2,6,34,43
30932,0,0,9,21,30
30934,0,1,5,25,31
30935,0,0,5,8,13
30936,2,2,4,18,26
30937,0,0,1,5,6
30938,0,0,11,17,28
30939,0,1,7,9,17
30940,0,0,7,10,17
30941,0,0,11,13,24
30942,0,0,12,20,32
30943,0,0,10,8,18
30944,0,0,6,4,10
30945,0,1,20,29,50
30946,0,0,2,3,5
30947,0,0,0,5,5
30948,0,0,5,4,9
30949,0,0,8,10,18
30950,0,0,1,8,9
30951,0,0,6,3,9
30952,0,0,1,11,12
30953,0,0,4,7,11
30954,0,0,4,2,6
30955,0,0,6,4,10
30956,0,0,2,13,15
30957,0,0,13,24,37
30958,0,0,1,13,14
30959,0,0,18,26,44
30960,1,1,3,24,29
30961,0,0,10,18,28
30962,0,0,3,7,10
30963,0,1,3,18,22
30964,0,0,2,7,9
30965,0,0,4,2,6
30966,0,0,1,4,5
30967,0,1,3,4,8
30968,0,0,4,1,5
30969,0,0,3,9,12
30971,0,0,8,9,17
30972,0,0,4,8,12
30973,0,0,1,15,16
30974,0,1,1,14,16
30975,0,1,5,29,35
30976,0,0,11,17,28
30977,0,0,13,37,50
30978,1,2,11,25,39
30979,0,0,8,14,22
30980,0,0,9,5,14
30981,0,0,7,8,15
30982,0,0,13,17,30
30983,0,0,10,10,20
30984,0,1,2,9,12
30985,0,1,7,13,21
30986,1,1,5,25,32
30987,0,0,3,9,12
30989,0,0,6,25,31
30990,0,0,2,5,7
30991,1,0,11,21,33
30993,0,1,4,9,14
30994,0,0,4,5,9
30995,0,0,8,8,16
30996,0,0,14,25,39
30997,2,1,2,15,20
30998,0,0,3,14,17
30999,0,0,5,4,9
31000,0,0,4,11,15
31001,0,1,6,4,11
31002,0,0,10,14,24
31003,0,0,3,1,4
31004,2,0,7,33,42
31005,0,1,7,5,13
31006,1,3,11,20,35
31007,0,0,10,38,48
31008,0,0,0,7,7
31009,0,1,3,1,5
31010,1,0,0,9,10
31011,0,0,9,23,32
31012,0,1,7,8,16
31013,0,0,5,3,8
31014,0,1,3,5,9
31015,0,0,1,7,8
31016,0,0,3,13,16
31017,0,0,5,1,6
31018,0,0,5,37,42
31019,0,0,5,11,16
31020,0,0,3,2,5
31021,0,0,4,6,10
31022,0,0,2,10,12
31023,0,0,2,26,28
31024,0,0,6,4,10
31025,3,0,9,33,45
31026,0,1,1,2,4
31027,1,0,5,6,12
31028,0,1,12,37,50
31029,4,1,4,41,50
31030,0,2,10,37,49
31031,0,0,2,8,10
31032,0,0,1,5,6
31033,3,2,6,29,40
31034,0,0,7,14,21
31035,0,0,6,18,24
31036,0,0,6,8,14
31037,4,1,4,27,36
31038,0,0,2,10,12
31039,0,0,6,15,21
31040,0,0,0,1,1
31041,0,0,4,4,8
31042,0,0,2,5,7
31043,0,0,5,5,10
31044,0,0,2,6,8
31045,0,1,6,21,28
31046,0,0,3,10,13
31047,0,0,3,3,6
31048,0,0,4,10,14
31049,0,0,9,10,19
31050,0,1,9,25,35
31051,0,1,12,18,31
31052,2,1,5,6,14
31053,0,2,3,22,27
31054,0,0,1,21,22
31055,1,0,8,25,34
31056,0,1,9,12,22
31057,0,0,5,26,31
31058,0,0,1,7,8
31059,0,0,8,21,29
31060,0,0,11,36,47
31061,0,0,3,2,5
31062,0,0,4,11,15
31063,1,1,10,35,47
31064,0,1,17,20,38
31065,0,0,9,20,29
31066,0,2,2,21,25
31067,0,1,14,25,40
31068,0,0,5,4,9
31069,0,0,4,3,7
31070,0,0,8,19,27
31071,1,1,5,10,17
31072,0,2,15,29,46
31073,0,0,7,5,12
31074,0,0,0,4,4
31075,0,0,12,37,49
31076,0,0,5,3,8
31077,0,1,18,21,40
31078,0,1,9,40,50
31079,1,0,12,25,38
31080,0,0,1,10,11
31083,0,0,0,7,7
31084,0,0,13,19,32
31085,0,0,13,22,35
31086,0,0,4,25,29
31087,0,0,1,7,8
31088,0,1,9,10,20
31089,0,0,5,12,17
31090,0,0,8,15,23
31091,0,2,3,24,29
31092,0,0,4,9,13
31093,0,0,1,6,7
31094,0,0,3,9,12
31095,0,0,0,5,5
31096,0,0,5,2,7
31097,0,1,9,40,50
31098,0,2,4,9,15
31099,3,0,7,40,50
31100,0,1,1,10,12
31101,0,0,2,6,8
31102,0,0,2,7,9
31103,0,0,5,8,13
31104,0,0,4,4,8
31105,2,2,11,35,50
31106,0,0,5,17,22
31107,0,0,0,1,1
31108,0,3,13,27,43
31109,0,0,1,0,1
31110,0,0,4,6,10
31111,0,0,5,6,11
31112,0,0,6,8,14
31113,0,0,1,4,5
31114,0,1,5,13,19
31115,0,0,5,14,19
31116,0,0,6,14,20
31117,0,1,7,12,20
31118,0,0,1,9,10
31119,1,0,9,17,27
31121,0,0,7,19,26
31122,0,0,10,39,49
31123,0,0,3,12,15
31125,0,1,7,38,46
31126,0,0,0,5,5
31127,0,0,5,2,7
31128,0,1,5,18,24
31129,0,0,1,7,8
31130,1,0,1,7,9
31133,2,1,7,24,34
31134,0,0,8,42,50
31135,1,2,12,35,50
31136,0,0,3,9,12
31137,0,0,8,15,23
31138,1,0,7,42,50
31139,0,0,0,13,13
31140,1,0,2,4,7
31141,0,0,8,23,31
31144,0,0,3,11,14
31145,0,0,4,1,5
31146,0,0,4,8,12
31147,0,0,6,7,13
31148,0,1,9,39,49
31149,0,0,4,20,24
31150,0,1,7,9,17
31153,0,0,8,14,22
31154,0,0,6,9,15
31155,0,0,13,33,46
31156,0,0,3,12,15
31157,0,0,10,11,21
31158,0,0,3,10,13
31159,0,0,9,8,17
31160,0,0,4,1,5
31161,1,0,6,20,27
31162,0,0,5,10,15
31164,1,2,7,18,28
31165,0,0,1,5,6
31166,0,0,4,3,7
31168,0,0,4,3,7
31169,0,0,5,9,14
31170,0,1,4,14,19
31171,0,0,0,3,3
31172,0,0,1,8,9
31173,0,0,15,26,41
31175,0,0,0,6,6
31176,0,0,11,9,20
31178,0,0,2,7,9
31179,0,0,3,6,9
31180,1,1,2,11,15
31182,0,0,0,3,3
31183,1,0,2,16,19
31187,1,2,3,39,45
31190,0,1,3,9,13
31191,0,0,0,9,9
31193,0,0,5,5,10
31195,0,0,0,1,1
31196,0,0,2,1,3
31197,0,0,2,14,16
31198,0,0,10,8,18
31200,0,0,7,23,30
31201,0,0,7,8,15
31202,0,0,6,4,10
31204,0,0,1,1,2
31213,1,0,2,1,4
31215,0,0,8,11,19
31216,3,0,4,25,32
31217,0,0,6,13,19
31218,0,1,1,9,11
31219,0,1,2,3,6
31220,1,2,2,15,20
31221,0,0,8,27,35
31222,0,0,4,11,15
31223,0,0,2,4,6
31224,0,0,2,19,21
31225,0,0,5,21,26
31226,0,1,5,16,22
31227,0,0,3,6,9
31228,0,2,15,33,50
31229,0,0,6,20,26
31230,0,1,1,9,11
31231,0,0,6,2,8
31232,0,0,8,5,13
31233,2,0,2,10,14
31234,2,0,1,16,19
31235,0,0,8,8,16
31236,0,0,0,8,8
31237,1,3,2,35,41
31238,0,0,5,10,15
31239,0,0,6,15,21
31240,2,2,16,25,45
31241,0,0,2,44,46
31242,0,2,6,24,32
31243,0,1,11,27,39
31244,0,2,4,27,33
31245,0,0,8,17,25
31246,0,0,11,39,50
31247,0,0,11,26,37
31248,0,0,2,10,12
31249,0,0,6,13,19
31250,0,0,6,23,29
31251,0,1,7,20,28
31253,0,1,6,6,13
31254,0,0,5,31,36
31255,0,3,9,38,50
31256,0,0,11,24,35
31257,0,0,1,8,9
31258,0,1,12,30,43
31259,0,1,7,36,44
31260,0,0,15,35,50
31261,0,2,8,20,30
31262,0,1,6,10,17
31263,1,2,8,26,37
31264,0,0,7,8,15
31265,0,0,7,28,35
31266,0,1,1,27,29
31267,1,1,10,38,50
31268,0,0,1,13,14
31269,0,0,7,9,16
31270,0,0,14,32,46
31271,0,0,12,37,49
31272,1,0,3,23,27
31273,0,0,12,37,49
31274,1,0,6,16,23
31275,0,0,1,5,6
31276,0,0,0,12,12
31277,0,0,3,11,14
31278,0,0,0,18,18
31279,1,0,5,27,33
31280,4,3,2,17,26
31281,0,0,3,31,34
31282,0,0,10,10,20
31283,0,0,8,19,27
31284,0,0,4,8,12
31285,0,0,3,2,5
31286,0,0,2,6,8
31287,3,1,6,18,28
31288,0,0,2,45,47
31289,0,0,11,30,41
31291,0,1,6,18,25
31292,0,1,3,20,24
31294,1,1,13,22,37
31295,0,1,7,10,18
31297,1,1,8,29,39
31298,0,1,4,18,23
31299,0,0,4,14,18
31300,0,1,17,22,40
31301,0,1,12,34,47
31302,0,0,7,25,32
31303,0,2,0,36,38
31304,0,0,8,28,36
31305,1,1,5,26,33
31306,1,0,4,19,24
31307,0,0,1,6,7
31308,0,0,3,5,8
31309,0,0,4,21,25
31310,2,2,7,20,31
31311,0,1,3,15,19
31312,0,1,1,17,19
31313,1,0,13,12,26
31314,0,3,5,18,26
31315,0,0,11,6,17
31316,0,0,6,17,23
31317,3,0,4,12,19
31318,0,0,8,17,25
31319,0,0,14,16,30
31320,0,0,5,14,19
31321,1,0,4,42,47
31322,0,0,14,14,28
31323,0,0,0,5,5
31324,0,0,9,19,28
31325,0,0,0,1,1
31326,0,0,0,3,3
31327,1,0,12,35,48
31328,0,0,13,15,28
31329,0,0,15,25,40
31330,0,0,5,13,18
31331,0,2,4,13,19
31332,0,0,12,31,43
31333,0,0,13,37,50
31334,1,0,5,24,30
31335,0,1,18,31,50
31336,0,0,5,30,35
31337,0,0,16,26,42
31338,0,0,3,7,10
31339,3,0,13,34,50
31340,0,0,14,14,28
31341,1,0,12,28,41
31342,1,2,2,15,20
31343,0,0,2,8,10
31344,0,1,6,22,29
31345,0,0,12,23,35
31346,0,0,2,13,15
31347,1,0,14,26,41
31348,0,0,5,6,11
31349,0,0,1,12,13
31350,1,0,5,19,25
31351,0,0,3,3,6
31352,0,0,7,9,16
31353,0,0,3,3,6
31354,0,0,8,27,35
31355,1,0,1,10,12
31356,0,1,3,38,42
31357,0,1,2,15,18
31358,0,0,3,3,6
31359,0,0,4,11,15
31360,0,0,20,23,43
31361,0,0,10,40,50
31362,0,1,16,28,45
31363,0,0,3,43,46
31364,0,1,4,7,12
31365,0,0,1,8,9
31366,0,2,3,16,21
31367,1,1,6,40,48
31368,0,0,0,11,11
31369,0,1,8,17,26
31370,0,0,5,30,35
31371,0,1,1,13,15
31372,1,0,2,12,15
31373,1,0,7,32,40
31374,0,0,8,12,20
31375,0,0,13,13,26
31376,0,0,1,8,9
31377,0,1,6,17,24
31378,0,0,15,23,38
31379,0,0,3,7,10
31380,0,0,2,36,38
31381,0,0,4,11,15
31382,1,1,2,26,30
31383,0,0,3,3,6
31384,0,3,5,40,48
31385,0,0,4,11,15
31386,0,0,7,9,16
31387,1,2,1,9,13
31388,0,0,2,3,5
31389,0,0,0,6,6
31391,0,0,19,31,50
31392,1,0,20,21,42
31393,0,0,7,19,26
31394,0,0,4,6,10
31395,0,0,9,41,50
31396,0,0,14,23,37
31397,0,0,6,25,31
31398,0,0,1,9,10
31399,0,0,6,20,26
31400,0,0,16,25,41
31401,0,0,7,8,15
31402,0,1,6,42,49
31403,0,0,7,12,19
31404,0,0,1,5,6
31405,0,0,8,41,49
31406,0,1,10,30,41
31407,0,2,15,19,36
31409,0,0,10,15,25
31410,0,0,12,14,26
31411,0,0,6,3,9
31412,0,1,8,10,19
31413,0,0,9,8,17
31414,0,0,7,9,16
31415,1,0,5,32,38
31416,1,0,2,12,15
31417,0,0,4,8,12
31418,0,1,8,17,26
31419,0,1,1,20,22
31420,0,2,9,33,44
31421,0,1,8,27,36
31422,1,1,11,36,49
31423,1,0,6,8,15
31424,0,0,5,9,14
31425,0,0,6,6,12
31426,3,0,1,12,16
31427,2,0,14,34,50
31428,0,0,2,8,10
31429,0,0,3,21,24
31430,1,0,12,22,35
31431,0,0,2,4,6
31432,0,0,3,10,13
31433,0,0,15,26,41
31434,0,0,2,2,4
31436,0,2,0,22,24
31437,0,0,2,13,15
31438,5,2,6,37,50
31439,1,0,2,33,36
31440,1,1,9,39,50
31441,1,0,5,14,20
31442,0,0,4,12,16
31443,1,0,17,18,36
31444,0,0,3,6,9
31445,0,1,4,19,24
31446,0,2,5,24,31
31447,0,1,4,19,24
31448,4,0,7,18,29
31449,0,0,3,24,27
31450,2,0,7,34,43
31451,0,0,2,7,9
31452,0,0,4,26,30
31453,0,0,6,21,27
31454,0,0,7,9,16
31455,0,0,9,15,24
31456,0,0,0,5,5
31457,0,2,5,33,40
31458,0,0,13,12,25
31459,0,2,2,21,25
31460,4,0,8,37,49
31461,0,0,8,26,34
31462,4,0,3,9,16
31463,0,1,9,30,40
31464,1,0,3,24,28
31465,0,1,3,3,7
31467,1,0,16,33,50
31469,0,0,1,11,12
31470,0,1,5,20,26
31471,1,0,10,36,47
31472,0,0,1,26,27
31473,1,0,0,2,3
31474,0,0,5,16,21
31475,0,0,4,16,20
31476,0,0,10,31,41
31477,0,1,9,14,24
31478,0,0,7,11,18
31479,0,0,13,17,30
31481,0,0,22,27,49
31482,0,2,11,23,36
31483,1,0,1,17,19
31484,0,0,2,6,8
31485,1,0,4,21,26
31487,0,0,12,17,29
31488,0,0,7,17,24
31489,1,1,9,39,50
31490,1,0,12,33,46
31491,0,0,15,29,44
31492,3,1,3,19,26
31493,0,0,12,18,30
31495,0,1,9,40,50
31496,0,0,4,3,7
31497,1,0,4,13,18
31498,0,0,7,17,24
31499,4,0,2,23,29
31500,0,0,1,9,10
31501,0,0,8,16,24
31502,0,1,7,40,48
31503,0,1,1,19,21
31504,0,0,9,18,27
31505,0,0,12,36,48
31506,0,2,3,12,17
31507,0,1,1,17,19
31508,0,2,4,11,17
31509,0,0,1,17,18
31510,0,0,10,11,21
31511,0,0,7,15,22
31512,1,0,11,29,41
31513,1,2,12,35,50
31514,0,2,1,10,13
31515,0,0,3,3,6
31516,0,1,8,13,22
31517,0,0,0,5,5
31518,0,2,6,6,14
31519,2,0,10,24,36
31520,1,0,4,9,14
31521,2,0,4,31,37
31522,1,0,4,21,26
31523,4,0,0,8,12
31524,0,0,14,34,48
31525,0,0,0,8,8
31527,0,1,3,14,18
31528,0,0,0,20,20
31529,0,1,9,40,50
31530,0,0,2,4,6
31531,0,0,10,19,29
31532,1,1,9,17,28
31533,0,0,2,2,4
31538,0,0,4,4,8
31539,0,0,0,2,2
31540,0,1,5,44,50
31541,1,1,4,28,34
31542,0,1,2,3,6
31543,0,0,6,5,11
31544,0,2,13,30,45
31545,0,0,2,15,17
31546,0,0,8,11,19
31547,0,1,4,18,23
31548,0,0,6,5,11
31549,0,1,4,45,50
31550,0,0,6,2,8
31552,0,1,10,25,36
31553,0,0,5,5,10
31554,0,0,10,18,28
31555,0,0,7,16,23
31556,3,0,4,25,32
31557,0,0,5,3,8
31558,0,0,2,7,9
31559,0,0,5,21,26
31560,0,1,4,27,32
31561,0,1,6,21,28
31562,0,0,3,2,5
31563,0,0,3,6,9
31564,0,1,1,9,11
31565,0,1,5,16,22
31566,1,1,5,10,17
31567,2,1,7,24,34
31568,0,1,7,12,20
31569,2,0,1,16,19
31570,1,1,6,22,30
31571,0,0,7,8,15
31572,0,0,7,19,26
31573,1,0,7,42,50
31574,2,0,2,10,14
31575,1,0,3,12,16
31576,5,3,3,38,49
31577,1,0,7,32,40
31578,0,1,5,44,50
31579,1,1,2,18,22
31580,0,1,3,14,18
31581,0,0,0,18,18
31582,0,2,6,24,32
31583,1,1,10,24,36
31584,4,0,0,8,12
31585,0,0,10,40,50
31586,1,0,1,28,30
31587,0,0,0,18,18
31588,0,1,3,12,16
31589,0,1,7,36,44
31590,0,0,5,23,28
31591,0,1,1,27,29
31592,0,0,12,37,49
31593,1,2,8,26,37
31594,1,0,2,2,5
31595,3,1,2,19,25
31596,4,1,2,35,42
31597,0,2,3,26,31
31598,0,2,0,36,38
31599,0,1,1,9,11
31600,1,1,5,26,33
31601,0,0,2,45,47
31602,1,0,4,19,24
31603,0,0,0,2,2
31605,0,1,0,16,17
31606,1,0,8,13,22
31607,0,0,0,8,8
31608,1,0,3,29,33
31609,0,0,2,9,11
31610,1,0,12,35,48
31611,2,1,3,30,36
31612,0,0,3,3,6
31613,0,2,2,23,27
31614,0,0,1,9,10
31615,0,0,5,30,35
31616,0,1,10,38,49
31618,0,0,19,31,50
31619,0,0,2,4,6
31620,1,1,6,40,48
31621,0,1,4,45,50
31622,0,0,15,23,38
31623,0,0,2,19,21
31624,2,0,4,20,26
31625,0,0,0,8,8
31626,0,0,1,10,11
31627,2,0,2,14,18
31628,2,0,12,34,48
31629,0,0,5,44,49
31630,2,0,14,34,50
31631,1,0,9,29,39
31632,1,1,9,39,50
31633,0,1,1,20,22
31635,0,0,1,1,2
31636,1,0,6,14,21
31638,0,0,9,29,38
31639,0,0,8,42,50
31640,3,2,2,24,31
31641,0,1,0,12,13
31643,4,0,7,18,29
31644,1,0,7,6,14
31646,0,1,2,14,17
31647,0,0,7,21,28
31648,1,2,4,43,50
31649,0,0,10,6,16
31650,0,0,9,15,24
31651,0,0,9,12,21
31658,0,1,9,40,50
31659,4,0,1,25,30
31662,0,2,13,30,45
31663,0,3,5,40,48
31664,0,0,8,11,19
31665,0,0,6,16,22
31666,0,0,5,21,26
31667,2,0,7,34,43
31668,0,0,10,39,49
31669,0,2,1,10,13
31670,0,1,7,38,46
31671,2,1,2,10,15
31672,1,0,11,37,49
31673,0,0,3,28,31
31674,1,1,9,39,50
31675,0,1,2,21,24
31676,0,0,6,27,33
31677,0,0,12,37,49
31678,0,1,3,13,17
31679,1,0,7,17,25
31680,1,0,2,13,16
31681,2,1,1,15,19
31682,0,0,1,7,8
31683,1,1,6,40,48
31684,0,1,6,39,46
31685,0,3,5,40,48
31686,0,0,4,8,12
31687,1,0,9,32,42
31688,0,2,13,30,45
31689,0,0,0,10,10
31690,4,0,1,25,30
31691,0,1,1,9,11
31692,0,1,1,20,22
31693,0,0,5,3,8
31694,4,3,2,17,26
31695,3,1,2,19,25
31696,1,1,10,38,50
31698,0,0,10,17,27
31699,2,0,1,16,19
31700,0,0,5,21,26
31701,0,1,5,44,50
31702,0,0,3,12,15
31703,2,2,16,25,45
31704,4,1,0,21,26
31705,0,1,4,27,32
31706,0,1,1,9,11
31707,0,0,5,21,26
31708,0,2,15,33,50
31709,0,1,2,3,6
31710,4,1,0,21,26
31711,0,1,4,27,32
31712,2,2,16,25,45
31713,1,1,6,22,30
31714,3,0,4,25,32
31715,0,2,13,30,45
31716,2,2,16,25,45
31717,0,0,2,3,5
31718,0,0,6,13,19
31719,2,0,2,10,14
31720,0,0,7,8,15
31721,0,0,3,10,13
31722,0,0,6,14,20
31723,0,0,14,36,50
31724,0,0,1,11,12
31725,0,2,0,23,25
31726,0,0,6,14,20
31728,0,0,3,7,10
31729,0,0,6,10,16
31730,0,2,8,24,34
31731,0,0,1,11,12
31732,0,2,0,23,25
31733,0,0,8,23,31
31734,0,2,8,24,34
31735,0,0,10,34,44
31736,0,0,4,14,18
31737,0,0,5,10,15
31738,0,0,5,9,14
31739,0,0,2,4,6
31740,0,0,2,12,14
31741,0,1,6,9,16
31742,0,0,11,31,42
31743,0,0,9,37,46
31744,0,1,5,6,12
31745,0,1,15,30,46
31746,0,0,14,31,45
31747,0,5,7,24,36
31748,2,1,5,42,50
31749,0,0,0,10,10
31750,0,0,6,14,20
31751,2,1,4,12,19
31752,0,0,3,6,9
31753,0,0,3,9,12
31754,0,1,6,4,11
31755,0,0,6,5,11
31756,0,0,9,35,44
31757,0,0,7,17,24
31758,0,1,5,9,15
31759,0,1,5,14,20
31760,0,0,4,8,12
31761,1,2,8,14,25
31762,0,0,6,15,21
31763,0,0,2,6,8
31764,1,0,9,27,37
31765,0,0,4,13,17
31766,0,0,5,3,8
31767,0,0,7,12,19
31768,0,0,1,5,6
31769,0,0,2,4,6
31770,0,0,10,22,32
31771,0,0,3,7,10
31772,0,0,5,13,18
31773,0,1,11,22,34
31774,0,1,5,33,39
31775,0,0,9,25,34
31776,0,0,1,4,5
31777,0,0,4,2,6
31778,0,1,0,8,9
31779,0,0,0,5,5
31780,0,0,2,6,8
31783,0,0,7,10,17
31784,0,0,6,3,9
31785,0,0,5,9,14
31786,0,0,1,4,5
31787,0,0,3,7,10
31788,0,0,3,7,10
31789,0,1,5,4,10
31790,0,2,3,15,20
31791,0,0,0,7,7
31792,0,0,4,14,18
31794,0,0,10,13,23
31795,0,0,7,5,12
31796,0,0,7,17,24
31797,1,0,3,22,26
31798,0,4,4,7,15
31799,0,0,2,10,12
31800,0,0,1,8,9
31801,0,1,2,8,11
31802,0,0,1,5,6
31804,0,2,10,13,25
31805,0,0,3,8,11
31806,0,0,2,10,12
31807,0,0,7,33,40
31808,0,0,3,2,5
31810,0,1,1,6,8
31812,0,0,8,25,33
31813,0,0,1,3,4
31814,0,0,2,3,5
31815,0,0,2,25,27
31816,0,0,5,10,15
31817,0,0,0,7,7
31818,0,0,2,7,9
31819,0,0,1,7,8
31820,0,0,7,23,30
31821,0,0,11,28,39
31822,0,1,4,7,12
31823,0,0,2,6,8
31824,0,0,1,4,5
31825,0,0,0,5,5
31826,0,0,0,5,5
31827,0,0,9,26,35
31829,0,0,2,4,6
31830,0,0,4,10,14
31831,0,0,3,14,17
31832,0,1,12,15,28
31833,0,0,3,10,13
31834,0,0,13,25,38
31835,0,0,4,6,10
31836,0,0,10,18,28
31837,1,0,10,12,23
31838,0,1,6,13,20
31839,0,0,9,29,38
31840,0,0,1,8,9
31842,0,3,12,14,29
31843,0,0,5,9,14
31844,0,0,16,34,50
31845,0,1,20,29,50
31846,0,0,7,23,30
31847,0,0,7,12,19
31848,3,0,0,6,9
31849,0,0,9,29,38
31850,0,0,5,11,16
31851,1,0,10,12,23
31852,0,0,10,32,42
31853,0,0,4,14,18
31854,0,0,15,32,47
31855,0,1,5,33,39
31856,0,0,4,7,11
31857,0,0,13,10,23
31858,0,3,1,11,15
31859,0,0,0,8,8
31860,0,1,5,16,22
31861,0,2,2,6,10
31862,0,1,3,9,13
31863,0,2,11,13,26
31864,0,1,6,18,25
31865,0,1,5,6,12
31866,0,1,9,28,38
31867,2,1,5,42,50
31868,0,1,5,18,24
31869,0,2,3,22,27
31870,0,0,9,35,44
31871,0,0,13,6,19
31872,0,0,16,33,49
31873,0,0,4,17,21
31874,0,1,6,39,46
31875,0,0,10,18,28
31876,0,1,6,13,20
31878,0,0,2,4,6
31879,0,0,17,29,46
31881,0,0,3,10,13
31882,2,0,4,11,17
31883,0,0,1,8,9
31884,2,0,4,11,17
31885,2,1,5,42,50
31886,0,0,2,23,25
31887,2,1,4,12,19
31888,0,1,6,39,46
31889,3,0,0,6,9
31890,0,1,5,6,12
31891,0,0,1,8,9
31892,0,1,3,9,13
31893,0,2,2,6,10
31894,0,0,13,25,38
31895,0,0,13,6,19
31896,0,0,4,17,21
31897,0,0,17,29,46
31898,0,4,4,7,15
31899,0,0,3,14,17
31901,0,0,16,33,49
31902,0,1,3,9,13
31903,0,2,11,13,26
31904,3,0,0,6,9
31905,0,1,12,15,28
31906,0,1,20,29,50
31907,0,1,5,18,24
31908,0,0,9,26,35
31909,0,0,10,18,28
31910,0,0,2,4,6
31911,0,0,1,8,9
31912,0,0,1,7,8
31913,0,1,2,23,26
31914,0,0,4,2,6
31915,0,0,1,18,19
31916,0,0,3,5,8
31917,0,0,2,3,5
31918,0,0,4,14,18
31919,0,0,3,8,11
31920,0,0,4,1,5
31921,0,0,9,11,20
31922,0,0,5,22,27
31923,0,0,0,5,5
31924,0,0,1,5,6
31925,0,6,10,24,40
31926,0,0,3,13,16
31927,0,0,9,26,35
31928,0,0,14,36,50
31929,0,0,1,4,5
31930,0,0,3,17,20
31931,0,0,3,8,11
31932,0,0,0,9,9
31933,0,0,12,37,49
31934,0,0,17,29,46
31935,0,1,15,30,46
31936,0,0,5,3,8
31937,1,1,5,7,14
31938,0,0,6,9,15
31940,0,0,2,10,12
31941,0,0,5,3,8
31942,0,0,4,5,9
31943,0,0,3,12,15
31944,0,0,11,28,39
31945,1,1,8,15,25
31946,0,0,7,9,16
31947,1,0,1,9,11
31948,0,0,5,16,21
31949,0,3,14,27,44
31950,0,0,5,19,24
31951,0,0,4,9,13
31952,0,2,7,22,31
31953,0,1,16,30,47
31954,0,1,9,27,37
31955,0,0,4,36,40
31956,0,0,1,2,3
31957,1,0,9,9,19
31958,0,0,5,12,17
31959,0,0,6,16,22
31960,0,0,2,11,13
31961,0,1,3,11,15
31962,0,2,4,5,11
31963,0,0,6,14,20
31964,0,0,8,17,25
31965,0,0,1,10,11
31966,0,0,2,6,8
31967,1,0,1,20,22
31968,0,0,2,9,11
31969,0,0,3,6,9
31970,0,0,1,8,9
31971,0,0,2,6,8
31972,1,0,11,18,30
31973,0,0,8,11,19
31974,0,0,8,18,26
31975,0,0,1,4,5
31976,0,1,3,12,16
31977,0,0,8,12,20
31978,0,0,3,8,11
31979,0,0,3,10,13
31980,0,0,7,12,19
31981,1,1,2,14,18
31982,0,1,2,7,10
31983,0,0,3,13,16
31984,0,0,3,10,13
31985,0,0,3,18,21
31986,0,0,3,12,15
31987,0,1,2,9,12
31988,0,0,3,10,13
31989,0,0,7,14,21
31990,0,0,4,8,12
31992,0,0,10,15,25
31993,0,0,3,5,8
31994,0,5,4,13,22
31995,0,0,11,9,20
31996,0,0,6,7,13
31997,0,0,2,10,12
31999,1,1,7,26,35
32000,0,0,3,4,7
32001,0,0,4,16,20
32002,0,0,3,4,7
32003,0,1,14,35,50
32004,0,0,6,20,26
32005,0,0,6,10,16
32006,0,0,2,4,6
32007,0,0,1,1,2
32008,0,0,6,23,29
32009,0,0,9,9,18
32010,0,0,5,12,17
32011,0,0,3,9,12
32012,1,1,3,14,19
32013,0,0,12,28,40
32014,0,0,1,9,10
32015,0,0,3,10,13
32016,0,0,9,23,32
32017,0,0,11,28,39
32018,0,0,4,15,19
32019,0,0,6,17,23
32020,0,1,10,25,36
32021,0,0,10,7,17
32023,0,0,3,4,7
32024,0,1,9,30,40
32025,0,0,4,4,8
32026,0,0,8,11,19
32027,0,1,11,19,31
32028,0,0,8,10,18
32029,0,0,8,6,14
32030,0,0,6,12,18
32031,0,0,4,19,23
32032,0,0,12,5,17
32033,0,0,1,8,9
32034,0,0,11,3,14
32035,0,0,9,13,22
32036,0,0,4,3,7
32037,0,0,5,21,26
32038,0,0,13,25,38
32039,0,0,4,12,16
32040,0,1,5,11,17
32042,0,0,5,11,16
32043,0,0,0,8,8
32044,0,1,11,29,41
32045,0,1,12,30,43
32046,0,0,4,16,20
32047,1,0,0,8,9
32048,0,0,3,3,6
32049,0,4,0,11,15
32050,0,3,11,32,46
32051,0,1,3,3,7
32052,2,0,9,31,42
32053,0,0,12,35,47
32054,0,0,6,12,18
32055,0,2,5,20,27
32056,0,0,1,8,9
32057,0,0,4,7,11
32059,0,0,3,6,9
32060,0,5,4,10,19
32061,0,1,14,35,50
32062,0,0,4,13,17
32063,4,0,7,27,38
32064,0,1,7,17,25
32065,0,0,0,4,4
32066,0,0,7,18,25
32067,0,0,11,18,29
32068,0,0,4,4,8
32069,0,0,0,2,2
32070,0,0,4,2,6
32071,0,1,1,16,18
32073,0,0,14,11,25
32074,0,0,13,32,45
32075,0,0,4,14,18
32076,0,1,1,5,7
32077,0,1,1,10,12
32078,0,0,7,8,15
32079,0,0,8,17,25
32080,0,0,9,13,22
32081,0,0,5,4,9
32082,0,0,1,4,5
32083,0,0,7,10,17
32084,0,0,13,12,25
32085,0,0,4,1,5
32086,0,1,3,12,16
32087,0,0,7,10,17
32088,0,0,3,6,9
32089,0,0,3,4,7
32090,0,0,0,5,5
32091,0,2,3,3,8
32093,0,0,7,9,16
32094,0,0,10,22,32
32095,0,0,1,7,8
32096,0,0,13,18,31
32097,0,0,5,10,15
32098,0,0,6,14,20
32099,0,0,10,22,32
32100,0,0,3,4,7
32101,0,0,0,7,7
32103,0,0,4,4,8
32104,0,0,4,14,18
32105,0,0,2,5,7
32106,0,1,3,6,10
32108,0,0,5,18,23
32112,0,1,0,17,18
32113,0,1,2,23,26
32114,0,0,11,19,30
32116,0,0,3,19,22
32117,0,0,2,3,5
32118,0,1,10,6,17
32119,0,1,3,7,11
32120,0,1,3,2,6
32121,0,0,11,38,49
32122,0,0,4,16,20
32123,0,1,5,8,14
32124,0,0,4,10,14
32125,0,0,6,6,12
32126,0,0,1,12,13
32127,0,0,5,16,21
32129,0,0,3,6,9
32131,0,0,3,9,12
32132,2,1,3,17,23
32133,0,0,8,12,20
32134,0,0,10,18,28
32135,0,2,0,23,25
32136,0,0,1,15,16
32137,0,2,3,7,12
32139,1,2,5,9,17
32140,0,0,4,2,6
32141,1,1,2,16,20
32142,0,0,18,32,50
32143,1,0,8,38,47
32144,0,1,7,36,44
32145,0,0,4,23,27
32146,0,1,5,18,24
32147,0,0,10,28,38
32148,3,0,0,6,9
32149,0,3,8,23,34
32150,2,0,12,26,40
32151,0,0,4,16,20
32153,0,0,1,4,5
32154,0,0,13,30,43
32155,0,0,9,24,33
32156,0,0,11,38,49
32157,0,0,9,21,30
32158,0,3,11,26,40
32159,0,0,5,11,16
32160,0,0,5,9,14
32161,0,2,4,20,26
32162,0,1,2,14,17
32163,0,1,10,27,38
32164,0,1,14,32,47
32165,0,0,5,3,8
32166,0,0,13,36,49
32167,0,0,13,28,41
32168,0,0,3,2,5
32169,1,0,2,19,22
32170,1,1,7,33,42
32171,0,0,2,4,6
32172,0,1,0,5,6
32173,0,3,2,15,20
32174,0,2,1,10,13
32175,0,1,5,8,14
32176,0,0,6,16,22
32177,0,2,3,13,18
32178,0,2,7,22,31
32179,0,1,17,29,47
32180,0,0,16,33,49
32181,0,0,7,21,28
32182,0,0,10,7,17
32183,1,0,2,16,19
32184,0,0,6,12,18
32185,0,0,4,14,18
32186,0,0,1,15,16
32187,0,1,0,8,9
32188,0,0,5,7,12
32189,1,0,10,39,50
32190,0,0,10,18,28
32191,0,0,4,17,21
32192,0,1,16,25,42
32194,0,0,13,18,31
32195,1,1,4,13,19
32196,1,0,1,4,6
32198,0,1,8,18,27
32199,1,0,5,36,42
32200,0,1,2,23,26
32201,0,0,6,14,20
32202,0,1,3,46,50
32203,0,0,3,6,9
32204,0,0,12,28,40
32205,1,2,7,40,50
32206,1,1,2,16,20
32207,0,1,16,30,47
32208,0,0,8,17,25
32209,1,1,3,14,19
32210,0,4,0,11,15
32211,0,2,3,7,12
32212,0,1,5,8,14
32213,0,2,0,23,25
32214,0,1,0,17,18
32216,2,1,3,17,23
32217,1,0,5,36,42
32218,3,0,0,6,9
32219,0,0,13,30,43
32220,0,0,10,28,38
32221,0,1,0,8,9
32222,0,0,4,16,20
32223,1,1,3,14,19
32224,0,0,1,4,5
32225,1,0,8,38,47
32226,0,0,13,25,38
32227,0,1,3,46,50
32228,0,0,3,9,12
32229,1,1,5,7,14
32230,0,0,4,17,21
32231,1,2,5,9,17
32232,0,1,3,46,50
32233,1,2,5,9,17
32234,3,0,0,6,9
32235,0,0,9,26,35
32236,0,1,5,18,24
32237,0,0,8,12,20
32238,0,1,2,23,26
32239,0,0,16,33,49
32240,1,2,7,40,50
32241,0,0,10,18,28
32242,0,0,4,2,6
32243,0,0,1,9,10
32244,0,0,2,4,6
32245,0,0,7,12,19
32246,1,0,0,9,10
32247,0,0,13,22,35
32248,0,0,4,11,15
32250,0,0,6,14,20
32251,0,1,9,13,23
32252,0,0,2,10,12
32253,0,0,1,6,7
32254,0,0,8,20,28
32255,0,1,17,32,50
32256,0,1,6,25,32
32257,0,0,1,8,9
32258,0,0,8,15,23
32259,0,1,4,42,47
32260,0,0,4,4,8
32261,0,0,4,10,14
32262,0,0,3,14,17
32263,0,0,2,17,19
32264,0,0,4,16,20
32265,0,0,7,17,24
32266,0,0,7,11,18
32267,0,0,3,8,11
32268,0,0,9,15,24
32269,0,0,7,6,13
32270,0,0,8,12,20
32271,0,2,2,8,12
32272,0,0,4,2,6
32273,0,0,9,29,38
32275,0,0,10,40,50
32276,0,0,7,7,14
32277,0,3,8,20,31
32278,0,0,3,5,8
32279,0,0,8,17,25
32280,0,0,3,12,15
32281,0,0,4,21,25
32282,0,0,1,5,6
32283,0,1,2,17,20
32285,1,0,9,10,20
32286,0,0,1,4,5
32287,0,0,1,5,6
32288,0,1,2,5,8
32289,0,0,12,17,29
32290,0,0,8,13,21
32291,0,0,3,2,5
32292,0,0,10,22,32
32293,0,0,5,9,14
32294,0,0,1,5,6
32295,0,0,9,16,25
32296,0,0,0,8,8
32297,1,0,1,18,20
32298,0,0,6,10,16
32299,0,0,3,7,10
32300,0,0,6,19,25
32301,0,0,5,7,12
32302,0,0,7,22,29
32303,0,0,4,12,16
32304,0,0,6,12,18
32305,0,0,5,10,15
32306,0,0,8,11,19
32307,0,0,1,8,9
32308,0,0,5,8,13
32309,0,0,8,7,15
32310,0,0,3,4,7
32313,0,0,9,16,25
32314,0,0,7,12,19
32315,0,0,1,14,15
32316,0,0,6,4,10
32317,0,0,4,10,14
32318,0,0,2,4,6
32319,0,1,1,21,23
32320,0,1,5,12,18
32321,0,1,11,22,34
32322,0,0,4,3,7
32323,0,1,6,16,23
32324,0,2,3,7,12
32325,1,1,2,10,14
32326,1,1,2,9,13
32327,0,0,7,23,30
32328,0,0,2,3,5
32329,0,0,3,18,21
32330,0,0,2,6,8
32331,0,0,11,10,21
32332,0,0,7,5,12
32333,0,0,0,8,8
32334,0,0,6,12,18
32335,0,0,10,18,28
32336,0,0,1,5,6
32337,0,0,6,15,21
32338,0,0,8,21,29
32339,0,0,3,3,6
32340,0,0,3,4,7
32341,0,0,8,15,23
32342,0,0,6,12,18
32343,0,0,1,4,5
32344,0,0,4,12,16
32345,0,0,3,4,7
32346,0,0,1,1,2
32347,0,1,15,33,49
32348,0,1,6,10,17
32349,0,0,2,8,10
32350,0,0,5,3,8
32351,1,0,14,25,40
32352,0,0,11,3,14
32353,0,0,6,12,18
32354,0,0,1,7,8
32355,0,0,0,2,2
32356,0,0,1,8,9
32357,0,1,6,31,38
32358,0,0,4,13,17
32359,0,1,3,13,17
32360,0,0,3,5,8
32361,0,0,5,19,24
32362,0,1,12,15,28
32363,0,0,9,17,26
32364,0,0,3,3,6
32365,0,0,3,15,18
32366,0,0,2,6,8
32367,0,2,12,32,46
32368,0,0,4,10,14
32369,0,0,1,4,5
32370,0,0,0,9,9
32371,1,0,3,29,33
32372,0,1,6,5,12
32373,0,0,3,3,6
32374,0,1,8,11,20
32375,0,0,2,2,4
32376,0,0,1,7,8
32378,0,0,11,16,27
32380,0,0,4,9,13
32381,0,0,2,8,10
32383,1,0,10,29,40
32384,0,1,11,35,47
32385,0,0,0,5,5
32386,0,1,8,23,32
32387,0,1,0,13,14
32388,0,0,5,6,11
32389,0,2,7,25,34
32390,0,0,2,2,4
32391,1,0,4,9,14
32392,0,0,6,6,12
32393,0,0,1,6,7
32394,0,0,3,7,10
32395,0,0,2,9,11
32397,0,0,2,12,14
32398,0,1,3,10,14
32399,0,0,2,18,20
32400,0,0,2,3,5
32401,2,1,5,42,50
32402,0,0,11,38,49
32403,0,0,9,14,23
32405,0,1,4,15,20
32406,0,0,3,12,15
32407,1,0,8,15,24
32408,0,0,8,17,25
32409,0,0,20,30,50
32410,0,0,9,10,19
32411,0,1,5,10,16
32412,1,1,2,16,20
32413,0,1,6,13,20
32414,0,0,9,35,44
32415,0,0,4,6,10
32416,0,1,8,22,31
32417,0,0,18,32,50
32418,0,0,13,6,19
32419,0,0,15,35,50
32420,0,0,12,36,48
32421,0,0,8,34,42
32422,0,0,3,10,13
32423,1,2,7,40,50
32424,0,1,15,32,48
32425,0,0,6,17,23
32426,0,1,3,15,19
32427,0,0,10,27,37
32428,3,0,0,6,9
32429,0,1,9,20,30
32430,0,1,20,29,50
32431,0,0,19,27,46
32432,0,0,11,38,49
32433,0,0,4,16,20
32434,0,0,3,12,15
32435,1,3,8,12,24
32436,1,0,16,33,50
32437,0,1,6,39,46
32438,0,0,8,17,25
32439,0,0,10,15,25
32440,0,0,9,35,44
32441,0,0,5,4,9
32442,1,0,13,35,49
32443,0,0,7,10,17
32444,0,0,3,7,10
32445,0,1,8,24,33
32446,0,0,5,14,19
32447,0,0,5,16,21
32448,0,0,17,25,42
32449,0,0,7,15,22
32450,0,0,8,37,45
32451,0,0,4,11,15
32452,3,0,6,16,25
32453,0,0,9,10,19
32454,1,0,16,31,48
32456,0,0,3,3,6
32457,0,3,10,37,50
32458,0,1,8,11,20
32459,0,2,2,14,18
32460,0,1,3,22,26
32461,0,0,16,34,50
32462,0,0,11,19,30
32463,0,0,6,20,26
32464,0,0,2,4,6
32465,0,0,5,19,24
32466,0,0,3,13,16
32467,1,0,4,5,10
32468,0,1,14,34,49
32469,1,0,4,15,20
32470,0,0,10,6,16
32471,0,0,5,12,17
32472,0,0,6,25,31
32473,0,0,7,19,26
32474,0,0,0,10,10
32475,0,0,16,29,45
32476,0,0,0,4,4
32477,0,0,7,17,24
32478,1,1,6,16,24
32479,0,0,5,24,29
32480,0,1,7,16,24
32481,0,0,12,27,39
32482,0,0,10,30,40
32483,0,0,8,9,17
32485,0,0,3,13,16
32486,2,0,9,39,50
32487,1,0,6,39,46
32488,0,1,6,13,20
32489,0,0,7,16,23
32490,0,0,5,5,10
32491,0,1,0,5,6
32492,0,0,1,8,9
32493,0,0,4,8,12
32494,1,0,9,29,39
32495,0,0,3,2,5
32496,0,1,6,8,15
32497,0,0,3,12,15
32498,0,0,20,30,50
32499,0,0,1,14,15
32500,2,1,5,42,50
32501,1,0,5,36,42
32502,0,0,6,4,10
32503,0,0,9,29,38
32504,1,0,8,15,24
32505,1,1,2,16,20
32506,0,2,2,15,19
32507,0,0,9,17,26
32508,3,0,0,6,9
32509,0,0,4,16,20
32510,2,1,5,42,50
32511,0,1,8,11,20
32512,0,0,1,14,15
32513,0,0,6,20,26
32514,1,0,0,9,10
32515,0,0,0,6,6
32516,0,0,1,5,6
32517,0,1,6,39,46
32518,0,0,3,7,10
32519,0,0,1,8,9
32520,0,0,7,19,26
32521,0,0,5,24,29
32522,0,0,3,2,5
32523,0,1,6,8,15
32524,1,0,5,36,42
32525,1,0,4,9,14
32526,0,0,2,4,6
32527,0,0,3,13,16
32528,0,0,6,4,10
32529,0,0,13,6,19
32530,0,1,12,15,28
32531,0,1,20,29,50
32532,0,0,2,4,6
32533,3,0,0,6,9
32534,1,2,7,40,50
32535,0,0,4,14,18
32536,0,0,2,2,4
32537,0,0,2,4,6
32538,0,0,5,14,19
32539,0,0,3,6,9
32541,0,0,11,17,28
32542,1,1,1,15,18
32543,0,0,8,10,18
32544,0,0,0,12,12
32545,0,0,4,11,15
32546,0,0,1,13,14
32547,0,0,1,16,17
32548,0,1,7,15,23
32549,0,0,6,10,16
32550,0,0,4,14,18
32551,0,0,4,22,26
32552,0,0,1,13,14
32553,0,0,5,17,22
32555,0,0,6,16,22
32556,0,0,1,10,11
32557,0,1,2,26,29
32558,0,0,0,4,4
32559,0,0,5,4,9
32560,0,1,6,19,26
32561,0,0,3,14,17
32562,1,0,5,32,38
32563,0,0,5,9,14
32564,0,0,8,4,12
32565,0,0,1,12,13
32566,0,1,7,9,17
32567,0,0,9,25,34
32568,0,0,9,12,21
32569,0,0,6,21,27
32570,0,0,5,8,13
32571,0,0,6,15,21
32572,1,0,3,8,12
32573,0,0,4,9,13
32574,0,0,1,12,13
32575,0,0,3,2,5
32576,0,0,9,23,32
32577,0,0,8,7,15
32578,0,0,4,11,15
32579,0,0,6,4,10
32580,0,0,2,8,10
32581,0,0,3,7,10
32582,0,0,6,17,23
32583,0,0,6,19,25
32584,0,0,3,13,16
32585,0,0,0,9,9
32586,0,0,3,0,3
32587,0,0,2,5,7
32588,0,1,1,6,8
32589,0,1,6,21,28
32590,0,0,14,26,40
32591,0,0,5,22,27
32592,0,1,5,4,10
32593,0,0,8,31,39
32594,0,0,10,18,28
32595,0,0,0,2,2
32596,0,0,2,9,11
32597,0,0,4,6,10
32598,0,0,4,14,18
32599,0,0,3,4,7
32600,0,0,4,3,7
32601,0,1,6,27,34
32602,0,0,14,18,32
32603,0,1,5,10,16
32604,0,4,9,30,43
32605,0,0,1,10,11
32606,0,0,1,10,11
32607,0,0,1,7,8
32608,1,0,3,31,35
32609,0,0,1,11,12
32610,1,0,9,17,27
32611,0,0,3,14,17
32612,0,0,3,10,13
32613,0,0,3,9,12
32614,0,0,3,6,9
32615,0,0,4,10,14
32616,1,0,2,6,9
32617,0,0,0,6,6
32618,0,0,5,3,8
32619,0,0,11,20,31
32620,0,0,4,3,7
32621,0,0,5,5,10
32622,0,0,3,3,6
32623,0,0,6,3,9
32624,0,1,7,12,20
32625,0,0,5,3,8
32626,0,0,9,17,26
32627,1,0,7,22,30
32628,0,0,2,25,27
32629,0,1,4,6,11
32630,0,0,1,5,6
32632,0,0,4,8,12
32633,0,0,1,5,6
32634,0,0,5,8,13
32635,0,0,4,6,10
32636,0,0,5,5,10
32638,0,0,3,4,7
32639,0,0,1,12,13
32641,0,0,5,8,13
32642,0,1,7,16,24
32644,0,0,1,8,9
32645,0,0,12,19,31
32646,0,0,2,4,6
32647,0,0,3,11,14
32648,0,0,1,15,16
32649,0,0,3,9,12
32650,0,1,4,21,26
32651,0,0,4,14,18
32652,0,0,0,14,14
32653,0,0,1,4,5
32654,0,0,5,14,19
32655,3,0,0,6,9
32656,0,2,6,20,28
32657,0,0,5,15,20
32658,1,0,0,30,31
32659,0,3,11,36,50
32660,0,0,5,8,13
32661,0,0,1,6,7
32662,0,1,8,10,19
32664,1,0,11,18,30
32665,0,0,18,32,50
32666,0,0,11,30,41
32667,0,0,6,23,29
32668,0,0,5,6,11
32669,0,0,6,7,13
32670,0,0,5,12,17
32672,0,0,7,12,19
32673,0,0,3,8,11
32674,0,0,2,6,8
32675,0,0,10,32,42
32676,0,0,11,20,31
32677,0,0,1,15,16
32678,0,0,5,12,17
32679,0,0,6,8,14
32680,0,0,5,10,15
32681,0,0,11,20,31
32682,0,1,4,21,26
32683,0,1,7,16,24
32684,0,0,3,7,10
32686,0,0,2,4,6
32687,0,0,4,9,13
32689,0,0,3,18,21
32690,0,0,1,15,16
32691,0,0,6,16,22
32692,0,0,3,7,10
32693,3,0,0,6,9
32694,3,1,10,36,50
32695,1,0,11,18,30
32696,0,0,0,14,14
32697,1,1,1,15,18
32698,0,0,3,9,12
32699,0,0,3,14,17
32701,3,0,0,6,9
32702,0,0,2,4,6
32703,0,0,3,3,6
32704,0,0,5,9,14
32705,0,2,4,12,18
32706,0,0,4,4,8
32707,0,0,3,3,6
32708,0,0,9,19,28
32709,0,0,10,22,32
32710,0,0,1,5,6
32711,0,0,5,25,30
32712,0,0,4,10,14
32713,0,0,7,14,21
32714,0,0,1,5,6
32715,0,0,2,5,7
32716,0,0,3,7,10
32717,0,0,5,13,18
32718,1,1,11,31,44
32719,0,0,5,18,23
32720,1,2,4,7,14
32721,0,0,1,8,9
32722,0,0,12,16,28
32723,0,0,7,6,13
32724,0,1,6,12,19
32725,0,2,9,21,32
32726,0,0,1,16,17
32727,0,0,5,6,11
32728,0,0,2,11,13
32729,0,0,4,19,23
32730,0,0,7,32,39
32731,0,1,7,11,19
32732,0,0,6,12,18
32733,0,0,1,4,5
32734,1,0,4,6,11
32735,0,0,5,11,16
32736,0,3,1,5,9
32737,0,1,6,41,48
32738,0,0,2,4,6
32739,0,0,2,9,11
32740,0,0,1,8,9
32741,0,0,4,7,11
32742,0,0,3,47,50
32743,0,0,7,3,10
32744,0,0,6,16,22
32745,0,0,0,6,6
32746,0,0,0,9,9
32747,0,1,20,28,49
32748,0,0,3,26,29
32749,0,0,9,27,36
32750,0,0,3,7,10
32751,0,0,2,8,10
32752,0,0,4,6,10
32753,0,0,5,11,16
32754,0,0,4,12,16
32755,0,0,5,9,14
32756,0,0,4,13,17
32757,0,0,7,24,31
32759,0,0,3,6,9
32760,0,0,8,25,33
32761,0,0,1,8,9
32763,0,0,2,3,5
32764,0,0,4,9,13
32765,0,0,6,12,18
32766,0,1,9,40,50
32767,0,2,6,13,21
32768,0,0,2,3,5
32769,0,0,2,15,17
32770,0,0,3,13,16
32771,0,1,5,19,25
32772,0,0,4,19,23
32773,0,0,6,32,38
32774,0,0,6,20,26
32775,0,0,3,7,10
32776,0,0,4,10,14
32777,0,2,9,10,21
32778,0,0,4,18,22
32779,0,0,3,4,7
32780,0,0,3,8,11
32781,0,0,3,10,13
32782,0,0,3,2,5
32783,0,0,1,5,6
32785,0,0,1,13,14
32786,1,0,14,28,43
32787,0,0,1,4,5
32788,0,0,1,11,12
32790,0,0,0,5,5
32791,0,0,17,16,33
32792,0,0,4,15,19
32794,1,0,7,25,33
32795,1,1,9,26,37
32796,0,0,1,16,17
32797,0,0,9,26,35
32798,0,0,5,29,34
32799,0,1,17,32,50
32800,0,0,0,10,10
32801,0,0,5,8,13
32802,0,0,9,21,30
32803,0,0,5,21,26
32804,0,0,12,38,50
32805,0,0,9,28,37
32806,1,0,8,17,26
32807,0,0,8,36,44
32808,0,0,2,3,5
32809,0,0,1,5,6
32810,0,0,2,5,7
32811,0,0,8,16,24
32812,0,0,4,20,24
32813,0,1,9,25,35
32814,0,0,2,14,16
32815,1,0,1,15,17
32816,0,0,12,17,29
32817,0,1,7,17,25
32818,0,0,13,13,26
32819,0,0,3,18,21
32820,0,0,4,4,8
32821,0,0,4,10,14
32822,0,0,8,35,43
32823,0,0,13,12,25
32824,0,0,9,27,36
32825,0,0,1,11,12
32826,0,0,3,10,13
32827,0,0,5,18,23
32829,0,2,9,21,32
32830,0,0,4,10,14
32831,0,0,6,12,18
32832,0,0,13,13,26
32833,0,1,17,32,50
32834,1,0,3,45,49
32835,0,0,1,16,17
32836,1,0,0,5,6
32837,0,0,3,11,14
32839,0,0,5,21,26
32840,0,1,2,23,26
32841,0,1,2,4,7
32842,0,1,12,18,31
32843,0,0,5,10,15
32844,1,1,9,27,38
32846,0,0,4,26,30
32847,0,0,3,3,6
32848,0,0,1,5,6
32849,0,0,7,14,21
32850,0,0,3,39,42
32851,0,1,9,13,23
32852,0,0,3,12,15
32853,0,0,3,14,17
32854,0,0,10,20,30
32855,0,0,8,15,23
32856,0,0,17,29,46
32857,0,0,5,15,20
32858,0,1,10,20,31
32859,0,0,11,5,16
32860,0,0,4,16,20
32861,0,0,6,41,47
32862,0,2,10,35,47
32863,0,0,5,43,48
32864,0,0,6,7,13
32865,0,0,2,5,7
32866,0,0,2,9,11
32867,2,0,7,30,39
32868,0,0,0,10,10
32869,0,0,12,17,29
32870,0,0,6,15,21
32871,0,0,2,5,7
32872,0,0,1,18,19
32873,0,0,17,19,36
32874,0,0,5,7,12
32875,0,0,8,13,21
32877,0,0,4,16,20
32878,0,0,4,10,14
32879,0,3,14,23,40
32880,0,0,3,5,8
32881,0,0,0,6,6
32882,0,0,9,23,32
32883,1,0,1,39,41
32884,0,1,4,12,17
32885,0,0,7,28,35
32886,0,0,2,8,10
32887,0,0,6,10,16
32888,0,0,8,12,20
32889,0,0,10,12,22
32890,0,0,2,5,7
32891,0,0,7,7,14
32892,0,0,4,7,11
32893,0,0,12,18,30
32894,1,0,5,30,36
32896,0,0,0,11,11
32897,0,0,5,6,11
32898,0,2,1,31,34
32899,0,0,13,9,22
32900,0,0,6,38,44
32901,0,1,3,8,12
32902,0,0,9,33,42
32903,0,1,2,17,20
32904,0,0,0,5,5
32905,0,1,1,6,8
32906,0,3,11,20,34
32907,0,1,9,20,30
32908,0,0,5,7,12
32909,0,0,5,12,17
32910,0,1,3,14,18
32911,0,0,8,8,16
32912,0,0,1,4,5
32914,0,0,5,21,26
32915,0,0,10,17,27
32916,0,0,5,8,13
32917,0,0,3,3,6
32918,0,1,4,8,13
32919,0,0,3,6,9
32920,0,0,1,4,5
32921,0,1,2,10,13
32922,0,2,1,11,14
32923,0,0,9,23,32
32924,0,0,7,11,18
32925,0,0,0,5,5
32926,0,0,2,11,13
32927,0,0,14,16,30
32928,1,1,7,25,34
32929,1,1,3,9,14
32930,0,1,1,4,6
32931,0,0,5,15,20
32932,0,1,4,11,16
32933,0,0,5,6,11
32934,0,0,4,16,20
32935,6,2,0,42,50
32936,0,0,3,11,14
32937,0,2,14,24,40
32938,0,0,6,3,9
32939,0,0,5,5,10
32940,0,0,0,7,7
32941,0,0,5,28,33
32942,0,0,1,6,7
32943,0,1,9,24,34
32944,0,1,6,10,17
32945,0,0,10,7,17
32946,0,0,8,42,50
32947,0,0,2,24,26
32948,0,0,9,33,42
32949,0,1,3,20,24
32950,0,0,0,3,3
32951,0,0,12,27,39
32952,0,0,2,15,17
32953,0,1,4,9,14
32954,0,0,8,15,23
32955,0,0,0,6,6
32956,0,0,3,12,15
32957,0,1,7,14,22
32958,0,0,1,7,8
32959,0,0,6,12,18
32960,0,0,2,11,13
32961,0,0,3,4,7
32962,0,1,3,17,21
32963,0,0,10,21,31
32964,0,0,2,5,7
32965,0,2,3,15,20
32966,0,2,0,14,16
32967,0,3,11,16,30
32968,0,0,9,10,19
32969,0,0,4,16,20
32972,0,0,5,10,15
32973,0,0,1,1,2
32974,0,0,11,20,31
32975,0,0,8,4,12
32976,0,0,6,32,38
32977,0,0,0,2,2
32978,2,1,3,17,23
32979,1,1,5,31,38
32980,0,0,4,2,6
32981,0,0,6,15,21
32982,0,0,4,24,28
32983,0,0,8,7,15
32984,0,0,1,22,23
32985,0,0,5,5,10
32986,0,2,4,5,11
32987,0,0,4,33,37
32988,0,1,12,22,35
32989,0,0,7,5,12
32991,0,0,2,7,9
32992,0,0,5,4,9
32994,0,0,2,3,5
32995,0,0,11,21,32
32996,0,0,9,14,23
32997,0,1,6,8,15
32998,0,0,3,6,9
32999,0,0,7,10,17
33000,0,0,0,7,7
33001,0,4,0,11,15
33003,0,0,12,38,50
33004,0,1,2,23,26
33005,0,1,7,12,20
33006,0,1,3,23,27
33007,0,0,2,4,6
33008,0,0,10,40,50
33009,1,1,8,38,48
33010,0,0,12,36,48
33011,0,0,7,11,18
33012,0,0,7,19,26
33013,0,0,4,5,9
33014,0,0,4,26,30
33015,0,0,2,13,15
33016,0,0,3,4,7
33017,0,0,6,19,25
33018,0,0,9,18,27
33019,0,0,5,37,42
33020,0,1,7,31,39
33021,0,0,1,29,30
33022,0,1,6,17,24
33023,1,0,3,23,27
33024,0,0,13,27,40
33025,0,0,14,20,34
33026,0,1,5,27,33
33027,0,0,3,11,14
33028,0,0,12,27,39
33029,0,0,3,8,11
33030,0,1,15,19,35
33031,0,0,3,6,9
33032,0,0,14,33,47
33033,0,0,5,7,12
33034,0,3,3,18,24
33035,0,0,8,18,26
33036,0,0,11,16,27
33037,0,1,6,15,22
33038,0,0,13,26,39
33039,0,1,5,11,17
33040,0,0,17,33,50
33041,0,2,2,11,15
33042,0,1,12,37,50
33043,0,0,4,19,23
33044,0,0,3,10,13
33045,0,0,2,3,5
33046,0,0,7,15,22
33047,0,1,14,35,50
33048,0,0,5,19,24
33049,0,0,17,29,46
33050,0,0,12,23,35
33051,0,0,10,20,30
33052,0,0,3,11,14
33053,0,0,2,3,5
33054,0,0,9,36,45
33055,0,0,8,40,48
33056,0,3,12,26,41
33057,0,1,4,34,39
33058,0,0,11,21,32
33059,0,0,8,24,32
33060,0,0,3,22,25
33061,0,0,0,6,6
33062,0,1,0,10,11
33063,0,0,10,9,19
33064,0,0,4,14,18
33065,0,1,6,12,19
33066,0,0,6,11,17
33068,0,0,19,31,50
33069,0,1,4,16,21
33070,0,1,4,14,19
33072,0,1,14,34,49
33073,0,0,0,5,5
33074,0,1,6,8,15
33075,1,0,2,8,11
33076,0,0,12,38,50
33077,0,4,0,11,15
33078,2,1,3,17,23
33079,0,2,0,14,16
33080,0,0,3,2,5
33081,0,1,2,23,26
33082,0,0,4,21,25
33083,0,1,11,21,33
33084,0,0,2,3,5
33085,0,0,1,8,9
33086,0,1,3,23,27
33087,0,0,1,5,6
33088,0,0,3,2,5
33090,0,0,9,41,50
33091,0,0,5,37,42
33092,0,1,6,8,15
33093,0,0,17,29,46
33094,0,1,6,8,15
33095,0,1,2,23,26
33096,0,0,6,10,16
33097,0,0,19,25,44
33098,0,1,13,10,24
33099,0,1,0,8,9
33100,0,1,15,33,49
33101,0,0,9,11,20
33102,1,0,9,9,19
33103,0,0,4,5,9
33104,0,0,9,37,46
33105,0,0,3,11,14
33106,1,2,6,21,30
33107,0,0,4,18,22
33108,0,0,7,10,17
33109,0,0,6,7,13
33110,0,0,4,17,21
33111,0,0,0,5,5
33112,0,0,0,18,18
33113,0,1,1,3,5
33114,0,0,2,18,20
33115,0,1,5,13,19
33116,0,0,3,17,20
33117,0,0,2,3,5
33118,0,0,5,8,13
33119,0,0,11,15,26
33120,1,0,3,10,14
33121,0,0,3,4,7
33122,0,1,12,13,26
33123,0,0,8,12,20
33124,0,1,3,12,16
33125,0,0,4,12,16
33126,0,0,1,4,5
33127,0,0,0,18,18
33128,0,0,7,8,15
33129,0,0,4,3,7
33130,0,0,2,1,3
33131,3,0,0,10,13
33132,1,1,10,34,46
33133,0,0,3,6,9
33134,1,0,1,9,11
33135,0,0,4,11,15
33136,0,0,3,8,11
33137,0,0,1,6,7
33138,0,0,5,21,26
33139,0,1,4,15,20
33140,0,1,7,12,20
33142,0,0,1,4,5
33143,1,0,0,4,5
33144,0,0,4,12,16
33145,0,0,0,5,5
33146,0,0,6,7,13
33147,1,1,3,14,19
33148,0,0,0,5,5
33149,0,0,11,12,23
33150,0,0,11,38,49
33151,0,0,8,25,33
33152,0,0,3,4,7
33153,0,0,6,12,18
33154,0,1,16,26,43
33155,0,0,5,19,24
33156,0,0,11,22,33
33157,0,0,11,38,49
33158,0,0,6,17,23
33159,0,0,0,18,18
33160,0,0,5,15,20
33161,0,0,2,23,25
33162,0,0,14,26,40
33164,0,0,2,10,12
33165,0,0,14,28,42
33166,0,1,1,12,14
33167,0,0,2,7,9
33168,0,0,11,12,23
33169,0,1,9,38,48
33170,0,0,2,2,4
33171,0,0,0,5,5
33172,0,0,6,12,18
33173,1,1,3,14,19
33175,0,1,7,12,20
33176,0,0,2,10,12
33177,1,0,1,13,15
33178,0,0,3,8,11
33179,1,0,1,19,21
33180,1,1,3,14,19
33181,0,0,2,18,20
33182,0,0,5,19,24
33183,1,0,0,4,5
33184,0,0,14,20,34
33186,0,0,8,12,20
33187,0,0,8,24,32
33188,0,0,5,10,15
33189,0,1,0,8,9
33190,0,0,15,35,50
33191,0,1,6,9,16
33192,0,0,9,19,28
33193,0,0,5,15,20
33194,0,0,1,6,7
33195,0,0,2,10,12
33196,0,1,5,5,11
33197,0,0,0,7,7
33198,0,0,6,18,24
33199,0,0,12,26,38
33200,1,1,11,32,45
33201,0,2,15,11,28
33202,0,0,7,14,21
33204,0,0,3,10,13
33205,1,0,1,6,8
33206,1,0,12,31,44
33207,1,0,2,14,17
33208,0,0,4,22,26
33209,0,0,2,6,8
33210,1,0,15,32,48
33211,0,0,7,6,13
33212,1,1,2,1,5
33213,1,1,4,33,39
33214,0,0,11,12,23
33215,0,0,13,30,43
33216,0,1,13,36,50
33217,0,0,5,10,15
33218,0,0,4,3,7
33219,0,0,13,16,29
33220,0,0,4,38,42
33221,0,0,1,10,11
33222,0,0,0,5,5
33223,0,0,4,6,10
33224,0,1,14,24,39
33225,0,2,8,24,34
33226,0,0,5,12,17
33227,0,0,1,5,6
33229,0,1,3,17,21
33230,1,0,6,13,20
33231,1,0,2,11,14
33232,1,0,6,38,45
33233,0,0,1,13,14
33234,1,1,15,27,44
33235,0,0,3,4,7
33236,0,0,1,15,16
33237,0,0,3,7,10
33238,0,0,0,14,14
33239,0,1,3,11,15
33240,0,0,1,8,9
33242,0,0,5,9,14
33243,0,0,1,2,3
33244,0,1,5,4,10
33245,0,0,6,10,16
33246,0,0,2,6,8
33247,0,1,1,17,19
33248,0,0,0,19,19
33249,0,1,13,31,45
33250,0,1,4,8,13
33251,0,0,1,3,4
33253,0,0,3,17,20
33254,0,1,3,17,21
33255,0,0,2,7,9
33256,2,0,9,39,50
33257,0,0,5,5,10
33258,0,0,10,8,18
33259,2,4,5,38,49
33260,0,0,5,25,30
33261,0,0,8,21,29
33262,1,0,3,19,23
33263,0,0,2,1,3
33264,0,0,2,5,7
33265,0,0,0,13,13
33266,0,0,8,8,16
33267,0,0,5,15,20
33268,0,1,7,10,18
33269,0,2,5,43,50
33270,0,0,5,5,10
33271,0,0,11,37,48
33272,0,0,8,14,22
33273,0,0,10,17,27
33274,0,0,9,9,18
33278,0,1,4,20,25
33279,0,0,5,8,13
33280,0,0,2,2,4
33281,0,0,9,41,50
33282,0,0,6,17,23
33283,0,0,3,3,6
33284,1,0,4,43,48
33285,0,0,6,16,22
33286,0,0,0,9,9
33287,0,0,1,9,10
33288,0,0,1,6,7
33289,1,0,5,22,28
33290,0,3,2,45,50
33291,0,0,1,6,7
33292,1,0,7,32,40
33294,1,0,6,13,20
33295,0,0,0,6,6
33296,0,0,1,5,6
33297,0,0,5,8,13
33298,0,0,1,7,8
33299,0,0,3,7,10
33300,1,0,7,19,27
33302,0,0,1,7,8
33305,1,0,2,16,19
33307,0,0,2,3,5
33308,0,0,2,19,21
33309,0,0,9,27,36
33310,0,0,5,9,14
33311,0,0,4,10,14
33312,0,1,16,30,47
33313,0,0,1,5,6
33314,0,2,9,21,32
33317,0,1,7,12,20
33318,0,0,1,10,11
33319,1,0,10,29,40
33320,0,0,15,20,35
33321,0,0,13,37,50
33322,0,0,16,34,50
33323,0,2,17,30,49
33324,1,2,2,42,47
33325,0,1,5,18,24
33326,0,1,6,9,16
33327,0,2,11,13,26
33328,0,0,8,22,30
33329,0,0,16,21,37
33330,0,0,17,31,48
33331,1,1,8,18,28
33332,0,1,16,30,47
33333,0,2,9,21,32
33334,0,0,3,12,15
33335,0,0,20,30,50
33336,1,1,2,11,15
33337,0,0,11,18,29
33338,1,0,3,22,26
33339,1,0,18,30,49
33340,0,2,10,31,43
33341,1,0,6,12,19
33342,0,0,5,18,23
33343,0,0,3,14,17
33344,0,0,6,13,19
33345,0,2,3,33,38
33346,0,1,3,46,50
33347,0,0,9,27,36
33348,0,0,6,8,14
33349,0,1,16,14,31
33350,0,0,3,8,11
33351,1,1,4,18,24
33352,1,0,3,17,21
33353,0,0,5,18,23
33354,0,0,6,6,12
33355,0,0,0,8,8
33356,0,0,0,7,7
33357,0,0,2,10,12
33358,0,1,6,9,16
33359,0,1,4,24,29
33360,0,0,2,4,6
33362,0,0,8,23,31
33363,0,0,4,6,10
33364,0,0,14,36,50
33365,0,0,4,10,14
33366,0,0,2,6,8
33367,1,0,2,18,21
33368,0,1,5,17,23
33369,2,0,9,39,50
33370,0,1,7,12,20
33371,0,0,1,10,11
33372,0,0,2,19,21
33373,0,0,13,25,38
33374,0,0,1,5,6
33375,0,0,11,12,23
33376,0,0,3,10,13
33377,0,1,10,39,50
33378,0,0,0,5,5
33379,0,0,6,8,14
33380,1,2,2,42,47
33381,0,0,8,22,30
33382,0,0,3,18,21
33384,0,1,3,46,50
33385,0,2,8,24,34
33386,0,1,3,46,50
33387,0,1,5,18,24
33388,0,2,11,13,26
33389,0,1,1,5,7
33390,2,2,1,24,29
33391,0,2,9,36,47
33392,0,0,6,9,15
33393,2,2,1,24,29
33394,3,0,1,12,16
33395,0,1,3,26,30
33396,3,0,1,12,16
33397,2,2,1,24,29
33398,0,1,3,26,30
33399,0,0,8,7,15
33400,1,1,1,21,24
33401,1,0,2,2,5
33402,0,0,2,5,7
33403,0,0,5,8,13
33404,1,2,7,27,37
33405,0,7,2,9,18
33406,0,0,1,4,5
33407,0,1,2,14,17
33408,3,0,6,18,27
33409,0,0,3,16,19
33410,0,0,3,6,9
33411,2,0,3,13,18
33412,2,3,5,38,48
33413,0,0,3,8,11
33414,0,0,7,9,16
33415,0,7,4,24,35
33416,1,0,2,2,5
33417,0,2,3,3,8
33418,3,1,1,17,22
33419,0,0,2,7,9
33420,0,0,1,5,6
33422,0,1,8,25,34
33424,0,3,7,8,18
33425,1,1,1,16,19
33426,0,0,5,4,9
33427,0,0,10,18,28
33428,0,0,9,12,21
33429,0,0,1,4,5
33430,0,0,7,13,20
33431,0,0,2,4,6
33433,0,2,0,4,6
33434,0,0,12,33,45
33435,0,0,2,17,19
33436,0,1,0,4,5
33437,0,0,4,20,24
33438,0,0,4,2,6
33439,0,0,11,21,32
33440,0,0,1,6,7
33441,0,0,3,14,17
33443,0,2,5,1,8
33444,1,1,3,33,38
33445,1,3,3,18,25
33446,2,2,1,24,29
33447,1,1,3,12,17
33448,0,0,1,5,6
33449,0,0,1,4,5
33450,7,1,4,38,50
33451,0,0,9,9,18
33452,0,0,15,35,50
33453,0,3,8,30,41
33454,0,1,3,26,30
33455,5,0,1,23,29
33456,0,0,11,21,32
33457,0,0,0,5,5
33458,0,0,12,33,45
33459,0,0,12,15,27
33460,6,3,5,33,47
33462,0,0,3,16,19
33463,0,1,10,19,30
33464,0,3,6,21,30
33465,0,0,6,19,25
33466,1,0,1,7,9
33467,0,3,5,19,27
33468,0,7,4,24,35
33469,0,0,0,5,5
33470,2,3,5,38,48
33471,1,0,2,2,5
33472,2,2,1,24,29
33473,1,1,3,12,17
33474,1,3,3,18,25
33475,0,0,13,29,42
33477,6,3,5,33,47
33478,0,1,0,16,17
33479,0,0,13,29,42
33480,1,0,1,7,9
33481,7,1,4,38,50
33482,0,0,10,19,29
33483,1,1,3,12,17
33484,6,3,5,33,47
33485,1,1,3,33,38
33486,0,0,3,16,19
33487,6,3,5,33,47
33488,8,0,1,12,21
33489,6,3,5,33,47
33490,1,1,3,33,38
33492,0,2,3,2,7
33493,0,0,19,27,46
33494,0,1,2,19,22
33495,8,0,1,12,21
33496,0,0,5,8,13
33497,0,1,3,26,30
33498,0,2,5,1,8
33499,1,2,7,26,36
33500,0,0,2,17,19
33501,1,4,2,5,12
33502,6,3,5,33,47
33503,2,2,1,24,29
33504,1,1,3,12,17
33505,0,0,13,29,42
33506,0,0,10,18,28
33507,0,0,1,4,5
33508,0,0,0,5,5
33510,0,0,6,8,14
33511,0,0,5,7,12
33512,0,0,8,19,27
33513,0,0,2,5,7
33514,0,0,2,17,19
33515,0,0,5,13,18
33516,0,0,2,4,6
33517,2,0,3,13,18
33518,0,0,11,21,32
33519,0,0,5,1,6
33520,0,0,12,14,26
33521,0,1,7,10,18
33522,0,0,4,9,13
33523,1,4,12,33,50
33524,1,3,3,21,28
33525,1,2,7,27,37
33526,0,3,10,29,42
33527,0,0,15,21,36
33528,0,1,8,34,43
33529,0,0,6,9,15
33530,0,1,3,8,12
33531,0,1,4,20,25
33532,0,0,12,33,45
33533,0,0,6,16,22
33534,1,1,14,29,45
33535,0,0,6,2,8
33536,0,1,6,20,27
33537,0,1,5,12,18
33538,0,0,3,8,11
33539,0,0,13,22,35
33540,0,0,15,22,37
33541,0,0,3,9,12
33542,0,0,5,12,17
33543,0,0,7,8,15
33544,0,0,8,9,17
33545,0,0,9,16,25
33546,0,0,3,4,7
33547,0,0,8,4,12
33548,0,0,11,17,28
33549,0,2,8,21,31
33550,0,0,1,3,4
33551,0,0,7,13,20
33552,0,1,5,19,25
33554,0,0,3,5,8
33555,0,4,12,23,39
33557,0,0,2,4,6
33558,0,0,11,13,24
33559,0,0,8,11,19
33560,0,0,9,5,14
33561,0,1,6,8,15
33562,0,0,10,15,25
33563,0,0,10,17,27
33564,0,0,1,4,5
33565,0,0,1,13,14
33566,0,0,10,26,36
33567,0,0,11,25,36
33568,0,6,0,10,16
33569,0,0,3,8,11
33570,0,2,6,13,21
33571,2,7,1,12,22
33572,0,0,8,11,19
33573,0,0,2,4,6
33574,1,1,6,24,32
33575,0,1,0,7,8
33576,0,0,4,11,15
33577,0,0,0,13,13
33578,0,0,4,7,11
33579,0,0,3,7,10
33580,0,0,9,14,23
33581,0,0,8,12,20
33582,0,0,0,5,5
33583,0,1,2,5,8
33584,1,0,2,7,10
33585,0,0,6,3,9
33586,0,0,1,4,5
33587,0,0,10,25,35
33588,1,0,2,18,21
33589,0,0,5,14,19
33590,0,0,4,3,7
33591,0,0,7,8,15
33592,1,1,3,12,17
33593,0,2,9,11,22
33594,0,0,11,18,29
33595,0,0,1,4,5
33596,1,0,3,10,14
33597,0,1,1,5,7
33598,0,0,0,5,5
33600,0,0,4,12,16
33602,0,0,2,8,10
33603,1,1,8,17,27
33604,0,1,11,17,29
33605,0,0,5,14,19
33606,0,0,1,7,8
33607,0,0,4,4,8
33608,0,0,2,4,6
33609,0,0,3,4,7
33610,0,0,4,16,20
33611,0,0,0,3,3
33612,2,3,5,38,48
33613,1,1,3,33,38
33614,0,0,9,22,31
33615,0,7,4,24,35
33616,0,0,5,9,14
33617,1,1,3,12,17
33618,0,0,5,8,13
33619,0,1,0,4,5
33620,0,5,3,42,50
33621,3,1,3,16,23
33622,1,3,3,18,25
33623,0,0,7,6,13
33624,0,0,1,9,10
33625,0,0,10,29,39
33626,3,1,8,38,50
33627,0,0,13,35,48
33628,0,0,10,23,33
33629,0,0,3,7,10
33630,0,0,3,11,14
33631,0,1,3,26,30
33632,1,0,5,25,31
33633,0,2,9,17,28
33634,0,0,11,16,27
33635,0,0,7,6,13
33636,3,2,0,6,11
33637,0,2,3,16,21
33638,0,2,13,15,30
33639,0,0,2,9,11
33640,1,0,0,5,6
33641,0,0,6,7,13
33642,0,1,6,21,28
33643,0,0,8,19,27
33644,0,0,7,9,16
33645,0,0,8,7,15
33647,0,0,10,18,28
33648,0,0,4,16,20
33649,6,3,5,33,47
33650,3,1,3,16,23
33651,0,0,5,9,14
33652,0,0,12,33,45
33653,0,0,11,21,32
33654,0,0,2,6,8
33655,0,0,0,3,3
33656,1,3,3,18,25
33657,2,3,5,38,48
33658,4,0,4,28,36
33659,0,7,4,24,35
33660,0,0,1,9,10
33661,1,1,3,12,17
33662,0,0,1,7,8
33663,1,0,2,18,21
33664,1,0,3,10,14
33665,1,0,2,18,21
33666,0,0,1,9,10
33667,0,0,0,8,8
33668,6,3,5,33,47
33670,0,0,8,8,16
33671,1,1,3,33,38
33672,1,1,3,12,17
33673,0,0,3,11,14
33674,6,3,5,33,47
33675,3,1,3,16,23
33676,6,3,5,33,47
33677,0,0,13,35,48
33678,6,3,5,33,47
33679,3,1,3,16,23
33680,0,0,9,22,31
33681,0,0,7,6,13
33682,1,1,3,33,38
33683,1,4,19,24,48
33684,0,0,10,29,39
33685,0,0,9,22,31
33686,0,1,3,26,30
33687,6,3,5,33,47
33688,0,0,5,8,13
33689,0,0,1,4,5
33690,1,1,3,12,17
33691,0,0,2,17,19
33692,0,0,4,16,20
33693,0,0,1,7,8
33694,0,0,8,17,25
33695,1,0,2,2,5
33696,0,0,9,17,26
33698,0,0,0,8,8
33699,0,2,11,31,44
33700,0,0,5,17,22
33701,0,0,4,18,22
33702,1,1,10,28,40
33703,0,0,3,10,13
33704,0,0,1,7,8
33705,0,1,2,3,6
33706,0,0,6,18,24
33707,0,0,6,8,14
33708,0,0,9,11,20
33709,0,0,5,14,19
33710,0,0,5,9,14
33711,0,0,11,20,31
33712,0,2,5,23,30
33713,0,0,10,17,27
33714,0,2,6,17,25
33715,0,0,0,3,3
33716,0,0,8,17,25
33717,0,0,11,19,30
33718,0,0,2,6,8
33719,0,0,7,16,23
33720,0,1,6,6,13
33721,0,0,2,7,9
33722,0,2,4,22,28
33723,0,0,6,13,19
33724,0,0,2,11,13
33725,0,0,10,13,23
33726,0,0,5,19,24
33727,0,0,6,37,43
33728,0,0,5,10,15
33729,1,1,3,33,38
33730,0,1,15,34,50
33731,0,2,2,18,22
33732,0,0,4,12,16
33733,0,2,10,23,35
33734,0,2,5,1,8
33735,0,0,13,28,41
33737,0,0,3,5,8
33738,0,0,6,11,17
33739,0,0,3,9,12
33740,0,0,8,17,25
33741,0,0,5,4,9
33742,0,1,6,6,13
33743,0,0,8,6,14
33744,2,1,2,8,13
33745,1,4,7,9,21
33746,0,2,5,6,13
33747,0,0,4,9,13
33748,0,0,4,1,5
33749,0,0,2,7,9
33750,0,0,0,3,3
33751,0,0,11,10,21
33752,0,0,5,4,9
33753,0,0,8,1,9
33754,0,0,3,14,17
33755,0,0,3,6,9
33756,0,0,1,4,5
33757,2,0,7,29,38
33758,2,0,2,6,10
33759,2,2,1,24,29
33760,1,0,4,15,20
33761,0,0,8,20,28
33762,0,0,7,6,13
33763,2,2,0,46,50
33764,1,1,3,12,17
33765,0,1,5,14,20
33766,1,0,2,2,5
33767,0,0,14,36,50
33768,0,0,3,14,17
33769,1,0,0,5,6
33770,0,1,9,16,26
33771,0,0,1,17,18
33772,2,0,16,32,50
33773,2,0,7,29,38
33774,0,0,13,18,31
33775,1,1,7,27,36
33776,0,1,2,21,24
33777,0,0,9,17,26
33778,1,1,10,28,40
33779,0,5,1,12,18
33781,0,0,7,27,34
33782,2,2,1,24,29
33783,0,0,0,6,6
33784,0,0,6,23,29
33785,0,0,2,8,10
33787,2,0,0,5,7
33788,1,0,14,21,36
33789,0,0,1,5,6
33790,2,0,2,6,10
33791,1,0,2,2,5
33792,0,0,5,10,15
33793,0,2,11,31,44
33794,0,1,2,5,8
33795,1,0,2,5,8
33797,1,1,3,12,17
33798,0,0,14,34,48
33799,1,0,2,5,8
33800,4,0,1,25,30
33801,4,0,9,37,50
33802,1,2,2,16,21
33803,1,0,15,31,47
33804,2,0,12,32,46
33805,0,0,4,3,7
33806,0,0,16,34,50
33807,1,0,17,29,47
33808,4,0,1,25,30
33809,1,1,3,12,17
33810,1,0,0,5,6
33811,1,1,3,33,38
33812,0,0,10,19,29
33813,4,0,9,37,50
33814,1,1,3,33,38
33815,0,0,7,6,13
33816,0,1,9,16,26
33817,1,1,3,12,17
33818,2,2,1,24,29
33819,0,2,5,1,8
33820,0,0,3,9,12
33821,0,0,3,4,7
33822,0,0,2,3,5
33824,0,1,6,11,18
33825,0,0,1,11,12
33826,0,0,4,15,19
33827,0,3,2,17,22
33828,0,0,6,21,27
33829,0,0,5,19,24
33830,0,0,7,43,50
33831,0,0,7,24,31
33832,0,0,0,5,5
33833,0,1,3,6,10
33834,0,0,1,5,6
33835,0,0,6,10,16
33836,1,0,0,8,9
33837,0,0,4,5,9
33838,0,0,9,14,23
33839,0,0,5,13,18
33840,0,0,4,9,13
33841,0,1,17,32,50
33842,0,2,7,15,24
33843,3,0,7,40,50
33844,0,0,0,5,5
33845,0,0,6,10,16
33846,0,0,3,9,12
33847,0,0,16,11,27
33848,1,0,2,15,18
33849,0,0,8,6,14
33850,0,0,6,10,16
33851,0,0,6,10,16
33853,0,0,5,3,8
33855,0,1,7,14,22
33856,0,0,4,8,12
33857,0,0,8,23,31
33858,0,0,3,4,7
33859,0,0,4,16,20
33860,0,0,6,8,14
33861,0,0,6,19,25
33862,0,0,1,16,17
33863,1,3,3,18,25
33864,0,2,9,36,47
33865,0,0,10,19,29
33866,0,0,7,10,17
33867,0,1,10,39,50
33868,3,0,4,16,23
33869,0,0,6,2,8
33870,0,0,4,5,9
33872,2,2,9,34,47
33873,0,0,3,9,12
33874,0,2,7,33,42
33875,2,1,9,38,50
33876,0,0,11,14,25
33877,1,0,2,7,10
33878,0,0,11,16,27
33879,1,0,8,24,33
33880,1,0,7,8,16
33881,1,0,0,8,9
33882,2,0,10,31,43
33883,0,1,7,14,22
33884,1,3,3,18,25
33885,0,0,4,16,20
33886,0,1,6,43,50
33887,1,0,2,7,10
33888,0,1,10,39,50
33889,2,2,9,34,47
33890,0,0,0,4,4
33891,1,1,7,35,44
33893,0,0,5,3,8
33894,0,0,4,16,20
33895,0,0,0,11,11
33896,0,0,6,4,10
33897,0,0,4,9,13
33898,1,2,14,33,50
33899,1,0,5,11,17
33900,3,1,6,26,36
33901,0,0,1,8,9
33902,0,1,7,13,21
33903,0,0,5,10,15
33905,0,3,2,18,23
33906,0,0,6,5,11
33907,0,2,11,28,41
33908,0,0,4,6,10
33909,0,0,2,6,8
33910,0,0,9,15,24
33911,1,1,17,31,50
33912,0,0,1,6,7
33913,0,0,1,6,7
33914,0,0,2,1,3
33915,0,0,7,8,15
33916,0,0,0,4,4
33917,2,0,2,30,34
33918,0,1,11,24,36
33920,1,1,8,6,16
33921,1,0,0,8,9
33922,0,3,8,25,36
33923,0,0,13,37,50
33924,1,0,1,8,10
33925,2,0,2,30,34
33926,0,0,10,37,47
33927,0,0,1,5,6
33928,0,0,9,15,24
33929,0,0,3,28,31
33930,0,0,13,17,30
33932,1,0,9,30,40
33933,1,0,10,17,28
33935,1,0,9,30,40
33936,0,0,3,4,7
33937,1,0,2,2,5
33938,0,2,11,29,42
33940,0,3,8,21,32
33941,0,4,9,37,50
33942,0,1,15,33,49
33943,0,3,10,20,33
33944,0,0,10,27,37
33945,1,1,3,24,29
33946,0,0,3,5,8
33947,0,0,5,10,15
33948,0,0,2,7,9
33949,0,2,11,36,49
33950,0,0,10,19,29
33951,0,1,5,22,28
33952,0,0,6,12,18
33953,1,0,19,21,41
33954,0,0,6,9,15
33955,0,0,1,9,10
33956,0,0,13,31,44
33957,2,0,0,17,19
33958,0,0,6,11,17
33959,1,0,9,27,37
33960,0,0,10,29,39
33961,0,3,7,28,38
33962,0,1,21,28,50
33963,0,0,7,24,31
33964,0,0,7,35,42
33965,0,0,8,13,21
33966,0,0,8,29,37
33967,2,9,1,19,31
33968,0,0,1,17,18
33970,0,0,15,30,45
33971,0,0,5,4,9
33972,0,0,4,11,15
33973,0,0,7,8,15
33974,0,1,1,9,11
33975,0,0,9,22,31
33976,0,0,6,27,33
33977,0,0,10,20,30
33978,0,0,11,21,32
33979,0,3,10,20,33
33980,0,0,14,31,45
33981,0,1,3,7,11
33982,0,0,0,13,13
33983,1,0,7,39,47
33984,0,0,3,7,10
33985,0,0,7,12,19
33986,0,0,1,7,8
33987,0,0,7,16,23
33988,2,0,9,20,31
33989,0,0,3,5,8
33990,0,0,2,4,6
33991,0,0,5,8,13
33992,0,0,1,5,6
33993,0,0,7,11,18
33994,0,0,5,5,10
33995,0,0,4,1,5
33996,0,0,2,4,6
33997,0,0,5,8,13
33998,0,0,4,4,8
33999,0,0,2,3,5
34000,1,1,21,25,48
34001,1,0,0,8,9
34002,1,3,3,18,25
34003,0,0,1,9,10
34004,1,0,2,2,5
34005,0,2,11,31,44
34006,0,0,4,20,24
34007,0,0,3,4,7
34008,4,1,7,27,39
34009,0,0,4,29,33
34011,0,1,4,12,17
34012,0,2,11,31,44
34013,1,2,16,19,38
34014,1,5,10,31,47
34015,0,0,7,14,21
34016,0,0,8,41,49
34017,0,0,10,23,33
34018,1,5,2,41,49
34019,0,0,8,36,44
34020,1,1,2,31,35
34021,1,0,5,20,26
34022,1,0,0,8,9
34023,0,0,15,23,38
34024,0,1,13,25,39
34025,0,0,4,11,15
34026,1,0,9,18,28
34027,0,0,11,31,42
34028,0,0,15,25,40
34029,0,0,5,14,19
34030,2,1,10,36,49
34031,1,0,5,18,24
34032,0,1,7,33,41
34033,5,3,3,24,35
34034,0,0,9,29,38
34035,1,1,10,38,50
34036,0,0,9,23,32
34037,2,4,14,26,46
34038,0,0,6,9,15
34039,1,0,3,17,21
34040,0,0,1,5,6
34041,1,0,2,5,8
34042,5,0,3,10,18
34043,0,0,13,29,42
34044,0,3,7,28,38
34045,0,4,9,37,50
34046,1,0,2,2,5
34047,2,1,9,34,46
34048,1,3,3,18,25
34049,0,0,1,9,10
34050,0,0,3,24,27
34051,1,0,2,5,8
34052,0,0,1,9,10
34053,4,0,9,37,50
34054,0,2,9,25,36
34055,1,1,2,31,35
34056,0,0,13,29,42
34057,2,0,6,15,23
34058,2,0,10,38,50
34059,0,0,0,11,11
34060,0,0,9,15,24
34061,1,0,16,31,48
34062,0,1,4,12,17
34063,0,0,1,20,21
34064,4,0,9,37,50
34065,0,0,9,22,31
34066,0,0,9,22,31
34067,1,1,21,25,48
34068,0,0,13,29,42
34069,0,0,5,5,10
34070,0,1,7,11,19
34071,0,0,0,7,7
34072,0,0,2,28,30
34073,1,0,4,28,33
34074,0,0,1,12,13
34075,0,0,8,19,27
34076,0,1,7,13,21
34077,0,0,5,4,9
34078,0,0,9,12,21
34080,2,3,5,38,48
34081,0,0,4,16,20
34082,0,0,3,2,5
34084,1,0,3,10,14
34085,3,1,3,43,50
34086,1,1,18,30,50
34087,0,0,10,31,41
34088,0,0,4,16,20
34089,0,0,10,18,28
34090,1,0,3,25,29
34091,0,0,1,8,9
34092,0,0,14,35,49
34093,0,0,7,11,18
34094,0,0,9,15,24
34095,2,3,5,38,48
34096,1,0,3,10,14
34097,0,0,8,8,16
34098,0,0,2,6,8
34099,0,1,11,27,39
34100,0,0,3,22,25
34101,0,0,0,12,12
34102,2,0,9,28,39
34103,0,0,7,8,15
34104,0,0,1,5,6
34105,0,0,4,16,20
34106,5,0,3,28,36
34107,0,0,1,6,7
34108,0,0,16,16,32
34109,0,1,8,15,24
34111,0,1,6,36,43
34112,0,0,1,9,10
34114,0,1,2,7,10
34116,0,1,7,5,13
34117,0,0,6,13,19
34118,0,2,3,17,22
34119,7,0,0,11,18
34120,0,4,12,34,50
34121,2,0,5,14,21
34122,0,1,4,33,38
34123,1,0,9,27,37
34124,2,0,7,29,38
34126,0,1,10,15,26
34127,0,0,7,9,16
34128,0,0,1,7,8
34129,0,0,0,8,8
34130,0,1,7,12,20
34131,1,0,4,13,18
34132,0,0,6,13,19
34133,0,0,3,8,11
34134,0,0,8,7,15
34135,0,0,4,10,14
34136,1,0,0,6,7
34137,0,0,4,14,18
34138,0,0,3,3,6
34139,0,1,11,24,36
34140,4,1,1,8,14
34141,0,1,7,9,17
34142,1,10,5,18,34
34143,0,0,6,7,13
34144,0,0,10,25,35
34145,0,1,7,39,47
34146,0,3,7,28,38
34148,3,1,3,23,30
34149,0,0,3,16,19
34151,0,0,3,2,5
34152,0,0,10,30,40
34153,0,0,0,5,5
34154,0,0,8,19,27
34155,0,0,20,30,50
34156,0,0,18,32,50
34157,1,2,2,42,47
34158,0,1,1,18,20
34159,0,0,3,16,19
34160,0,0,15,24,39
34161,3,0,3,23,29
34162,0,0,7,8,15
34163,3,0,3,37,43
34164,0,0,4,8,12
34165,0,3,7,28,38
34166,0,0,10,35,45
34167,0,1,3,26,30
34168,0,2,15,26,43
34169,2,0,6,35,43
34170,5,1,1,27,34
34171,0,0,2,11,13
34172,0,1,1,28,30
34173,0,0,4,16,20
34174,1,1,6,15,23
34175,1,1,9,39,50
34176,0,0,2,24,26
34177,0,0,4,4,8
34179,3,0,1,12,16
34180,0,0,6,10,16
34181,0,1,8,40,49
34182,2,1,1,17,21
34185,0,0,12,33,45
34186,5,0,3,18,26
34187,0,0,0,9,9
34188,0,2,10,37,49
34189,0,0,0,15,15
34190,0,0,10,3,13
34191,0,1,6,39,46
34192,0,0,15,30,45
34193,1,10,5,18,34
34194,2,0,7,29,38
34195,3,1,3,23,30
34197,0,1,3,26,30
34198,0,0,2,34,36
34199,0,0,20,30,50
34201,3,0,7,22,32
34202,4,1,2,35,42
34203,3,1,7,20,31
34204,3,0,3,23,29
34205,0,0,10,15,25
34206,1,2,2,42,47
34207,1,1,9,39,50
34208,5,1,1,27,34
34209,3,1,3,23,30
34210,4,0,1,25,30
34211,0,1,6,39,46
34212,5,0,3,18,26
34213,4,0,1,25,30
34214,1,0,5,15,21
34215,0,0,3,16,19
34216,3,0,1,12,16
34218,0,1,3,26,30
34219,0,0,10,12,22
34220,0,2,3,13,18
34221,0,0,7,10,17
34222,0,1,1,14,16
34223,0,0,12,38,50
34224,1,0,7,14,22
34225,0,1,5,5,11
34226,0,0,3,11,14
34227,0,1,2,10,13
34228,0,1,3,10,14
34230,0,0,2,5,7
34231,0,0,1,9,10
34232,0,6,4,30,40
34233,0,3,4,10,17
34234,0,1,2,8,11
34235,0,0,12,32,44
34236,0,1,2,8,11
34238,0,6,4,30,40
34239,0,0,7,22,29
34240,0,0,12,32,44
34241,0,6,4,30,40
34242,0,6,4,30,40
34243,0,1,2,8,11
34244,5,1,5,26,37
34245,0,0,10,13,23
34246,1,2,2,9,14
34247,0,0,3,13,16
34248,0,0,2,9,11
34249,0,0,2,18,20
34250,0,0,6,4,10
34251,0,0,7,15,22
34252,0,0,8,12,20
34253,0,0,0,7,7
34254,0,0,3,15,18
34255,0,0,6,10,16
34256,0,0,15,24,39
34257,0,0,7,12,19
34258,0,0,5,22,27
34259,0,0,12,13,25
34260,0,0,9,7,16
34261,0,0,5,31,36
34262,0,0,4,9,13
34263,0,1,2,7,10
34264,0,2,1,15,18
34265,0,0,6,20,26
34266,0,0,5,17,22
34267,0,5,3,12,20
34268,0,0,6,2,8
34269,0,0,2,13,15
34270,0,0,4,10,14
34271,0,0,13,18,31
34273,0,0,7,17,24
34274,0,0,2,9,11
34275,1,1,4,42,48
34276,0,0,7,24,31
34277,1,2,11,24,38
34278,0,0,5,0,5
34279,0,0,5,21,26
34280,0,0,8,31,39
34281,0,1,3,8,12
34282,0,0,6,12,18
34283,0,0,5,8,13
34284,0,0,7,12,19
34285,0,1,14,35,50
34286,0,2,8,16,26
34287,0,0,14,17,31
34288,0,0,4,14,18
34289,0,0,3,3,6
34290,4,1,4,41,50
34291,0,0,7,10,17
34292,0,0,2,9,11
34293,1,1,5,8,15
34295,0,0,4,8,12
34296,0,1,3,12,16
34297,0,1,9,16,26
34298,0,0,9,39,48
34299,0,0,6,20,26
34300,0,0,6,8,14
34301,0,0,4,9,13
34302,0,0,2,14,16
34303,0,1,4,6,11
34304,0,3,18,29,50
34305,0,1,7,28,36
34306,0,1,11,38,50
34307,1,0,7,15,23
34308,0,0,8,17,25
34309,0,0,4,20,24
34310,0,1,13,25,39
34311,0,1,3,17,21
34312,0,1,5,2,8
34313,0,0,9,20,29
34314,0,1,4,11,16
34315,0,0,4,5,9
34316,1,0,4,8,13
34317,0,0,12,33,45
34318,0,0,5,15,20
34319,0,0,2,5,7
34320,0,0,2,3,5
34321,0,0,4,8,12
34322,0,0,0,5,5
34323,0,0,2,8,10
34324,0,0,7,9,16
34325,0,0,8,17,25
34327,0,1,0,9,10
34328,0,1,2,7,10
34329,0,0,3,13,16
34330,0,0,5,24,29
34332,0,0,5,10,15
34333,0,0,2,2,4
34334,0,1,5,2,8
34335,1,3,3,23,30
34336,0,0,5,1,6
34337,0,0,5,6,11
34338,0,0,2,8,10
34339,0,0,3,14,17
34340,1,1,15,33,50
34341,0,0,5,4,9
34342,0,2,2,11,15
34343,0,0,4,17,21
34344,3,1,2,7,13
34345,0,0,10,11,21
34346,0,0,2,7,9
34347,0,0,1,9,10
34348,0,2,7,14,23
34349,0,1,5,24,30
34350,0,2,7,21,30
34351,0,0,2,4,6
34352,0,0,2,13,15
34354,0,0,0,3,3
34355,0,0,9,21,30
34356,0,0,5,5,10
34357,0,0,2,8,10
34358,0,0,7,8,15
34359,0,0,6,32,38
34360,0,0,2,19,21
34361,0,3,8,16,27
34362,0,0,7,12,19
34363,0,1,7,19,27
34364,0,0,8,21,29
34365,0,0,5,9,14
34366,0,0,5,11,16
34367,0,0,3,7,10
34368,0,0,1,5,6
34369,0,0,2,3,5
34370,0,0,13,9,22
34371,0,0,5,6,11
34372,0,0,4,4,8
34375,1,2,2,9,14
34376,0,0,5,4,9
34377,0,0,3,32,35
34378,0,2,6,5,13
34379,0,0,2,2,4
34380,0,0,5,6,11
34381,0,0,4,9,13
34382,0,0,3,5,8
34384,0,0,9,11,20
34385,0,0,1,6,7
34386,0,0,5,10,15
34387,0,0,6,14,20
34388,0,0,6,2,8
34389,0,0,2,11,13
34390,0,0,9,8,17
34393,0,0,2,2,4
34394,0,0,0,4,4
34395,0,1,0,4,5
34396,0,0,18,30,48
34398,0,0,2,7,9
34399,0,0,3,11,14
34400,0,0,0,6,6
34403,0,0,10,11,21
34404,0,1,20,28,49
34406,0,0,3,3,6
34407,0,2,12,33,47
34408,0,0,6,10,16
34409,3,0,4,15,22
34410,0,6,4,30,40
34412,0,0,1,4,5
34413,0,0,2,12,14
34414,0,2,14,34,50
34415,0,1,4,3,8
34416,0,0,11,25,36
34417,0,1,9,23,33
34418,0,0,3,4,7
34419,0,1,3,6,10
34420,0,0,6,8,14
34421,0,0,10,13,23
34422,0,0,3,4,7
34423,0,0,14,30,44
34424,0,1,1,12,14
34425,0,1,3,12,16
34426,0,3,4,11,18
34427,0,0,9,16,25
34428,0,0,2,9,11
34429,0,1,2,8,11
34430,1,1,1,9,12
34431,0,0,12,19,31
34432,0,1,6,27,34
34433,0,0,1,13,14
34434,1,0,3,17,21
34436,0,0,10,28,38
34437,0,1,7,16,24
34438,0,0,3,11,14
34439,1,0,13,35,49
34440,0,0,11,34,45
34441,0,1,8,14,23
34442,0,0,6,10,16
34443,0,0,13,37,50
34444,0,0,7,20,27
34445,0,0,18,30,48
34446,0,1,9,34,44
34447,0,0,3,12,15
34448,0,0,14,36,50
34449,0,0,5,17,22
34450,0,0,0,7,7
34451,0,0,14,36,50
34452,0,0,4,13,17
34453,0,0,7,28,35
34454,0,0,8,16,24
34455,0,0,3,5,8
34457,0,0,7,18,25
34458,0,0,3,4,7
34459,0,0,17,24,41
34460,0,0,11,28,39
34461,0,0,7,20,27
34462,0,0,6,20,26
34463,0,0,11,20,31
34464,0,1,7,28,36
34465,1,1,0,14,16
34466,1,0,6,28,35
34467,0,0,10,20,30
34468,1,0,8,23,32
34469,0,0,3,8,11
34470,0,0,12,8,20
34471,0,0,3,4,7
34472,0,3,4,11,18
34473,1,2,18,29,50
34474,0,0,1,6,7
34479,0,0,3,15,18
34480,0,2,12,33,47
34481,3,0,4,15,22
34482,0,2,3,12,17
34483,0,6,4,30,40
34484,0,0,2,13,15
34485,0,0,0,4,4
34486,1,0,1,6,8
34487,1,1,1,7,10
34488,1,1,4,16,22
34489,0,0,9,16,25
34490,0,0,8,17,25
34491,0,2,4,10,16
34492,0,1,4,3,8
34493,0,0,3,3,6
34494,0,0,10,26,36
34495,1,0,5,13,19
34496,1,0,6,23,30
34497,3,0,1,14,18
34498,0,0,8,21,29
34499,0,0,12,19,31
34500,0,1,2,8,11
34502,0,0,3,7,10
34503,0,2,3,15,20
34504,1,2,2,9,14
34505,0,1,6,27,34
34506,0,0,1,13,14
34507,1,1,11,37,50
34508,0,0,8,14,22
34509,0,0,17,32,49
34510,0,0,2,18,20
34511,0,0,5,5,10
34512,0,0,6,16,22
34513,1,0,6,23,30
34514,0,0,8,12,20
34515,0,0,7,15,22
34516,0,1,1,12,14
34517,0,1,6,13,20
34518,0,2,3,15,20
34519,0,0,2,18,20
34520,1,0,3,17,21
34521,0,0,6,4,10
34522,0,0,9,17,26
34523,1,3,3,23,30
34524,0,0,7,20,27
34526,3,0,4,15,22
34527,0,2,7,21,30
34528,0,0,9,16,25
34529,0,0,3,15,18
34530,0,0,7,15,22
34531,0,3,9,9,21
34532,0,0,11,25,36
34533,0,0,10,13,23
34534,0,0,14,30,44
34535,3,0,1,14,18
34536,0,0,6,20,26
34537,0,6,4,30,40
34538,0,0,1,1,2
34539,0,0,6,16,22
34540,0,1,6,4,11
34541,1,1,4,16,22
34542,0,0,5,17,22
34543,0,0,11,28,39
34544,0,0,5,15,20
34545,0,0,11,34,45
34546,0,1,8,14,23
34547,0,2,3,12,17
34548,0,0,7,10,17
34549,0,1,4,5,10
34550,0,0,18,30,48
34551,0,0,17,32,49
34552,3,0,1,14,18
34553,0,0,2,12,14
34554,0,1,11,19,31
34555,0,1,4,18,23
34556,0,0,1,4,5
34557,0,3,4,25,32
34558,0,3,9,9,21
34559,0,1,6,13,20
34560,0,0,14,36,50
34561,0,0,8,16,24
34562,0,1,20,28,49
34563,0,0,8,14,22
34564,0,2,12,33,47
34565,0,0,7,15,22
34566,0,6,4,30,40
34567,0,2,4,10,16
34568,0,0,6,4,10
34569,1,0,5,13,19
34570,5,1,5,26,37
34571,0,1,9,23,33
34572,0,2,14,34,50
34573,0,0,3,4,7
34574,0,0,5,5,10
34575,0,0,6,8,14
34576,0,0,9,16,25
34577,0,0,7,20,27
34578,1,0,6,23,30
34579,1,1,1,7,10
34580,0,1,1,12,14
34581,0,2,7,21,30
34582,1,1,1,9,12
34583,0,2,3,15,20
34584,1,2,18,29,50
34585,0,1,2,8,11
34586,1,3,3,23,30
34587,0,0,10,26,36
34588,0,0,3,7,10
34589,0,0,8,17,25
34590,0,0,3,2,5
34592,0,0,4,5,9
34594,0,0,4,7,11
34595,0,1,5,10,16
34596,0,0,3,0,3
34597,0,1,8,26,35
34598,0,1,4,22,27
34599,0,0,3,6,9
34600,0,0,7,14,21
34601,0,0,1,4,5
34602,0,0,1,10,11
34603,0,0,6,13,19
34604,0,0,3,9,12
34606,1,2,2,17,22
34607,0,0,2,9,11
34608,0,0,3,8,11
34609,1,2,2,9,14
34610,0,1,5,5,11
34611,0,0,4,6,10
34612,0,1,2,23,26
34613,0,2,11,12,25
34614,0,0,7,7,14
34615,0,0,9,7,16
34616,0,0,9,22,31
34617,0,3,8,38,49
34618,0,0,18,30,48
34619,0,0,3,12,15
34620,0,0,6,3,9
34621,0,0,7,10,17
34622,0,0,11,24,35
34623,0,0,7,5,12
34624,0,1,2,13,16
34625,1,1,1,6,9
34626,0,1,8,16,25
34627,0,0,4,9,13
34628,0,0,12,26,38
34629,1,0,3,17,21
34630,0,0,3,11,14
34631,3,0,13,34,50
34632,0,1,8,15,24
34633,0,1,7,42,50
34634,0,0,2,7,9
34635,1,4,14,31,50
34636,0,0,7,9,16
34637,0,0,6,18,24
34638,0,0,3,6,9
34639,0,0,6,15,21
34640,1,1,8,20,30
34641,0,0,1,4,5
34642,3,0,4,15,22
34643,1,0,20,29,50
34644,0,1,5,23,29
34645,0,1,5,13,19
34646,0,1,1,8,10
34647,0,0,2,15,17
34648,0,0,14,21,35
34649,0,0,11,13,24
34650,0,1,8,39,48
34651,0,0,2,4,6
34652,0,0,1,13,14
34653,0,0,1,7,8
34654,0,0,2,4,6
34655,0,0,10,12,22
34657,0,6,4,30,40
34658,0,1,5,12,18
34659,0,0,5,9,14
34660,0,0,1,4,5
34661,0,0,6,12,18
34662,0,0,5,5,10
34663,0,0,0,5,5
34665,0,2,12,33,47
34666,0,1,18,31,50
34667,2,0,0,8,10
34668,0,5,15,27,47
34669,0,1,7,24,32
34670,1,3,4,16,24
34671,0,1,6,21,28
34672,0,0,13,5,18
34673,0,0,8,5,13
34674,0,0,3,4,7
34675,0,0,2,1,3
34676,0,1,5,15,21
34677,1,1,9,39,50
34678,1,0,3,22,26
34679,0,0,7,26,33
34680,0,0,5,12,17
34681,0,1,3,9,13
34682,0,0,2,3,5
34683,0,0,6,8,14
34684,0,0,3,6,9
34685,0,0,7,11,18
34686,0,0,9,9,18
34687,0,0,2,12,14
34688,0,1,14,25,40
34689,0,2,10,19,31
34690,0,1,9,15,25
34691,0,0,9,29,38
34692,0,0,4,9,13
34693,0,0,4,12,16
34694,0,0,9,19,28
34695,0,1,3,9,13
34696,0,0,4,0,4
34697,0,1,9,6,16
34698,0,0,8,14,22
34699,0,0,12,29,41
34700,0,0,4,1,5
34701,0,0,8,13,21
34702,0,0,13,18,31
34703,0,2,1,10,13
34704,0,1,9,22,32
34705,0,1,10,22,33
34706,0,0,7,11,18
34707,0,0,1,9,10
34708,0,0,4,13,17
34709,1,0,3,7,11
34710,0,0,7,9,16
34711,0,0,2,17,19
34712,0,0,3,3,6
34713,0,0,6,7,13
34714,0,0,7,12,19
34715,1,0,14,28,43
34716,1,1,9,6,17
34717,0,1,8,9,18
34718,0,0,2,5,7
34719,0,0,5,15,20
34720,0,0,6,15,21
34721,0,0,4,4,8
34722,0,0,6,18,24
34723,0,0,5,15,20
34724,0,1,8,10,19
34725,0,0,1,3,4
34726,0,0,5,17,22
34727,0,0,3,9,12
34728,0,0,5,11,16
34729,0,0,5,11,16
34730,0,3,12,17,32
34731,0,0,5,12,17
34732,0,0,8,25,33
34733,0,0,4,10,14
34734,0,0,1,5,6
34735,0,0,11,31,42
34736,0,1,3,4,8
34737,0,1,1,20,22
34738,0,1,6,20,27
34739,0,0,7,20,27
34740,0,0,12,19,31
34741,0,0,5,6,11
34742,0,0,1,4,5
34743,0,0,8,17,25
34744,0,0,5,7,12
34745,0,0,13,26,39
34746,0,0,4,16,20
34747,0,0,8,8,16
34748,0,2,6,23,31
34749,0,0,2,5,7
34750,0,0,2,9,11
34751,0,0,2,1,3
34752,0,0,8,15,23
34753,0,4,12,34,50
34754,0,0,5,19,24
34755,0,0,10,17,27
34756,0,0,4,21,25
34757,0,1,3,28,32
34758,0,0,6,12,18
34759,0,0,5,7,12
34760,0,0,3,20,23
34761,0,0,9,10,19
34762,0,2,2,7,11
34763,0,0,6,11,17
34764,0,0,2,3,5
34765,0,1,11,27,39
34766,0,0,2,3,5
34767,0,1,9,34,44
34768,0,0,5,14,19
34769,1,2,6,11,20
34770,0,1,7,17,25
34771,0,7,8,19,34
34772,0,0,6,19,25
34773,0,0,3,17,20
34774,0,0,1,4,5
34775,0,0,7,16,23
34776,0,0,11,9,20
34777,0,0,6,8,14
34778,0,0,1,14,15
34779,0,1,3,17,21
34780,0,0,11,22,33
34782,0,0,6,25,31
34783,0,0,0,3,3
34784,0,0,10,14,24
34785,0,1,7,40,48
34786,0,0,7,11,18
34787,0,2,2,6,10
34788,0,1,12,32,45
34789,0,1,4,20,25
34790,0,0,4,7,11
34791,0,3,4,10,17
34792,0,1,15,32,48
34793,0,0,6,20,26
34794,1,1,6,33,41
34795,0,2,14,34,50
34796,0,0,1,11,12
34797,0,0,2,7,9
34798,0,3,9,24,36
34799,5,0,7,26,38
34800,0,0,5,1,6
34801,0,0,2,6,8
34802,0,0,6,8,14
34803,0,0,4,2,6
34804,0,0,8,14,22
34805,0,1,5,16,22
34806,0,0,5,9,14
34807,0,1,1,6,8
34808,0,0,15,30,45
34809,0,0,9,18,27
34810,0,0,2,6,8
34812,0,0,7,5,12
34813,0,2,13,11,26
34814,0,0,2,4,6
34815,0,0,1,6,7
34816,0,1,4,4,9
34818,0,0,0,5,5
34819,0,4,5,12,21
34820,0,0,9,33,42
34821,0,0,6,11,17
34822,0,1,0,3,4
34823,0,0,3,5,8
34824,1,0,3,12,16
34825,0,0,9,20,29
34826,0,1,3,8,12
34828,0,0,2,10,12
34829,0,0,5,8,13
34830,0,1,4,3,8
34831,0,0,3,3,6
34832,0,0,2,1,3
34833,0,2,7,15,24
34834,3,1,3,33,40
34835,0,0,2,3,5
34836,0,0,10,17,27
34838,0,0,3,8,11
34839,0,0,1,4,5
34840,0,0,4,8,12
34841,0,0,8,12,20
34842,0,0,3,7,10
34843,0,0,7,14,21
34844,0,0,3,3,6
34845,0,0,3,2,5
34846,0,0,2,11,13
34847,0,0,4,7,11
34848,0,2,9,26,37
34849,0,0,8,5,13
34850,0,0,8,17,25
34851,0,0,8,21,29
34852,0,0,6,8,14
34853,0,0,13,14,27
34854,0,0,7,11,18
34855,0,0,3,12,15
34856,1,9,3,26,39
34857,0,2,3,12,17
34858,0,0,1,4,5
34859,1,3,2,14,20
34860,0,0,7,3,10
34861,0,0,2,3,5
34862,0,0,2,6,8
34863,0,0,6,2,8
34864,0,0,6,10,16
34865,1,0,4,19,24
34866,0,0,9,17,26
34867,0,0,4,7,11
34868,0,0,3,15,18
34869,0,0,5,7,12
34870,1,0,11,6,18
34871,0,0,3,7,10
34872,0,0,6,11,17
34873,1,0,9,25,35
34874,0,0,2,1,3
34875,0,0,5,15,20
34876,0,0,7,7,14
34877,0,0,7,41,48
34878,0,0,2,8,10
34879,0,0,7,9,16
34880,0,0,6,13,19
34881,0,0,7,18,25
34882,0,1,6,14,21
34883,0,0,1,9,10
34884,0,0,7,11,18
34885,0,0,6,8,14
34886,0,1,8,2,11
34887,0,0,8,12,20
34888,0,0,8,15,23
34889,0,5,7,36,48
34891,0,0,7,17,24
34892,0,2,6,19,27
34893,0,0,4,9,13
34894,0,0,1,14,15
34895,0,0,7,13,20
34896,0,0,1,4,5
34897,0,0,6,6,12
34898,0,1,12,21,34
34899,0,0,6,10,16
34900,0,0,6,13,19
34902,0,1,13,22,36
34903,0,1,3,24,28
34905,0,0,1,5,6
34906,0,0,9,11,20
34907,0,0,9,13,22
34908,0,2,8,15,25
34910,0,0,3,6,9
34912,0,0,11,16,27
34913,0,0,0,2,2
34914,0,0,1,5,6
34915,0,0,5,13,18
34916,0,1,9,15,25
34917,0,0,6,19,25
34918,0,2,9,25,36
34919,0,0,4,12,16
34920,0,0,2,12,14
34921,0,4,4,22,30
34922,0,0,5,5,10
34923,0,3,2,11,16
34924,0,0,7,17,24
34925,1,0,4,0,5
34926,0,0,4,3,7
34927,0,0,16,19,35
34928,0,2,9,11,22
34929,0,0,3,8,11
34930,0,0,2,8,10
34931,0,0,9,8,17
34932,0,1,6,14,21
34933,0,0,5,12,17
34934,0,0,3,6,9
34935,0,0,11,18,29
34936,0,0,4,8,12
34938,0,0,4,9,13
34939,0,0,1,6,7
34940,0,1,3,9,13
34941,0,0,4,17,21
34942,0,0,4,4,8
34944,0,0,10,23,33
34945,1,1,0,11,13
34946,0,0,15,30,45
34948,0,0,4,8,12
34949,0,0,3,8,11
34950,0,0,6,11,17
34951,0,1,5,5,11
34952,0,1,2,4,7
34953,0,0,4,3,7
34955,1,0,4,7,12
34956,0,1,10,34,45
34957,0,0,14,30,44
34958,0,0,4,6,10
34959,0,0,2,5,7
34960,0,0,2,2,4
34961,0,1,1,10,12
34963,0,1,2,2,5
34964,0,0,4,5,9
34965,0,0,1,7,8
34968,0,1,2,23,26
34969,0,0,4,7,11
34970,0,0,0,6,6
34971,0,0,1,13,14
34975,0,0,1,5,6
34976,0,0,0,5,5
34977,0,1,10,36,47
34979,0,0,5,3,8
34980,0,0,2,3,5
34981,0,1,1,5,7
34982,1,0,3,17,21
34983,0,0,10,21,31
34986,0,1,12,19,32
34987,0,0,4,4,8
34988,0,0,1,4,5
34989,0,0,3,2,5
34990,0,0,3,15,18
34992,0,0,1,4,5
34993,0,0,2,4,6
34994,0,1,1,13,15
34995,0,0,3,4,7
34996,0,1,1,9,11
34997,0,1,5,10,16
34998,0,0,4,5,9
34999,0,0,1,8,9
35001,0,0,6,20,26
35002,0,0,9,16,25
35003,0,0,7,12,19
35004,8,0,4,38,50
35005,0,1,1,23,25
35006,0,0,2,2,4
35007,1,3,3,23,30
35009,0,0,2,9,11
35010,0,1,4,22,27
35011,0,0,5,5,10
35012,0,0,8,17,25
35013,0,0,5,13,18
35015,0,1,15,21,37
35016,0,4,3,9,16
35017,0,2,7,25,34
35018,0,1,11,15,27
35019,0,0,0,7,7
35020,0,0,12,32,44
35021,1,2,2,9,14
35022,0,0,2,4,6
35023,1,0,0,4,5
35024,4,0,2,9,15
35025,0,0,4,1,5
35026,1,0,12,32,45
35027,1,0,11,33,45
35028,0,4,8,34,46
35029,0,1,8,22,31
35030,0,0,7,20,27
35031,0,0,10,22,32
35032,0,0,13,26,39
35033,0,0,5,12,17
35034,0,0,5,15,20
35035,0,1,16,33,50
35036,0,0,10,17,27
35037,0,0,12,14,26
35038,0,0,8,14,22
35039,0,1,12,20,33
35040,0,0,3,11,14
35041,0,0,18,32,50
35042,3,0,4,15,22
35043,0,1,7,36,44
35044,0,2,12,36,50
35045,0,0,6,15,21
35046,0,6,4,30,40
35047,0,0,3,5,8
35048,0,0,9,10,19
35049,0,1,7,16,24
35050,0,1,6,7,14
35051,0,0,11,16,27
35052,0,0,3,3,6
35053,0,0,1,13,14
35054,0,1,11,16,28
35056,0,0,12,15,27
35057,0,0,4,12,16
35058,0,0,9,12,21
35059,0,0,1,7,8
35060,0,0,10,26,36
35061,0,1,7,19,27
35062,0,0,10,12,22
35063,0,1,3,12,16
35064,0,0,2,7,9
35065,0,0,4,6,10
35066,0,1,2,6,9
35067,0,0,4,9,13
35068,0,0,8,15,23
35069,0,0,3,6,9
35070,0,0,5,8,13
35071,0,2,3,12,17
35072,0,0,6,10,16
35073,0,0,7,12,19
35074,0,0,4,22,26
35075,0,0,1,7,8
35076,0,0,0,50,50
35077,0,0,7,10,17
35078,0,1,17,32,50
35079,0,0,13,26,39
35080,0,0,8,38,46
35081,0,2,13,34,49
35082,0,0,8,19,27
35083,0,2,4,10,16
35084,0,0,10,26,36
35085,1,1,4,7,13
35086,0,2,10,37,49
35087,0,0,14,36,50
35088,0,0,15,32,47
35089,0,0,16,34,50
35090,0,1,9,27,37
35091,0,0,4,2,6
35092,0,2,2,7,11
35093,0,0,1,6,7
35094,1,0,13,18,32
35095,1,0,12,35,48
35096,0,0,8,14,22
35097,0,1,5,23,29
35098,0,1,6,9,16
35100,0,0,13,19,32
35101,0,0,11,22,33
35102,1,0,8,17,26
35103,0,1,3,14,18
35104,1,3,16,27,47
35105,0,0,9,30,39
35106,0,0,14,28,42
35107,0,1,8,11,20
35108,0,0,10,13,23
35109,0,0,13,22,35
35110,1,0,8,25,34
35111,0,0,8,18,26
35112,0,3,17,25,45
35113,0,0,7,19,26
35114,0,0,6,16,22
35115,0,0,6,1,7
35116,0,0,18,25,43
35117,0,0,6,24,30
35118,0,0,6,18,24
35119,0,0,4,15,19
35120,0,0,2,4,6
35121,0,0,15,30,45
35122,0,1,11,15,27
35123,0,0,6,8,14
35124,0,0,5,17,22
35125,0,1,9,14,24
35126,0,0,6,14,20
35127,0,0,0,8,8
35128,0,0,15,12,27
35129,1,0,1,6,8
35130,0,0,6,13,19
35131,1,1,1,7,10
35132,0,0,15,19,34
35133,0,0,3,9,12
35134,2,0,4,16,22
35135,0,0,13,24,37
35136,0,0,4,8,12
35137,0,0,9,11,20
35138,1,0,11,18,30
35139,0,0,2,8,10
35140,0,0,10,14,24
35141,0,0,7,28,35
35142,3,0,0,13,16
35143,1,0,4,7,12
35144,0,0,3,3,6
35145,0,0,11,20,31
35146,0,0,20,27,47
35147,1,0,6,9,16
35148,0,0,12,32,44
35149,0,0,6,6,12
35151,1,0,9,15,25
35152,0,1,2,23,26
35156,0,0,3,15,18
35157,0,1,12,19,32
35158,0,0,3,11,14
35159,0,0,1,5,6
35160,0,0,7,9,16
35161,0,0,18,30,48
35163,0,0,9,14,23
35164,0,0,1,8,9
35165,1,1,6,33,41
35166,2,0,0,8,10
35167,0,0,2,7,9
35168,0,1,2,11,14
35169,0,0,3,3,6
35170,0,2,12,33,47
35171,0,1,18,31,50
35172,0,1,9,22,32
35173,0,0,6,20,26
35174,8,0,4,38,50
35175,0,1,1,23,25
35176,1,9,3,26,39
35177,3,0,1,14,18
35178,0,0,16,34,50
35179,0,0,2,2,4
35180,0,1,4,3,8
35181,0,0,8,17,25
35182,0,0,5,5,10
35183,0,0,9,16,25
35184,6,1,4,39,50
35185,2,1,11,36,50
35186,1,0,6,23,30
35187,0,0,1,13,14
35188,0,1,11,15,27
35189,0,0,5,5,10
35190,0,1,5,5,11
35191,0,0,5,13,18
35192,1,2,2,9,14
35194,1,0,0,4,5
35195,1,1,14,27,43
35196,2,0,14,34,50
35198,0,0,14,18,32
35199,2,0,0,5,7
35200,0,0,17,32,49
35201,0,0,1,26,27
35202,0,0,0,3,3
35203,0,0,0,7,7
35204,0,1,1,13,15
35205,0,1,14,15,30
35206,0,0,12,20,32
35207,0,0,7,28,35
35208,0,0,16,34,50
35209,0,0,13,25,38
35211,0,0,17,32,49
35212,0,0,4,6,10
35214,0,0,10,21,31
35215,1,0,6,23,30
35216,0,0,10,27,37
35217,1,1,10,22,34
35218,1,1,9,39,50
35219,0,0,7,21,28
35220,4,0,2,9,15
35221,0,1,6,13,20
35222,1,1,6,12,20
35223,2,1,4,23,30
35224,2,0,6,7,15
35225,0,0,8,18,26
35227,0,0,13,25,38
35228,0,1,12,32,45
35229,0,0,1,26,27
35230,1,0,3,17,21
35231,0,1,14,15,30
35232,8,0,4,38,50
35233,0,0,5,15,20
35234,0,1,1,9,11
35235,1,3,3,23,30
35237,1,1,4,7,13
35238,0,0,3,15,18
35239,1,1,4,7,13
35240,3,0,4,15,22
35241,0,0,5,9,14
35242,0,0,13,25,38
35243,0,0,9,16,25
35244,1,1,4,7,13
35245,0,0,14,30,44
35246,0,1,3,10,14
35247,0,1,3,9,13
35248,3,0,1,14,18
35249,0,6,4,30,40
35250,0,0,6,20,26
35251,0,0,15,32,47
35252,1,0,0,4,5
35253,1,1,10,22,34
35254,0,0,13,22,35
35255,0,0,18,30,48
35256,1,0,12,32,45
35257,0,0,17,32,49
35258,0,6,4,30,40
35259,0,2,12,33,47
35260,0,0,1,4,5
35261,0,0,3,4,7
35262,0,1,6,13,20
35264,8,0,4,38,50
35265,1,1,1,7,10
35266,1,1,4,7,13
35267,0,2,3,12,17
35268,0,0,9,16,25
35269,0,0,13,25,38
35270,0,0,6,8,14
35271,0,2,4,10,16
35272,0,2,14,34,50
35273,0,1,2,23,26
35274,0,4,3,9,16
35275,0,0,4,8,12
35276,0,0,4,8,12
35277,1,0,6,23,30
35278,1,3,3,23,30
35279,3,0,1,14,18
35280,0,0,3,2,5
35281,0,0,10,13,23
35282,1,2,2,9,14
35283,0,1,5,5,11
35284,1,1,1,6,9
35286,0,0,3,2,5
35287,0,0,0,5,5
35289,1,0,0,15,16
35290,0,0,2,12,14
35291,0,0,15,29,44
35292,0,3,8,38,49
35293,0,0,15,28,43
35294,0,0,7,8,15
35295,0,0,2,16,18
35296,0,0,7,8,15
35297,0,0,4,3,7
35298,0,0,11,18,29
35299,0,0,7,13,20
35300,0,0,9,13,22
35301,0,0,8,6,14
35302,0,0,9,6,15
35303,0,3,7,27,37
35304,0,1,3,0,4
35305,0,0,6,16,22
35306,0,0,16,26,42
35307,1,0,17,32,50
35308,0,0,3,8,11
35309,0,0,10,24,34
35310,1,0,9,21,31
35311,1,0,3,13,17
35313,0,0,8,16,24
35314,0,1,15,34,50
35315,0,0,5,10,15
35316,0,2,9,17,28
35317,0,0,2,6,8
35318,0,0,3,7,10
35319,0,0,0,9,9
35320,1,0,13,34,48
35321,0,0,4,6,10
35322,0,0,5,4,9
35323,0,0,11,29,40
35324,0,0,1,10,11
35325,0,0,6,10,16
35326,0,0,5,2,7
35327,0,0,4,2,6
35328,0,1,1,15,17
35329,0,0,4,39,43
35330,0,0,5,6,11
35331,0,0,8,22,30
35332,0,1,7,8,16
35333,0,0,5,10,15
35334,0,1,20,28,49
35335,0,0,2,1,3
35336,1,0,10,37,48
35337,0,0,10,24,34
35338,0,0,14,20,34
35339,0,1,5,5,11
35340,0,0,5,13,18
35341,1,0,5,16,22
35342,0,2,4,12,18
35343,0,0,4,17,21
35344,0,1,11,17,29
35345,0,0,10,11,21
35346,0,0,8,13,21
35347,0,1,8,11,20
35348,0,0,5,11,16
35349,0,0,7,17,24
35350,0,0,6,14,20
35351,0,0,3,8,11
35352,0,0,5,10,15
35353,0,0,14,20,34
35354,0,1,2,14,17
35355,0,0,7,23,30
35356,0,1,1,10,12
35357,0,0,3,5,8
35358,0,1,6,8,15
35359,0,0,3,6,9
35360,0,0,1,7,8
35361,1,0,8,38,47
35362,0,0,0,12,12
35363,0,0,1,2,3
35364,0,0,1,7,8
35365,0,0,1,4,5
35366,0,1,13,23,37
35367,0,2,5,8,15
35368,0,1,1,7,9
35369,0,0,2,8,10
35370,0,0,8,19,27
35371,0,0,3,12,15
35372,0,0,1,9,10
35373,0,0,8,11,19
35374,0,0,2,12,14
35375,0,1,4,12,17
35376,0,0,0,2,2
35377,0,0,11,13,24
35378,0,0,3,11,14
35379,0,0,10,21,31
35380,3,0,2,13,18
35381,0,0,4,22,26
35382,1,0,4,30,35
35383,0,1,4,0,5
35384,0,0,2,17,19
35385,0,0,6,16,22
35386,0,0,2,5,7
35388,1,0,7,21,29
35389,0,0,5,6,11
35391,0,0,3,18,21
35392,0,0,12,8,20
35393,1,0,13,27,41
35394,0,0,2,14,16
35395,0,1,3,16,20
35396,0,0,3,7,10
35397,1,0,6,8,15
35398,0,0,6,10,16
35399,0,0,6,13,19
35400,1,0,6,23,30
35401,0,0,2,3,5
35402,0,0,0,12,12
35403,0,0,3,26,29
35404,0,0,12,38,50
35405,0,0,1,7,8
35406,1,2,3,18,24
35407,0,0,7,18,25
35408,0,0,1,6,7
35409,0,0,12,34,46
35410,0,0,3,14,17
35411,0,0,7,11,18
35412,0,0,8,19,27
35413,0,0,7,13,20
35414,1,0,9,10,20
35415,0,0,3,11,14
35416,0,0,2,10,12
35417,0,0,6,8,14
35418,0,0,2,12,14
35419,0,0,2,11,13
35420,0,0,8,20,28
35421,0,0,12,36,48
35422,0,2,9,13,24
35423,0,0,3,11,14
35424,1,0,10,25,36
35425,0,1,9,20,30
35426,0,1,1,10,12
35427,1,0,3,8,12
35428,0,0,11,18,29
35429,0,0,6,24,30
35430,0,0,17,20,37
35431,1,0,9,37,47
35432,0,0,5,11,16
35433,0,0,5,2,7
35434,0,0,4,9,13
35435,0,0,2,9,11
35436,0,0,1,10,11
35437,0,0,4,5,9
35438,0,0,4,6,10
35439,0,3,11,21,35
35440,0,1,0,4,5
35441,0,1,3,17,21
35442,0,0,6,12,18
35443,0,4,12,34,50
35445,0,0,3,6,9
35446,0,0,6,20,26
35447,0,0,5,4,9
35448,0,0,6,11,17
35449,0,0,5,13,18
35450,0,0,6,3,9
35451,0,0,4,12,16
35452,0,3,10,20,33
35453,0,6,9,21,36
35454,0,0,3,7,10
35455,0,0,12,18,30
35456,0,1,6,37,44
35457,0,0,10,18,28
35458,0,1,0,17,18
35459,0,0,6,8,14
35460,0,1,8,14,23
35461,0,2,11,31,44
35462,0,0,7,13,20
35463,0,1,10,31,42
35464,0,0,8,22,30
35465,0,1,9,23,33
35466,0,0,4,19,23
35467,0,0,5,18,23
35468,0,0,6,11,17
35469,0,0,3,2,5
35470,0,0,1,5,6
35471,0,0,8,16,24
35472,0,1,9,34,44
35473,0,0,6,14,20
35474,0,1,9,15,25
35475,0,0,1,11,12
35476,0,0,4,6,10
35477,0,0,6,10,16
35478,0,0,2,10,12
35479,1,0,6,29,36
35480,0,0,11,16,27
35481,0,0,3,4,7
35482,0,1,2,8,11
35484,0,0,3,5,8
35485,0,0,18,30,48
35486,0,0,21,29,50
35487,0,0,11,25,36
35488,0,0,10,13,23
35489,0,0,1,7,8
35490,1,0,3,9,13
35491,1,3,5,24,33
35492,0,0,3,8,11
35493,0,0,6,17,23
35494,0,0,8,19,27
35495,0,0,7,5,12
35496,1,0,16,22,39
35497,0,0,4,16,20
35498,0,0,7,11,18
35499,0,2,11,25,38
35500,0,2,8,18,28
35501,0,2,8,28,38
35502,0,1,13,10,24
35504,0,0,4,2,6
35505,0,0,2,10,12
35506,0,1,3,4,8
35507,0,0,1,7,8
35508,0,6,4,22,32
35509,0,1,9,19,29
35510,0,0,3,6,9
35511,0,0,2,4,6
35512,0,0,4,22,26
35513,0,0,4,17,21
35514,0,2,6,14,22
35515,0,0,5,31,36
35516,0,1,13,16,30
35517,0,0,4,6,10
35518,0,1,5,16,22
35519,0,1,7,14,22
35520,0,0,2,4,6
35521,0,0,5,3,8
35522,1,0,7,37,45
35523,0,0,2,8,10
35524,0,0,7,24,31
35525,0,1,6,12,19
35526,0,0,9,18,27
35527,0,0,7,5,12
35528,0,2,6,9,17
35529,0,0,1,20,21
35530,0,0,3,5,8
35531,1,0,6,27,34
35532,0,0,9,28,37
35533,0,0,7,9,16
35534,1,2,6,23,32
35535,0,0,2,10,12
35537,0,0,0,20,20
35539,0,0,2,14,16
35540,0,1,2,7,10
35541,0,0,6,24,30
35542,0,0,8,9,17
35543,0,0,22,27,49
35544,0,0,9,29,38
35545,0,0,3,7,10
35546,0,0,3,2,5
35547,0,0,6,12,18
35548,1,0,1,13,15
35549,0,3,7,3,13
35550,0,0,8,18,26
35551,0,0,3,7,10
35552,0,0,4,1,5
35553,0,0,16,34,50
35554,0,0,2,2,4
35555,0,0,0,7,7
35556,0,0,8,16,24
35557,0,0,1,7,8
35558,0,0,9,10,19
35559,0,0,6,10,16
35560,0,0,1,4,5
35561,1,1,7,34,43
35562,0,0,6,1,7
35563,0,0,3,15,18
35564,0,0,7,12,19
35565,0,1,4,5,10
35566,0,0,5,8,13
35567,0,0,1,20,21
35568,0,0,0,9,9
35569,1,1,1,16,19
35570,0,0,2,8,10
35571,0,0,5,1,6
35572,0,1,8,20,29
35573,0,0,5,6,11
35574,0,0,9,16,25
35575,0,1,1,5,7
35576,0,0,4,8,12
35577,0,0,9,14,23
35578,0,0,12,15,27
35579,0,0,5,7,12
35580,0,0,3,16,19
35582,0,0,3,3,6
35583,0,0,15,33,48
35584,0,0,5,7,12
35585,0,0,4,6,10
35586,0,0,4,19,23
35588,0,0,5,3,8
35589,0,0,1,4,5
35590,0,0,5,4,9
35591,0,0,3,9,12
35592,0,0,13,30,43
35593,0,0,16,33,49
35594,1,0,1,5,7
35595,0,0,3,7,10
35596,0,0,1,1,2
35597,0,0,2,6,8
35598,0,0,4,13,17
35599,0,1,7,21,29
35601,1,0,3,18,22
35602,0,0,3,11,14
35603,0,1,6,12,19
35604,1,0,5,3,9
35605,0,0,4,12,16
35607,0,0,5,6,11
35608,0,0,1,8,9
35609,0,0,0,6,6
35610,0,0,6,7,13
35611,0,0,0,5,5
35612,0,0,4,10,14
35613,0,0,6,4,10
35614,0,1,1,12,14
35615,0,0,2,3,5
35616,0,1,8,10,19
35617,0,0,8,14,22
35618,0,0,6,10,16
35619,0,0,5,8,13
35620,0,0,9,25,34
35621,0,0,6,5,11
35622,0,0,4,7,11
35623,0,1,7,20,28
35624,0,0,4,6,10
35625,0,0,6,10,16
35626,0,1,4,13,18
35627,0,0,1,4,5
35628,0,0,13,11,24
35630,0,0,5,15,20
35631,0,0,1,9,10
35633,2,0,14,34,50
35636,0,0,1,5,6
35637,0,0,15,30,45
35638,0,0,4,29,33
35639,0,0,2,5,7
35641,0,0,2,8,10
35642,0,0,4,1,5
35644,0,0,0,1,1
35645,0,0,1,3,4
35646,0,0,2,4,6
35648,0,0,5,5,10
35650,1,0,4,11,16
35651,0,0,1,8,9
35652,1,2,5,13,21
35653,0,0,18,30,48
35655,1,1,8,20,30
35657,0,0,0,5,5
35659,0,1,12,20,33
35660,0,0,1,8,9
35661,0,0,4,7,11
35663,0,5,2,34,41
35664,0,0,0,11,11
35665,0,0,9,16,25
35667,0,1,1,15,17
35668,0,2,14,34,50
35669,0,1,1,5,7
35670,1,0,1,6,8
35671,0,0,13,9,22
35672,0,0,3,7,10
35673,0,0,0,7,7
35674,1,2,2,9,14
35675,0,0,5,13,18
35676,0,0,4,4,8
35677,0,1,5,5,11
35679,0,0,16,29,45
35680,0,1,7,31,39
35681,0,2,13,33,48
35682,1,0,16,30,47
35683,0,1,8,16,25
35684,0,0,11,36,47
35685,0,0,20,30,50
35687,1,1,3,36,41
35688,0,0,6,23,29
35689,0,2,2,22,26
35690,0,0,4,16,20
35691,0,0,7,42,49
35692,0,0,12,11,23
35693,0,0,6,9,15
35694,0,0,7,19,26
35695,0,0,13,35,48
35696,0,1,2,23,26
35697,0,7,2,41,50
35698,0,1,15,29,45
35699,0,0,5,11,16
35700,0,0,7,12,19
35701,4,0,3,32,39
35702,0,0,11,39,50
35703,0,0,14,30,44
35704,0,0,12,38,50
35705,1,0,13,34,48
35706,0,0,0,6,6
35707,0,0,9,12,21
35708,0,0,5,18,23
35709,0,0,7,40,47
35710,1,0,1,23,25
35711,0,1,8,17,26
35712,0,0,8,30,38
35713,0,0,3,9,12
35714,0,0,6,44,50
35715,0,0,14,20,34
35716,0,0,6,16,22
35718,1,2,10,17,30
35719,0,0,1,32,33
35720,1,0,8,34,43
35721,0,0,12,27,39
35722,0,0,2,5,7
35723,0,0,6,10,16
35724,0,0,3,3,6
35725,3,0,6,23,32
35726,0,0,7,9,16
35727,0,0,0,4,4
35728,0,0,0,2,2
35729,0,1,9,34,44
35730,0,0,15,25,40
35731,0,0,16,29,45
35732,0,0,13,16,29
35733,1,0,11,16,28
35734,1,3,3,18,25
35735,0,0,6,20,26
35736,0,0,10,15,25
35737,0,0,7,31,38
35738,0,0,11,14,25
35740,0,2,13,35,50
35741,0,1,6,9,16
35742,0,0,4,4,8
35743,0,0,7,20,27
35744,0,0,9,15,24
35746,0,0,8,14,22
35747,0,0,5,8,13
35748,3,0,4,8,15
35749,0,0,5,10,15
35750,0,0,14,34,48
35751,0,0,9,7,16
35752,0,1,14,31,46
35753,0,0,7,13,20
35754,0,0,12,19,31
35755,0,1,9,13,23
35756,1,0,2,27,30
35757,0,0,10,5,15
35758,0,0,9,15,24
35759,1,0,7,27,35
35760,0,0,13,24,37
35761,0,0,14,36,50
35762,0,1,4,38,43
35763,0,0,1,8,9
35764,0,0,8,23,31
35765,0,0,6,17,23
35766,1,0,4,11,16
35767,0,1,2,7,10
35768,1,2,5,13,21
35769,0,0,6,9,15
35770,0,0,2,4,6
35771,0,0,7,17,24
35772,1,0,1,9,11
35773,0,1,5,14,20
35774,0,0,2,12,14
35775,0,1,6,9,16
35776,0,0,4,16,20
35777,0,0,0,6,6
35778,0,0,4,6,10
35779,0,0,16,34,50
35780,1,0,6,10,17
35781,1,0,4,27,32
35782,0,0,7,13,20
35783,0,0,11,17,28
35784,0,0,18,11,29
35785,0,0,10,22,32
35786,0,0,21,28,49
35787,0,0,1,7,8
35788,0,0,1,9,10
35789,0,0,7,6,13
35790,0,0,5,6,11
35791,0,0,11,37,48
35792,0,0,20,30,50
35793,0,0,12,27,39
35794,0,0,6,27,33
35795,0,0,2,8,10
35796,1,1,6,33,41
35797,1,0,7,3,11
35798,1,0,0,6,7
35799,1,0,13,18,32
35800,0,0,6,10,16
35801,1,0,11,21,33
35803,0,0,2,7,9
35804,5,2,4,34,45
35805,0,0,10,18,28
35806,0,0,1,7,8
35807,0,0,9,18,27
35808,0,0,4,5,9
35809,0,0,7,7,14
35810,0,0,2,9,11
35811,0,5,2,34,41
35812,1,0,3,23,27
35813,0,0,9,14,23
35814,0,0,2,3,5
35815,0,0,17,33,50
35816,0,0,16,24,40
35817,0,1,3,14,18
35818,0,0,2,4,6
35819,0,1,3,8,12
35820,0,0,6,4,10
35821,0,1,11,18,30
35822,0,1,5,27,33
35823,0,0,4,8,12
35824,1,0,6,15,22
35825,0,0,11,12,23
35826,0,0,10,31,41
35827,0,0,0,11,11
35828,2,0,1,17,20
35829,1,1,7,37,46
35830,1,0,7,27,35
35831,0,0,11,36,47
35832,1,0,5,6,12
35833,0,0,4,4,8
35834,1,0,0,14,15
35835,1,0,2,28,31
35836,0,0,5,13,18
35838,2,0,2,10,14
35839,0,0,3,2,5
35840,0,0,4,8,12
35841,0,0,7,27,34
35842,0,0,15,34,49
35843,0,0,14,14,28
35844,0,0,12,33,45
35845,0,2,12,36,50
35846,0,0,3,10,13
35847,0,0,6,5,11
35848,0,1,9,14,24
35849,1,1,9,27,38
35850,0,0,3,9,12
35853,0,1,7,20,28
35854,1,0,3,6,10
35855,0,0,6,9,15
35856,0,0,5,6,11
35857,0,0,4,8,12
35859,0,0,11,25,36
35860,1,0,6,19,26
35861,0,1,3,23,27
35862,0,0,5,10,15
35863,0,1,9,34,44
35865,0,0,6,10,16
35866,0,0,18,30,48
35867,0,0,1,10,11
35868,0,0,0,6,6
35869,1,0,4,13,18
35870,0,1,1,15,17
35871,0,0,8,18,26
35872,1,1,4,16,22
35873,0,0,21,29,50
35874,0,0,2,2,4
35876,1,1,1,16,19
35877,0,0,9,16,25
35878,0,0,3,6,9
35879,3,1,6,22,32
35880,1,0,1,6,8
35881,0,1,5,5,11
35882,0,0,5,13,18
35883,0,2,3,15,20
35884,0,0,3,9,12
35885,0,0,3,7,10
35886,0,0,1,8,9
35888,0,1,12,20,33
35889,1,2,2,9,14
35890,0,1,0,9,10
35891,0,0,1,23,24
35892,1,0,2,8,11
35893,0,0,7,19,26
35894,0,7,2,41,50
35895,1,0,6,33,40
35896,0,1,7,31,39
35897,0,0,7,42,49
35898,0,0,9,39,48
35899,0,0,1,4,5
35900,1,0,8,24,33
35901,0,1,2,23,26
35902,0,0,13,25,38
35903,0,1,9,40,50
35904,0,2,9,18,29
35905,4,0,10,34,48
35906,1,0,5,27,33
35907,0,1,5,24,30
35908,0,0,0,6,6
35909,1,0,6,19,26
35910,0,1,7,35,43
35911,0,0,22,28,50
35912,0,0,13,29,42
35913,0,0,12,15,27
35914,0,0,15,26,41
35915,1,0,3,23,27
35916,0,0,5,14,19
35917,0,0,10,18,28
35918,1,0,5,9,15
35919,0,0,3,8,11
35920,0,0,6,16,22
35921,0,1,10,13,24
35922,0,0,6,14,20
35923,0,0,7,15,22
35924,0,1,1,12,14
35925,1,0,0,15,16
35926,0,0,0,2,2
35927,2,0,9,14,25
35928,1,0,1,6,8
35929,0,0,5,5,10
35930,0,0,4,29,33
35931,0,0,8,10,18
35932,0,0,8,18,26
35933,1,0,8,24,33
35934,1,0,8,34,43
35935,0,0,13,25,38
35936,0,0,6,22,28
35937,4,0,10,34,48
35938,0,0,16,32,48
35940,0,2,3,15,20
35941,0,1,1,5,7
35942,1,0,6,15,22
35943,0,0,13,25,38
35944,0,0,9,16,25
35945,0,0,3,7,10
35946,0,1,5,5,11
35947,0,0,7,15,22
35948,0,0,11,25,36
35949,0,0,10,13,23
35950,0,0,16,34,50
35951,1,3,3,18,25
35952,0,0,8,10,18
35953,0,0,6,14,20
35954,1,1,4,16,22
35955,0,0,5,5,10
35956,0,1,20,28,49
35957,0,0,7,15,22
35958,0,0,13,25,38
35959,0,0,18,30,48
35960,0,1,9,23,33
35961,0,2,14,34,50
35962,0,1,1,12,14
35963,1,0,1,6,8
35964,0,2,3,15,20
35965,0,0,9,16,25
35966,0,0,2,2,4
35967,0,0,0,13,13
35968,0,0,0,5,5
35969,0,0,2,18,20
35970,0,0,0,7,7
35971,0,2,2,2,6
35973,1,0,1,10,12
35974,0,0,7,3,10
35975,0,0,5,24,29
35976,0,1,8,26,35
35977,0,1,5,10,16
35978,0,0,2,15,17
35980,0,1,14,14,29
35981,0,0,5,7,12
35982,0,0,11,22,33
35983,0,0,6,8,14
35984,0,0,15,28,43
35985,0,0,1,14,15
35986,0,0,2,4,6
35987,0,0,11,35,46
35988,0,0,2,14,16
35989,0,0,7,18,25
35990,0,0,1,20,21
35991,0,0,5,10,15
35992,0,0,1,8,9
35993,0,0,6,16,22
35994,0,0,4,9,13
35995,0,0,2,9,11
35996,0,0,8,10,18
35997,0,1,1,35,37
35998,0,0,1,4,5
35999,0,0,5,6,11
36000,0,2,11,30,43
36001,0,0,7,17,24
36002,1,0,3,6,10
36003,0,1,7,42,50
36004,0,0,4,11,15
36005,0,0,10,40,50
36006,0,0,6,16,22
36007,0,1,9,12,22
36008,0,0,6,14,20
36009,0,0,2,6,8
36011,0,0,1,5,6
36012,0,0,3,6,9
36013,0,0,0,7,7
36014,0,0,0,5,5
36015,2,0,2,21,25
36016,0,1,7,15,23
36017,0,0,5,7,12
36018,0,1,9,35,45
36019,0,0,2,10,12
36020,0,1,4,11,16
36021,0,0,4,4,8
36022,0,0,8,12,20
36023,0,0,11,20,31
36024,0,0,3,5,8
36025,0,0,11,8,19
36026,0,0,5,10,15
36027,0,0,2,11,13
36028,0,0,9,18,27
36029,0,0,6,7,13
36030,0,0,2,8,10
36031,0,0,3,9,12
36032,0,0,9,33,42
36033,0,0,2,9,11
36034,0,0,7,43,50
36035,1,1,4,21,27
36036,0,1,3,22,26
36037,0,0,0,5,5
36038,0,0,4,20,24
36039,0,0,4,13,17
36040,0,1,6,11,18
36041,0,0,6,4,10
36042,0,0,5,8,13
36043,0,0,0,5,5
36044,0,1,11,26,38
36045,0,0,1,8,9
36046,2,1,2,28,33
36047,0,0,3,10,13
36048,0,0,0,6,6
36049,0,0,8,23,31
36050,0,0,5,0,5
36051,0,0,0,9,9
36052,0,0,4,12,16
36053,0,0,6,15,21
36054,0,0,3,5,8
36055,0,0,2,9,11
36056,0,0,4,10,14
36057,0,0,6,6,12
36058,0,0,5,11,16
36059,0,0,6,15,21
36060,0,0,4,10,14
36061,0,0,5,10,15
36062,0,1,6,16,23
36063,0,1,12,23,36
36064,0,1,5,26,32
36065,0,0,3,5,8
36066,0,0,14,26,40
36067,0,0,13,16,29
36068,0,0,12,17,29
36069,0,0,0,12,12
36070,0,0,3,4,7
36071,0,0,1,7,8
36072,1,1,5,18,25
36073,0,0,1,8,9
36074,0,0,9,19,28
36075,0,2,1,6,9
36076,0,0,9,24,33
36077,0,0,10,14,24
36078,0,0,6,43,49
36079,0,0,7,20,27
36080,0,0,2,5,7
36081,0,0,6,25,31
36082,0,0,4,30,34
36083,0,0,2,6,8
36084,0,0,2,4,6
36085,0,1,0,12,13
36086,0,0,7,34,41
36087,0,0,11,20,31
36088,0,0,11,28,39
36089,1,1,1,16,19
36090,1,1,3,35,40
36091,0,1,1,19,21
36093,0,0,5,7,12
36094,0,1,5,10,16
36095,0,1,3,13,17
36096,0,0,1,6,7
36097,0,0,8,11,19
36098,0,0,4,5,9
36099,0,0,4,20,24
36100,0,2,6,18,26
36101,0,0,9,29,38
36102,0,0,9,17,26
36103,0,0,3,10,13
36104,0,0,9,25,34
36105,0,2,2,5,9
36106,0,0,1,9,10
36107,0,0,3,1,4
36108,0,0,1,34,35
36110,0,0,0,11,11
36111,0,0,7,2,9
36112,0,0,0,6,6
36113,0,0,5,15,20
36114,0,0,4,18,22
36115,0,4,5,34,43
36116,0,0,5,6,11
36117,0,0,4,1,5
36118,1,0,1,6,8
36119,0,0,9,15,24
36120,0,0,3,2,5
36121,0,0,10,23,33
36122,5,1,5,39,50
36123,0,0,8,9,17
36124,1,0,0,13,14
36125,0,1,3,25,29
36126,0,0,2,7,9
36127,0,0,0,7,7
36128,0,0,2,8,10
36129,0,0,3,11,14
36130,0,5,2,34,41
36131,0,0,5,3,8
36132,0,0,4,10,14
36133,0,0,6,5,11
36134,0,0,4,23,27
36135,0,0,13,29,42
36136,0,1,1,5,7
36137,0,0,3,6,9
36138,0,0,4,3,7
36139,0,0,5,35,40
36140,0,1,3,11,15
36141,1,0,7,25,33
36142,0,0,12,37,49
36143,0,0,1,5,6
36144,0,1,5,15,21
36145,0,0,1,8,9
36146,0,0,6,14,20
36148,0,0,4,7,11
36149,0,0,0,1,1
36150,0,0,6,7,13
36151,0,0,10,27,37
36152,0,0,0,3,3
36153,0,0,0,3,3
36154,0,2,6,27,35
36155,0,4,10,24,38
36156,0,0,2,1,3
36157,1,0,6,18,25
36158,0,0,5,3,8
36159,0,0,5,1,6
36160,1,0,6,4,11
36161,1,0,2,10,13
36162,0,0,6,6,12
36163,0,0,0,16,16
36164,0,0,5,28,33
36165,0,1,12,20,33
36166,0,0,3,5,8
36167,1,0,2,25,28
36168,0,1,5,8,14
36169,0,0,2,11,13
36170,0,1,9,17,27
36171,1,0,10,34,45
36172,0,0,12,19,31
36173,0,0,7,5,12
36174,0,0,0,6,6
36175,0,0,2,15,17
36176,0,0,3,7,10
36177,0,0,0,9,9
36178,0,0,3,4,7
36179,0,0,9,5,14
36180,0,5,5,24,34
36181,0,0,3,8,11
36182,0,0,2,8,10
36183,1,1,1,9,12
36184,0,0,11,16,27
36185,0,1,13,36,50
36186,0,0,4,9,13
36187,0,0,12,14,26
36189,0,0,8,10,18
36190,1,1,7,13,22
36191,0,0,5,13,18
36192,0,0,2,18,20
36193,0,0,7,13,20
36194,0,0,4,1,5
36195,0,0,0,7,7
36196,1,0,4,4,9
36197,0,0,7,13,20
36198,0,0,12,23,35
36199,0,0,6,11,17
36200,0,2,9,16,27
36201,0,0,3,1,4
36202,0,0,2,8,10
36203,0,0,7,5,12
36204,1,0,4,15,20
36206,0,0,11,10,21
36207,0,0,5,5,10
36208,0,0,3,2,5
36209,0,1,3,18,22
36210,0,1,13,25,39
36211,0,0,1,5,6
36212,0,1,6,36,43
36213,1,0,12,34,47
36215,1,1,6,33,41
36216,0,0,5,8,13
36217,0,0,0,5,5
36218,0,1,15,16,32
36219,0,0,1,9,10
36220,1,0,1,6,8
36221,2,1,2,14,19
36222,0,0,2,8,10
36224,0,0,10,17,27
36225,0,0,12,21,33
36226,0,0,16,25,41
36227,0,0,7,43,50
36228,0,0,15,27,42
36229,0,0,5,8,13
36230,0,1,4,17,22
36231,0,1,7,17,25
36232,0,1,4,10,15
36233,0,0,8,23,31
36234,0,0,16,34,50
36235,0,0,5,8,13
36236,0,0,4,11,15
36237,0,0,4,13,17
36239,0,0,6,23,29
36240,0,0,3,23,26
36241,0,1,10,24,35
36242,0,0,9,27,36
36243,0,0,2,2,4
36244,0,0,12,4,16
36245,0,0,13,19,32
36246,0,0,7,14,21
36247,0,1,16,31,48
36248,0,0,5,13,18
36249,0,0,1,19,20
36250,1,0,12,36,49
36252,1,0,4,45,50
36253,0,0,7,13,20
36254,0,0,10,21,31
36255,0,0,4,12,16
36256,0,0,12,26,38
36257,0,0,13,37,50
36258,0,4,4,23,31
36259,0,0,17,32,49
36260,2,0,3,6,11
36261,0,0,15,24,39
36262,0,1,5,15,21
36263,0,0,3,11,14
36264,0,0,16,34,50
36265,1,1,8,16,26
36266,0,0,7,20,27
36267,0,0,2,19,21
36268,0,0,7,10,17
36269,0,1,6,36,43
36270,0,0,12,24,36
36271,0,0,19,22,41
36272,0,0,7,17,24
36273,2,0,7,27,36
36274,0,0,16,31,47
36275,0,2,4,16,22
36276,0,0,16,26,42
36277,0,0,13,26,39
36278,1,0,6,15,22
36279,0,0,7,22,29
36280,0,0,3,25,28
36281,0,1,8,17,26
36282,0,0,11,15,26
36283,1,1,14,19,35
36284,0,1,4,17,22
36285,0,0,9,2,11
36286,0,0,10,27,37
36287,1,0,6,12,19
36288,0,0,10,17,27
36289,0,0,6,15,21
36290,0,0,20,30,50
36291,0,1,11,8,20
36292,0,0,9,7,16
36293,0,0,11,8,19
36294,0,1,6,10,17
36295,0,0,0,11,11
36296,1,0,11,37,49
36297,0,0,8,15,23
36298,0,0,3,2,5
36299,0,2,3,12,17
36300,1,0,4,15,20
36301,0,2,10,14,26
36302,0,0,1,14,15
36303,0,0,5,15,20
36304,0,0,7,9,16
36305,0,0,14,20,34
36306,0,0,5,27,32
36307,0,0,3,2,5
36308,0,1,12,37,50
36309,0,0,7,19,26
36310,0,0,5,10,15
36311,0,0,5,20,25
36313,1,0,6,13,20
36314,0,0,4,3,7
36315,0,1,12,35,48
36316,2,0,3,19,24
36317,0,0,11,39,50
36318,0,0,6,15,21
36319,0,0,1,1,2
36320,0,1,13,22,36
36321,0,0,5,19,24
36322,0,0,5,20,25
36325,0,1,1,5,7
36326,0,1,6,18,25
36327,0,0,8,7,15
36328,0,1,9,11,21
36329,0,0,5,5,10
36330,1,1,2,35,39
36331,0,0,1,1,2
36332,0,0,5,9,14
36333,1,0,2,7,10
36334,0,0,10,6,16
36335,0,0,3,2,5
36336,0,1,4,20,25
36337,0,0,4,1,5
36338,0,1,3,9,13
36339,0,0,11,20,31
36340,1,0,8,12,21
36341,0,1,15,16,32
36342,0,0,12,12,24
36343,0,0,5,10,15
36344,0,0,1,6,7
36345,0,1,14,35,50
36346,0,0,5,29,34
36347,0,0,7,12,19
36348,0,0,20,30,50
36349,1,0,7,10,18
36350,0,0,4,20,24
36351,0,0,9,8,17
36352,0,0,1,5,6
36353,0,0,2,12,14
36355,0,5,2,34,41
36356,0,1,3,18,22
36357,1,1,6,33,41
36358,5,1,5,39,50
36359,0,1,6,11,18
36360,0,1,12,20,33
36361,0,0,1,5,6
36362,0,0,15,32,47
36363,0,0,12,19,31
36364,2,1,2,14,19
36365,0,0,5,13,18
36366,3,1,6,22,32
36367,0,0,1,9,10
36368,1,0,1,6,8
36369,1,0,0,10,11
36370,1,0,17,31,49
36371,0,0,8,14,22
36372,0,1,4,10,15
36373,0,1,4,20,25
36374,0,0,2,23,25
36375,0,1,11,38,50
36376,1,0,6,15,22
36377,0,0,11,28,39
36378,0,0,4,29,33
36379,0,1,5,12,18
36380,0,0,1,17,18
36382,0,1,10,28,39
36383,0,2,4,35,41
36384,0,0,1,5,6
36386,0,0,0,13,13
36388,0,0,1,8,9
36389,0,0,4,11,15
36390,0,0,2,18,20
36391,0,0,0,11,11
36392,0,2,4,16,22
36394,0,1,4,17,22
36395,1,0,1,6,8
36396,0,1,14,35,50
36397,0,0,9,24,33
36398,1,0,1,12,14
36399,0,0,4,13,17
36400,0,0,7,43,50
36401,0,0,2,18,20
36402,0,1,5,21,27
36403,0,1,7,18,26
36404,0,2,12,32,46
36405,3,0,5,23,31
36406,2,1,2,14,19
36407,2,0,2,16,20
36408,0,0,15,32,47
36409,2,1,2,14,19
36410,0,1,1,5,7
36411,0,0,1,5,6
36412,1,0,1,6,8
36413,1,1,1,9,12
36414,0,0,8,14,22
36415,0,1,0,8,9
36416,0,1,3,8,12
36417,0,0,6,13,19
36418,0,0,6,20,26
36419,0,0,2,5,7
36420,0,0,2,7,9
36421,0,0,8,12,20
36422,0,0,3,6,9
36423,0,0,8,12,20
36424,0,0,4,30,34
36425,0,0,7,12,19
36426,0,0,10,30,40
36427,0,2,3,27,32
36428,0,0,9,22,31
36429,0,0,2,4,6
36430,0,0,3,12,15
36431,0,0,9,32,41
36432,0,1,0,13,14
36434,0,0,14,22,36
36435,0,0,16,19,35
36436,0,0,5,10,15
36438,0,0,7,4,11
36439,0,0,2,17,19
36440,0,0,1,10,11
36441,0,0,0,10,10
36442,0,0,6,6,12
36443,0,2,3,35,40
36444,0,1,6,17,24
36445,0,0,6,24,30
36446,0,0,7,16,23
36447,0,0,5,16,21
36448,0,3,5,7,15
36449,0,0,4,15,19
36450,0,0,1,17,18
36451,0,0,5,6,11
36452,0,0,2,2,4
36453,0,1,2,13,16
36454,0,0,14,21,35
36455,0,0,0,5,5
36456,0,1,15,33,49
36457,0,0,5,29,34
36458,0,1,24,20,45
36460,0,0,10,24,34
36461,0,1,15,34,50
36462,0,0,5,15,20
36463,1,0,2,3,6
36464,0,0,9,30,39
36465,1,0,3,14,18
36466,0,0,3,5,8
36467,0,0,1,6,7
36468,1,1,12,19,33
36470,0,0,9,12,21
36471,0,1,2,26,29
36473,0,0,4,9,13
36474,0,1,2,27,30
36475,1,0,4,5,10
36476,0,0,0,5,5
36477,0,3,1,17,21
36478,0,0,4,10,14
36479,0,0,5,7,12
36480,0,0,1,4,5
36481,0,1,1,7,9
36482,0,0,13,23,36
36483,1,0,1,6,8
36484,0,0,17,13,30
36485,0,0,4,15,19
36486,0,0,20,28,48
36487,0,0,10,17,27
36488,0,0,2,8,10
36489,0,0,1,6,7
36490,0,0,1,6,7
36492,0,0,6,4,10
36493,0,0,2,7,9
36494,0,0,4,12,16
36495,0,0,4,7,11
36496,0,1,4,24,29
36497,0,1,7,10,18
36498,0,0,3,5,8
36499,0,0,14,19,33
36500,0,1,5,21,27
36501,0,0,0,19,19
36502,0,0,7,4,11
36503,0,0,7,13,20
36504,0,0,7,17,24
36505,0,0,3,4,7
36506,0,0,3,8,11
36507,0,0,0,7,7
36508,0,0,8,10,18
36509,0,0,7,8,15
36510,0,0,9,15,24
36511,0,1,3,8,12
36512,0,0,3,2,5
36513,0,0,6,13,19
36514,0,0,8,11,19
36515,0,1,2,7,10
36516,0,0,7,8,15
36517,0,1,0,8,9
36518,0,0,5,12,17
36519,0,0,8,42,50
36520,0,0,6,24,30
36521,0,0,6,24,30
36522,0,1,1,14,16
36523,0,0,0,3,3
36524,0,0,2,12,14
36525,0,0,4,5,9
36526,0,0,7,13,20
36527,0,0,11,38,49
36528,0,0,6,14,20
36530,0,0,11,9,20
36532,0,0,5,36,41
36533,0,0,8,6,14
36534,0,0,16,34,50
36535,0,0,9,18,27
36536,0,0,6,12,18
36537,0,0,8,23,31
36538,0,0,4,10,14
36539,0,0,4,13,17
36540,0,0,8,19,27
36541,1,0,1,10,12
36543,0,0,7,6,13
36544,0,0,5,13,18
36545,0,0,9,11,20
36546,0,2,1,20,23
36547,0,1,0,3,4
36549,0,1,2,5,8
36550,0,1,1,6,8
36552,1,1,9,17,28
36553,0,0,2,3,5
36554,0,0,11,21,32
36555,2,1,6,14,23
36556,0,0,3,15,18
36557,0,1,0,9,10
36558,0,0,9,14,23
36559,0,1,2,13,16
36560,0,1,2,16,19
36561,1,1,5,13,20
36562,0,0,7,30,37
36563,0,0,2,6,8
36564,1,1,1,7,10
36565,0,0,4,9,13
36566,0,0,6,6,12
36567,0,0,1,4,5
36568,0,0,2,4,6
36569,0,0,7,6,13
36570,0,0,3,14,17
36571,0,0,10,13,23
36572,0,0,0,6,6
36573,0,0,2,4,6
36574,0,0,1,9,10
36576,0,0,5,13,18
36577,0,0,5,11,16
36579,0,0,0,5,5
36580,0,1,2,12,15
36582,0,0,2,1,3
36584,0,0,2,3,5
36585,0,0,6,6,12
36586,0,0,0,12,12
36587,0,0,3,9,12
36588,0,0,4,11,15
36589,0,0,7,9,16
36590,0,0,7,7,14
36591,0,2,9,33,44
36592,0,1,6,20,27
36594,0,1,2,29,32
36595,0,0,2,13,15
36596,0,0,1,10,11
36597,0,0,2,14,16
36598,0,0,10,11,21
36600,0,0,2,6,8
36602,2,1,2,23,28
36604,0,1,4,12,17
36605,0,1,4,3,8
36606,0,0,1,9,10
36607,0,0,9,16,25
36608,1,0,15,24,40
36609,0,0,21,29,50
36610,0,1,6,11,18
36611,0,1,2,10,13
36613,0,1,7,20,28
36614,0,1,6,27,34
36615,0,0,6,9,15
36616,3,2,7,38,50
36617,1,0,6,21,28
36618,0,1,8,18,27
36619,0,0,9,19,28
36620,0,0,14,29,43
36621,0,0,9,15,24
36622,0,0,13,26,39
36623,0,0,10,30,40
36624,0,1,3,22,26
36625,0,0,6,4,10
36626,0,0,1,10,11
36627,0,0,3,9,12
36628,0,0,11,25,36
36629,0,0,14,22,36
36630,0,0,3,12,15
36631,0,0,3,6,9
36632,1,0,9,21,31
36633,0,2,4,11,17
36634,0,0,7,24,31
36635,0,0,2,6,8
36636,0,0,5,10,15
36637,0,0,10,9,19
36638,0,0,7,17,24
36639,0,0,7,18,25
36640,0,0,9,25,34
36641,0,0,10,15,25
36642,0,0,7,15,22
36643,0,0,6,15,21
36644,0,0,18,32,50
36645,0,1,16,31,48
36646,0,1,17,32,50
36648,0,1,17,32,50
36649,0,1,10,38,49
36650,1,0,9,10,20
36651,0,0,5,15,20
36652,2,0,1,28,31
36653,0,0,8,8,16
36654,0,1,14,24,39
36655,0,1,6,11,18
36656,0,0,6,13,19
36657,0,0,5,14,19
36658,0,0,13,18,31
36659,0,1,12,21,34
36660,0,1,6,20,27
36661,0,0,10,9,19
36662,0,0,0,3,3
36663,0,2,7,15,24
36664,0,0,1,16,17
36665,0,0,3,21,24
36666,0,0,2,12,14
36667,0,0,12,18,30
36668,1,1,5,3,10
36669,1,1,13,25,40
36670,0,1,4,12,17
36671,1,0,1,5,7
36672,0,0,8,14,22
36673,1,0,16,33,50
36675,0,0,10,12,22
36676,0,0,2,7,9
36677,0,1,7,24,32
36678,1,0,12,26,39
36679,0,0,12,30,42
36680,0,1,13,28,42
36681,0,0,4,14,18
36682,0,1,10,12,23
36683,2,2,1,16,21
36684,0,0,4,23,27
36685,0,0,8,14,22
36686,0,0,0,14,14
36687,0,2,8,13,23
36688,0,0,8,17,25
36689,0,0,11,25,36
36690,0,0,7,10,17
36691,0,0,10,15,25
36692,0,1,11,8,20
36693,0,0,4,5,9
36694,0,1,4,11,16
36695,0,0,15,29,44
36696,0,0,11,24,35
36697,0,0,4,8,12
36698,0,0,3,13,16
36699,1,0,8,14,23
36700,0,0,12,18,30
36701,1,0,6,15,22
36702,0,1,5,14,20
36703,0,1,2,20,23
36704,0,0,15,27,42
36705,0,0,0,6,6
36706,0,0,7,43,50
36707,0,0,5,5,10
36708,0,1,8,41,50
36709,0,0,8,11,19
36710,1,0,15,24,40
36711,0,0,13,37,50
36712,0,0,8,18,26
36713,1,0,7,21,29
36714,1,0,1,5,7
36715,1,0,6,14,21
36716,0,0,0,1,1
36717,0,1,7,21,29
36718,0,0,2,14,16
36719,0,1,7,20,28
36720,0,0,7,15,22
36721,0,0,5,12,17
36722,0,0,1,13,14
36723,6,1,4,39,50
36724,0,0,1,9,10
36726,0,0,6,7,13
36728,0,0,8,42,50
36729,0,0,2,13,15
36730,0,0,2,14,16
36731,0,1,2,10,13
36732,0,0,1,10,11
36733,0,0,21,29,50
36734,0,1,4,3,8
36736,0,0,6,9,15
36737,0,0,9,16,25
36738,0,1,6,27,34
36739,0,0,7,7,14
36740,0,0,6,13,19
36742,0,0,3,5,8
36743,2,0,5,39,46
36744,2,0,1,28,31
36745,0,0,4,21,25
36746,1,0,6,21,28
36747,1,1,3,45,50
36748,0,0,0,13,13
36749,0,0,1,10,11
36752,1,0,10,35,46
36753,0,0,8,12,20
36754,0,0,6,35,41
36755,1,0,3,17,21
36756,1,0,9,40,50
36757,0,1,12,36,49
36758,0,1,0,13,14
36759,0,1,12,31,44
36760,0,2,4,11,17
36761,1,0,3,4,8
36762,0,0,9,19,28
36763,0,0,12,13,25
36764,1,0,0,17,18
36765,1,0,15,24,40
36766,1,1,3,45,50
36767,0,0,9,19,28
36768,0,0,9,16,25
36769,0,1,6,20,27
36770,1,0,6,15,22
36771,0,0,5,16,21
36772,0,1,8,18,27
36773,2,1,2,23,28
36774,0,0,9,16,25
36775,1,0,15,24,40
36776,0,1,0,8,9
36777,0,0,5,4,9
36778,0,0,2,8,10
36779,0,0,2,18,20
36780,0,0,5,18,23
36781,0,0,2,11,13
36782,0,0,7,15,22
36783,0,0,6,7,13
36784,0,0,6,20,26
36785,0,0,3,2,5
36786,0,0,0,5,5
36787,0,1,3,8,12
36788,0,0,6,7,13
36789,0,0,10,13,23
36790,0,0,3,6,9
36791,0,0,4,5,9
36792,0,0,7,13,20
36793,0,0,3,13,16
36794,0,0,6,13,19
36795,0,0,0,5,5
36796,0,0,5,4,9
36797,0,0,3,8,11
36798,0,1,2,23,26
36799,0,1,2,4,7
36800,0,2,11,29,42
36801,0,1,1,7,9
36802,0,0,5,7,12
36803,0,0,5,26,31
36804,1,1,5,35,42
36805,0,0,6,11,17
36806,0,0,5,5,10
36807,0,0,2,6,8
36808,0,0,1,8,9
36809,0,0,10,26,36
36810,0,2,8,16,26
36811,0,0,8,12,20
36813,0,0,2,11,13
36814,0,0,5,5,10
36815,0,1,3,0,4
36817,0,0,2,20,22
36818,0,0,0,6,6
36819,0,0,2,14,16
36820,0,0,3,3,6
36821,0,0,5,44,49
36822,0,0,11,24,35
36823,0,0,8,28,36
36824,0,0,9,20,29
36825,0,0,2,20,22
36827,0,1,6,19,26
36828,0,0,4,10,14
36829,0,0,1,3,4
36830,0,0,6,18,24
36831,0,0,4,11,15
36833,0,0,4,8,12
36834,0,1,11,23,35
36835,0,0,4,14,18
36836,0,0,14,25,39
36837,0,0,3,9,12
36838,0,0,2,14,16
36839,0,1,14,24,39
36840,0,1,5,27,33
36841,0,0,4,12,16
36842,0,0,3,32,35
36843,0,1,13,25,39
36844,0,1,6,20,27
36845,0,0,4,11,15
36846,0,2,7,41,50
36847,0,0,6,15,21
36848,0,0,1,4,5
36849,0,1,9,28,38
36850,0,0,1,10,11
36851,0,0,3,14,17
36852,0,2,6,38,46
36853,0,1,12,26,39
36854,0,0,6,10,16
36855,0,0,9,19,28
36856,0,0,1,12,13
36857,0,0,3,19,22
36858,0,2,1,12,15
36859,0,2,8,18,28
36860,0,1,1,9,11
36862,0,0,1,22,23
36863,0,0,8,11,19
36864,0,0,5,3,8
36865,0,1,3,17,21
36866,0,1,6,12,19
36867,0,0,4,20,24
36868,0,0,1,9,10
36869,0,1,2,13,16
36870,0,0,4,31,35
36871,1,1,9,10,21
36872,0,0,15,22,37
36873,0,0,5,19,24
36874,0,2,2,5,9
36875,0,1,3,19,23
36876,0,0,5,10,15
36877,0,0,5,2,7
36878,0,1,8,11,20
36879,0,0,17,27,44
36880,0,0,6,1,7
36881,0,0,4,13,17
36882,0,0,4,6,10
36883,0,0,3,13,16
36884,0,0,1,11,12
36885,0,0,5,9,14
36886,0,0,7,8,15
36887,0,0,0,8,8
36888,0,0,11,16,27
36889,0,0,13,18,31
36890,0,0,3,5,8
36891,0,0,2,5,7
36892,3,0,7,11,21
36893,0,0,3,15,18
36894,0,3,10,20,33
36895,0,0,7,1,8
36896,0,0,10,26,36
36897,0,0,5,6,11
36898,0,0,8,28,36
36899,0,1,7,21,29
36900,0,0,1,7,8
36901,0,0,1,6,7
36902,0,1,10,14,25
36903,0,0,18,32,50
36904,0,0,2,3,5
36905,0,0,7,41,48
36906,0,0,1,9,10
36907,0,0,7,7,14
36908,0,0,4,22,26
36909,0,3,0,10,13
36910,0,0,6,23,29
36911,0,0,8,21,29
36912,0,0,0,7,7
36913,0,1,4,12,17
36914,0,1,1,40,42
36915,0,0,1,5,6
36916,0,0,3,6,9
36917,3,0,7,24,34
36918,0,0,2,12,14
36919,0,0,12,22,34
36921,0,0,10,14,24
36922,0,0,8,5,13
36923,0,1,6,9,16
36924,0,0,9,6,15
36925,0,0,2,7,9
36926,0,0,4,12,16
36927,0,0,2,4,6
36928,0,0,6,20,26
36930,0,0,5,9,14
36931,0,0,3,16,19
36932,1,0,5,19,25
36933,0,0,4,6,10
36934,0,0,2,6,8
36935,0,0,3,6,9
36936,0,0,15,20,35
36937,0,1,4,11,16
36938,0,0,2,3,5
36939,0,0,6,9,15
36940,0,0,13,21,34
36941,0,0,4,10,14
36942,0,1,8,12,21
36943,0,0,0,12,12
36944,0,1,8,34,43
36945,0,0,6,30,36
36946,0,0,1,1,2
36947,0,0,0,7,7
36948,0,0,4,11,15
36949,1,0,3,31,35
36950,0,0,8,10,18
36951,0,0,5,8,13
36952,0,0,8,9,17
36954,0,0,3,9,12
36955,0,0,7,23,30
36956,0,0,4,20,24
36957,0,0,2,10,12
36958,0,0,8,23,31
36959,0,0,10,24,34
36960,0,0,6,12,18
36961,0,0,2,3,5
36962,0,0,6,17,23
36963,0,0,5,3,8
36964,0,0,5,21,26
36965,0,0,1,16,17
36966,1,0,3,7,11
36967,0,0,8,12,20
36968,0,0,9,17,26
36969,0,0,3,6,9
36970,0,0,13,19,32
36971,0,0,7,7,14
36972,0,2,2,17,21
36973,0,0,4,15,19
36974,0,0,7,18,25
36975,0,0,7,19,26
36976,0,0,5,11,16
36977,0,0,1,8,9
36978,0,0,0,10,10
36979,0,0,9,9,18
36980,0,0,8,13,21
36981,0,0,12,29,41
36982,0,0,3,2,5
36983,0,0,8,18,26
36984,0,0,5,3,8
36986,0,0,0,5,5
36987,0,0,2,4,6
36988,0,0,4,10,14
36989,0,0,0,8,8
36990,0,1,6,20,27
36991,0,0,5,15,20
36992,0,0,9,27,36
36993,1,0,6,12,19
36994,0,0,18,29,47
36995,0,1,9,40,50
36996,1,0,0,4,5
36997,0,1,4,12,17
36998,0,0,5,6,11
36999,0,0,7,16,23
37000,0,0,8,9,17
37001,0,1,10,37,48
37002,0,4,7,22,33
37003,0,0,9,12,21
37004,0,0,8,18,26
37005,1,0,14,25,40
37006,0,0,2,5,7
37007,0,1,3,34,38
37008,0,0,13,17,30
37009,0,0,6,5,11
37010,0,0,4,8,12
37011,0,0,7,8,15
37012,0,1,9,26,36
37013,0,0,2,8,10
37014,0,1,1,6,8
37015,0,1,7,19,27
37016,0,0,9,18,27
37017,0,0,7,20,27
37018,0,1,8,5,14
37019,0,0,4,13,17
37020,0,0,4,23,27
37021,0,0,1,5,6
37022,2,2,13,22,39
37023,0,0,1,17,18
37024,0,1,13,25,39
37025,0,1,3,18,22
37026,0,0,1,5,6
37027,1,1,12,29,43
37029,0,0,5,2,7
37030,0,0,6,21,27
37031,0,0,7,14,21
37032,1,0,11,30,42
37033,0,0,4,11,15
37034,0,0,6,11,17
37035,0,0,2,8,10
37036,0,0,5,9,14
37037,0,0,3,4,7
37038,0,0,6,6,12
37039,0,0,4,5,9
37040,1,0,10,18,29
37041,0,0,5,13,18
37042,0,1,10,39,50
37044,0,0,4,9,13
37045,0,0,16,32,48
37046,1,0,9,31,41
37047,0,0,8,12,20
37048,0,0,10,17,27
37049,0,0,1,4,5
37050,0,0,5,13,18
37051,0,0,7,19,26
37052,0,1,2,10,13
37053,0,0,6,10,16
37054,1,1,12,33,47
37055,1,0,6,25,32
37056,0,0,1,0,1
37057,0,0,4,10,14
37058,0,0,5,12,17
37059,2,1,3,30,36
37060,0,0,6,14,20
37061,0,0,11,25,36
37062,0,0,5,7,12
37063,0,0,3,19,22
37064,0,1,12,37,50
37065,0,0,2,14,16
37066,0,0,6,10,16
37067,0,0,5,9,14
37068,0,0,7,7,14
37069,0,0,8,15,23
37070,0,0,5,14,19
37071,0,0,11,8,19
37072,1,0,4,12,17
37073,0,0,3,17,20
37074,0,0,4,0,4
37075,0,0,3,4,7
37076,0,0,9,20,29
37077,0,0,4,22,26
37078,0,0,10,32,42
37079,0,1,4,6,11
37080,0,0,3,4,7
37081,0,0,4,5,9
37082,1,0,2,20,23
37083,0,0,8,20,28
37084,0,0,3,16,19
37085,0,0,14,14,28
37086,0,4,6,18,28
37087,0,0,5,9,14
37088,0,0,1,10,11
37089,0,0,3,13,16
37090,0,0,1,3,4
37091,0,1,6,7,14
37092,0,0,3,5,8
37093,0,1,6,1,8
37094,0,1,1,9,11
37095,0,0,3,4,7
37097,0,0,5,6,11
37098,0,0,6,20,26
37099,0,0,12,25,37
37100,0,1,10,15,26
37101,0,0,2,7,9
37102,0,0,5,9,14
37103,0,0,7,13,20
37104,1,0,6,25,32
37105,0,0,2,8,10
37107,0,2,1,7,10
37108,0,0,10,20,30
37110,0,0,2,10,12
37111,0,1,7,6,14
37112,0,0,8,11,19
37113,0,0,10,23,33
37114,0,0,11,22,33
37116,0,0,5,11,16
37117,0,0,1,10,11
37118,0,0,6,7,13
37119,0,0,1,6,7
37120,0,0,8,10,18
37121,0,0,1,6,7
37122,1,0,2,8,11
37123,0,0,3,10,13
37124,0,0,5,4,9
37125,1,0,8,29,38
37126,0,1,4,29,34
37127,0,0,11,30,41
37128,0,1,0,9,10
37129,0,0,9,26,35
37130,2,0,2,11,15
37131,0,0,3,9,12
37132,0,0,6,9,15
37133,0,1,6,18,25
37134,0,0,3,5,8
37135,0,0,7,14,21
37136,0,0,9,3,12
37137,1,0,5,15,21
37139,0,0,5,9,14
37140,0,0,4,11,15
37141,0,0,6,20,26
37142,0,0,4,12,16
37143,0,0,10,12,22
37144,0,0,3,15,18
37145,0,0,11,19,30
37146,0,0,10,19,29
37147,0,0,3,2,5
37148,0,0,5,8,13
37149,0,0,3,8,11
37150,0,0,8,6,14
37151,0,0,2,5,7
37152,1,0,6,9,16
37153,0,0,2,11,13
37154,0,0,2,17,19
37155,0,1,8,12,21
37156,0,0,3,5,8
37157,1,0,2,14,17
37158,0,0,2,25,27
37159,0,1,5,10,16
37160,0,2,11,33,46
37161,0,0,6,9,15
37162,0,0,3,7,10
37163,0,0,3,19,22
37164,0,1,8,21,30
37165,0,0,0,4,4
37166,0,0,5,10,15
37167,0,0,4,7,11
37169,0,0,7,6,13
37170,0,0,13,31,44
37171,1,0,10,22,33
37172,0,0,10,29,39
37173,0,1,15,16,32
37174,1,1,5,15,22
37175,0,0,5,7,12
37176,1,3,16,27,47
37177,0,0,6,9,15
37178,0,0,14,22,36
37179,0,0,4,21,25
37180,0,0,4,10,14
37181,0,0,9,14,23
37182,0,0,8,8,16
37183,0,0,6,20,26
37184,0,0,1,7,8
37185,1,0,7,17,25
37186,0,0,5,9,14
37187,0,0,5,11,16
37188,0,0,2,3,5
37189,0,0,5,12,17
37190,0,0,10,25,35
37191,0,0,5,10,15
37192,0,0,3,24,27
37193,0,0,0,6,6
37194,0,0,2,12,14
37195,0,0,3,10,13
37196,0,0,8,14,22
37197,0,0,7,23,30
37198,0,0,7,12,19
37199,0,0,4,19,23
37200,0,0,5,7,12
37201,0,0,10,18,28
37202,2,4,0,13,19
37203,0,2,3,14,19
37204,0,0,13,16,29
37205,0,0,4,4,8
37206,0,0,3,5,8
37207,2,1,3,9,15
37208,0,0,10,16,26
37209,0,0,4,1,5
37210,0,1,3,14,18
37211,0,0,2,4,6
37212,0,2,8,29,39
37214,0,0,14,17,31
37215,0,0,4,7,11
37216,1,0,1,25,27
37217,0,0,14,25,39
37218,0,0,6,7,13
37219,0,0,3,4,7
37220,0,0,4,10,14
37221,2,0,3,14,19
37222,0,0,8,25,33
37223,0,0,5,5,10
37224,0,0,3,9,12
37225,0,0,6,4,10
37226,0,0,0,13,13
37227,0,0,7,11,18
37228,0,0,3,2,5
37229,0,2,7,26,35
37231,0,0,4,1,5
37232,0,1,13,26,40
37234,0,0,7,13,20
37235,0,0,3,8,11
37237,0,0,5,13,18
37238,0,0,2,6,8
37239,0,1,12,32,45
37240,1,0,5,7,13
37241,0,0,18,31,49
37242,1,0,8,29,38
37243,0,0,1,4,5
37244,0,0,5,13,18
37245,0,0,2,10,12
37246,1,0,5,4,10
37247,0,0,1,4,5
37248,0,0,2,9,11
37251,0,0,1,4,5
37253,1,0,5,2,8
37254,2,1,7,22,32
37255,0,3,15,24,42
37256,1,0,7,13,21
37257,0,0,4,7,11
37258,0,1,0,10,11
37259,0,1,1,5,7
37260,0,2,12,33,47
37261,0,0,1,4,5
37262,0,0,3,12,15
37263,0,0,7,9,16
37264,0,0,1,16,17
37267,0,0,1,4,5
37270,0,0,1,10,11
37271,1,1,10,38,50
37272,1,2,5,13,21
37273,0,0,2,7,9
37274,0,0,10,13,23
37275,0,0,6,14,20
37276,0,0,3,4,7
37277,0,1,3,8,12
37278,0,0,5,4,9
37280,0,1,5,20,26
37282,0,0,0,5,5
37283,0,0,6,20,26
37284,0,0,2,4,6
37285,1,0,15,24,40
37286,0,0,5,9,14
37287,0,1,0,8,9
37288,0,0,3,13,16
37289,0,0,9,16,25
37290,0,0,1,9,10
37291,0,0,18,30,48
37292,0,1,1,10,12
37293,0,0,3,6,9
37294,0,0,8,21,29
37295,1,0,0,4,5
37296,0,1,2,23,26
37297,0,0,3,8,11
37298,0,0,3,9,12
37299,0,0,13,27,40
37300,0,0,10,18,28
37301,0,2,4,23,29
37302,1,0,10,34,45
37303,0,2,11,29,42
37304,0,0,8,12,20
37305,0,0,5,36,41
37306,0,0,6,37,43
37307,0,0,3,12,15
37309,0,0,2,15,17
37310,0,0,1,2,3
37311,0,0,13,37,50
37312,0,0,12,36,48
37313,0,0,7,26,33
37314,0,0,4,9,13
37315,0,0,2,15,17
37316,0,0,13,27,40
37317,0,0,12,38,50
37318,0,0,7,42,49
37319,0,0,10,24,34
37320,0,0,8,21,29
37321,0,0,14,18,32
37322,0,0,13,37,50
37323,1,0,5,14,20
37324,0,0,16,34,50
37325,0,0,7,9,16
37326,0,0,3,3,6
37327,4,1,7,27,39
37328,0,0,3,5,8
37329,0,0,8,24,32
37330,0,0,7,13,20
37331,0,1,5,41,47
37332,0,0,9,17,26
37333,0,0,8,15,23
37334,0,0,7,15,22
37335,0,1,18,23,42
37337,0,1,0,6,7
37338,0,0,12,24,36
37339,0,2,13,35,50
37340,0,1,1,19,21
37341,0,0,19,31,50
37342,0,0,8,5,13
37343,0,0,4,12,16
37344,2,1,8,10,21
37345,0,0,6,44,50
37346,0,0,5,18,23
37347,1,0,3,8,12
37348,0,2,10,38,50
37349,0,0,0,5,5
37350,1,0,13,36,50
37351,0,0,7,43,50
37352,0,0,13,13,26
37353,0,0,7,17,24
37354,0,1,6,12,19
37355,0,1,12,24,37
37356,0,0,5,21,26
37357,0,0,5,13,18
37358,0,0,8,28,36
37359,0,0,4,21,25
37360,1,0,11,15,27
37361,0,0,6,26,32
37362,1,0,0,8,9
37363,0,0,14,28,42
37364,0,0,12,12,24
37365,2,0,10,27,39
37366,0,0,6,19,25
37367,0,1,9,23,33
37368,0,0,11,11,22
37369,0,2,5,26,33
37370,0,0,4,16,20
37371,0,0,10,33,43
37372,0,0,17,31,48
37373,0,0,1,7,8
37374,0,0,2,5,7
37375,1,0,6,24,31
37376,0,0,7,8,15
37377,1,0,7,27,35
37378,1,0,10,26,37
37379,0,0,5,9,14
37380,0,1,5,7,13
37381,0,0,6,16,22
37382,0,0,3,21,24
37383,1,1,10,18,30
37384,0,0,10,9,19
37385,0,0,12,28,40
37386,0,0,3,9,12
37387,0,1,3,19,23
37388,0,0,13,28,41
37389,1,0,8,20,29
37390,0,0,9,5,14
37391,1,1,15,33,50
37392,0,0,17,32,49
37393,0,0,3,14,17
37394,2,0,0,4,6
37395,0,0,10,27,37
37396,0,0,9,24,33
37397,0,0,8,9,17
37398,0,0,9,16,25
37399,0,0,17,33,50
37400,0,3,9,35,47
37401,1,0,16,33,50
37402,1,0,12,33,46
37403,0,0,9,21,30
37404,0,5,11,34,50
37406,0,0,13,37,50
37408,0,0,5,9,14
37409,1,1,9,39,50
37410,0,0,8,3,11
37411,1,0,10,33,44
37412,0,1,6,25,32
37413,0,0,12,38,50
37414,0,0,2,23,25
37415,0,0,5,3,8
37416,0,0,6,14,20
37417,0,0,10,19,29
37418,0,0,5,3,8
37419,0,0,9,20,29
37420,0,0,7,7,14
37421,0,0,3,18,21
37422,0,0,10,37,47
37423,0,0,4,13,17
37424,0,1,7,25,33
37425,1,0,4,14,19
37426,0,0,4,8,12
37427,0,0,13,33,46
37428,1,0,5,12,18
37429,0,0,15,34,49
37430,0,0,13,37,50
37431,0,2,7,38,47
37432,1,0,3,9,13
37433,0,0,18,29,47
37434,0,0,3,16,19
37435,0,1,9,7,17
37437,0,0,6,8,14
37438,0,0,16,34,50
37439,0,0,17,21,38
37440,0,0,7,14,21
37441,0,0,13,22,35
37442,0,0,15,35,50
37443,0,0,4,21,25
37444,0,0,1,4,5
37445,0,0,15,32,47
37446,0,0,7,11,18
37447,0,1,11,29,41
37448,3,1,1,25,30
37449,0,1,8,41,50
37450,0,0,9,26,35
37451,1,0,9,31,41
37452,1,1,8,35,45
37454,0,0,1,7,8
37455,0,0,3,12,15
37456,0,0,4,17,21
37457,1,0,8,34,43
37458,0,0,2,3,5
37459,0,0,3,27,30
37461,0,1,0,9,10
37462,0,0,12,36,48
37463,0,0,20,30,50
37464,0,0,4,10,14
37465,0,0,9,19,28
37466,0,0,9,29,38
37467,0,0,14,31,45
37468,0,0,5,19,24
37469,0,1,2,19,22
37470,1,0,2,9,12
37471,0,0,2,13,15
37472,0,1,12,36,49
37473,3,0,3,20,26
37474,0,0,8,1,9
37475,0,1,11,17,29
37476,1,1,14,33,49
37477,0,0,5,6,11
37478,0,0,0,7,7
37479,0,0,4,8,12
37480,0,0,7,9,16
37481,0,0,5,3,8
37482,1,0,1,7,9
37483,0,0,5,7,12
37484,1,0,7,23,31
37485,1,1,4,15,21
37486,0,1,10,15,26
37487,0,0,3,17,20
37488,0,1,0,11,12
37489,0,0,11,33,44
37490,0,0,8,21,29
37491,0,0,4,7,11
37492,1,0,12,18,31
37493,0,0,8,18,26
37494,0,0,9,37,46
37495,0,0,6,17,23
37496,4,1,2,32,39
37497,0,0,6,14,20
37498,0,0,8,5,13
37499,0,0,3,5,8
37500,0,1,2,12,15
37501,1,0,3,13,17
37502,0,1,4,9,14
37503,0,0,3,10,13
37504,0,0,15,32,47
37505,0,0,11,35,46
37506,0,0,10,24,34
37507,0,0,3,5,8
37508,0,0,7,25,32
37509,0,0,3,11,14
37510,1,0,7,24,32
37511,0,0,3,8,11
37512,0,0,6,1,7
37513,0,0,11,39,50
37514,0,2,8,13,23
37515,0,0,13,37,50
37516,0,0,1,6,7
37517,0,1,5,20,26
37518,0,0,9,36,45
37519,0,0,8,4,12
37520,0,0,2,5,7
37521,0,0,6,11,17
37522,1,2,20,25,48
37523,0,0,2,7,9
37524,2,0,6,14,22
37525,1,0,1,7,9
37526,0,0,6,9,15
37527,1,1,6,39,47
37528,1,2,5,14,22
37529,0,0,3,14,17
37530,0,0,4,6,10
37531,0,0,11,17,28
37532,0,0,6,13,19
37533,3,0,2,17,22
37534,0,0,9,20,29
37535,0,1,4,31,36
37537,0,0,6,12,18
37538,0,0,1,4,5
37539,0,0,3,8,11
37540,0,1,6,26,33
37541,0,4,8,26,38
37542,0,0,10,7,17
37543,0,2,15,33,50
37544,0,0,0,7,7
37545,0,0,6,20,26
37546,0,0,3,4,7
37547,0,0,9,16,25
37548,0,0,5,13,18
37549,0,0,7,11,18
37550,0,0,3,2,5
37551,0,0,3,18,21
37552,0,2,9,17,28
37553,1,0,15,24,40
37555,0,0,2,9,11
37556,1,0,14,33,48
37557,0,0,8,36,44
37558,0,0,5,19,24
37559,0,0,1,16,17
37560,0,0,10,10,20
37561,0,1,12,32,45
37562,0,0,0,1,1
37563,0,1,6,23,30
37564,2,1,11,36,50
37565,0,0,14,22,36
37567,0,0,6,6,12
37568,0,0,3,7,10
37571,0,0,15,27,42
37572,0,1,0,4,5
37573,1,0,5,12,18
37574,0,0,18,29,47
37575,0,0,14,33,47
37576,0,2,11,37,50
37577,0,0,4,6,10
37578,0,0,2,3,5
37579,0,1,6,4,11
37580,0,0,0,4,4
37581,0,0,3,5,8
37582,1,0,5,34,40
37583,0,0,0,7,7
37584,0,0,10,19,29
37585,0,0,3,18,21
37586,0,0,12,37,49
37587,0,0,9,27,36
37590,0,0,3,12,15
37591,0,2,4,16,22
37592,0,0,1,16,17
37593,1,2,5,13,21
37594,0,0,2,4,6
37595,0,0,2,14,16
37596,0,2,12,33,47
37597,0,1,14,24,39
37598,0,0,2,3,5
37599,0,1,1,13,15
37600,0,0,5,15,20
37601,0,0,2,7,9
37602,1,1,10,38,50
37603,0,1,2,10,13
37604,0,0,5,4,9
37605,0,0,9,16,25
37606,0,0,1,10,11
37607,0,0,3,4,7
37608,0,0,2,4,6
37609,0,0,9,37,46
37611,0,0,16,34,50
37612,0,1,2,4,7
37613,0,0,2,3,5
37614,0,0,7,28,35
37615,0,0,3,9,12
37616,0,1,15,16,32
37617,0,0,18,30,48
37619,1,0,0,4,5
37620,0,0,8,21,29
37621,0,1,2,23,26
37622,3,1,6,22,32
37623,1,0,1,13,15
37624,0,0,1,17,18
37625,0,0,3,30,33
37626,1,0,10,15,26
37627,1,1,8,39,49
37628,0,0,3,27,30
37629,0,0,19,31,50
37631,2,0,6,15,23
37632,0,0,4,11,15
37633,0,0,8,20,28
37634,1,0,3,8,12
37635,0,1,5,20,26
37636,1,0,5,17,23
37637,0,0,2,11,13
37638,0,0,6,6,12
37639,1,0,0,8,9
37640,0,0,7,23,30
37641,0,3,5,27,35
37642,0,0,3,11,14
37643,0,0,15,35,50
37644,1,2,8,16,27
37645,0,0,6,10,16
37646,1,0,7,19,27
37647,1,1,8,35,45
37648,4,1,2,32,39
37649,1,0,5,21,27
37651,1,0,12,31,44
37652,3,0,3,20,26
37653,0,0,2,12,14
37654,0,0,1,4,5
37655,0,0,4,14,18
37656,1,1,9,28,39
37657,2,0,8,40,50
37658,2,0,6,14,22
37659,0,1,5,20,26
37660,0,1,1,13,15
37661,0,0,4,6,10
37662,1,0,0,17,18
37663,0,0,0,10,10
37664,0,0,1,8,9
37666,0,0,7,28,35
37667,0,0,8,36,44
37668,1,2,5,11,19
37670,0,2,15,33,50
37671,0,0,1,2,3
37673,0,1,3,18,22
37674,0,0,16,34,50
37675,0,0,6,14,20
37676,0,2,4,16,22
37677,1,1,10,38,50
37678,0,0,9,37,46
37679,0,0,2,18,20
37680,0,0,1,16,17
37681,5,0,4,24,33
37683,0,0,6,14,20
37684,0,0,8,28,36
37685,1,2,3,12,18
37686,0,0,4,20,24
37687,0,1,18,23,42
37689,0,0,0,5,5
37690,0,0,14,36,50
37691,1,0,5,12,18
37692,0,0,7,7,14
37693,0,0,2,18,20
37694,0,0,3,17,20
37695,0,1,1,9,11
37696,1,0,15,24,40
37697,1,1,10,38,50
37698,0,0,1,16,17
37699,0,0,3,8,11
37700,0,1,1,5,7
37701,0,0,9,16,25
37702,0,0,5,9,14
37703,0,1,6,20,27
37704,1,1,10,38,50
37705,0,0,1,20,21
37706,0,1,14,24,39
37707,0,3,9,9,21
37708,0,0,15,32,47
37709,0,0,10,13,23
37710,1,0,0,4,5
37711,0,0,9,16,25
37712,0,0,9,37,46
37713,1,0,3,9,13
37714,0,3,9,9,21
37715,0,1,2,23,26
37716,0,2,12,33,47
37717,1,0,15,24,40
37718,0,0,6,14,20
37719,1,2,2,9,14
37720,0,1,4,7,12
37721,0,0,3,3,6
37722,0,0,1,6,7
37723,0,0,11,20,31
37724,0,0,3,11,14
37725,2,1,6,30,39
37726,0,0,1,11,12
37727,1,0,5,23,29
37728,1,0,2,9,12
37729,0,0,8,28,36
37730,0,0,2,6,8
37731,0,0,13,13,26
37732,0,0,3,6,9
37733,0,0,4,10,14
37734,0,0,2,4,6
37735,0,0,1,4,5
37736,0,0,10,32,42
37737,0,0,2,10,12
37738,0,0,9,20,29
37739,0,0,7,8,15
37740,0,0,2,14,16
37741,0,0,0,5,5
37742,0,0,2,9,11
37743,1,0,7,26,34
37744,0,1,2,16,19
37745,0,2,4,13,19
37746,0,0,7,5,12
37747,0,0,0,2,2
37748,0,0,1,9,10
37749,0,0,2,20,22
37750,0,2,4,9,15
37751,0,0,2,12,14
37752,0,0,4,16,20
37753,0,0,2,27,29
37754,0,0,7,13,20
37755,0,0,4,31,35
37756,1,0,10,39,50
37757,0,0,3,19,22
37758,0,0,3,21,24
37759,0,0,6,6,12
37760,0,0,2,6,8
37761,0,0,2,4,6
37762,0,0,13,11,24
37763,0,0,9,19,28
37764,0,1,3,19,23
37765,0,0,3,9,12
37766,0,0,4,4,8
37767,0,0,6,8,14
37768,0,0,7,16,23
37769,0,0,1,5,6
37770,1,1,9,38,49
37771,0,0,4,16,20
37772,0,1,2,11,14
37773,0,1,6,10,17
37774,0,0,6,9,15
37775,0,1,5,10,16
37777,1,1,4,24,30
37778,0,0,8,8,16
37779,0,0,3,12,15
37780,0,1,7,28,36
37781,0,0,2,11,13
37782,0,0,7,12,19
37783,2,0,2,6,10
37785,0,0,2,12,14
37786,0,0,4,6,10
37787,0,1,11,20,32
37788,0,2,4,17,23
37790,0,0,7,16,23
37791,0,1,6,7,14
37792,0,0,10,24,34
37793,0,0,9,26,35
37794,0,1,0,4,5
37795,0,0,4,11,15
37796,0,0,6,18,24
37797,0,1,5,12,18
37798,0,1,4,3,8
37800,1,0,7,28,36
37801,0,0,1,7,8
37802,0,3,2,11,16
37803,0,0,0,6,6
37804,0,1,14,30,45
37805,0,0,5,13,18
37806,0,0,2,15,17
37807,0,0,9,13,22
37808,0,0,1,3,4
37809,0,2,4,24,30
37810,0,0,4,14,18
37811,0,0,8,12,20
37812,0,1,1,12,14
37813,0,0,3,8,11
37815,2,0,8,16,26
37816,0,0,3,14,17
37817,0,0,3,9,12
37818,0,0,4,5,9
37819,0,0,5,7,12
37820,0,0,3,7,10
37821,0,1,6,19,26
37822,0,0,12,26,38
37823,0,0,2,6,8
37824,0,0,4,9,13
37825,1,0,5,11,17
37826,0,0,3,2,5
37827,0,2,2,28,32
37828,0,1,8,13,22
37829,0,0,1,2,3
37830,1,0,8,40,49
37831,0,0,3,9,12
37832,0,1,3,11,15
37833,8,0,4,38,50
37834,0,1,7,2,10
37835,0,1,3,9,13
37836,0,0,2,2,4
37837,1,0,5,9,15
37838,0,1,7,23,31
37839,0,2,1,7,10
37841,0,0,10,6,16
37842,0,0,6,21,27
37843,0,0,2,8,10
37844,1,0,12,36,49
37845,0,0,2,8,10
37846,0,2,7,14,23
37847,0,2,12,32,46
37848,0,0,4,25,29
37849,0,0,0,7,7
37850,0,0,0,1,1
37853,0,0,2,12,14
37854,1,0,1,7,9
37855,0,1,0,3,4
37856,0,0,16,23,39
37857,0,0,1,5,6
37858,0,0,8,7,15
37859,1,7,2,13,23
37861,0,0,6,10,16
37862,0,0,2,8,10
37863,0,0,1,9,10
37865,0,0,2,7,9
37866,0,0,4,10,14
37867,0,1,2,8,11
37868,0,0,10,13,23
37869,0,0,7,13,20
37871,1,0,5,44,50
37872,0,0,2,5,7
37873,0,0,2,11,13
37874,3,1,4,31,39
37875,1,1,10,38,50
37880,1,2,2,9,14
37882,0,0,9,35,44
37883,0,0,1,6,7
37884,4,0,6,38,48
37885,0,1,1,37,39
37886,0,0,16,34,50
37887,0,0,1,4,5
37888,0,0,8,21,29
37889,0,0,2,9,11
37890,0,0,1,5,6
37891,0,0,8,18,26
37892,0,0,2,8,10
37893,0,0,3,7,10
37894,0,0,5,20,25
37895,0,0,10,23,33
37896,0,0,1,17,18
37897,0,0,5,18,23
37898,0,0,3,9,12
37899,0,0,5,8,13
37900,1,0,4,4,9
37901,2,1,4,43,50
37902,0,0,5,21,26
37903,0,0,2,6,8
37904,0,0,9,40,49
37905,0,0,7,13,20
37906,0,0,5,6,11
37907,1,4,12,24,41
37908,0,0,5,15,20
37909,0,0,0,3,3
37910,0,0,6,6,12
37911,0,0,16,19,35
37912,0,0,5,1,6
37913,0,0,7,2,9
37914,0,1,3,19,23
37915,0,0,10,32,42
37916,1,0,10,39,50
37917,1,0,3,25,29
37918,1,0,5,16,22
37919,1,1,7,21,30
37920,0,0,4,7,11
37921,1,0,3,12,16
37922,0,0,0,2,2
37923,0,0,12,33,45
37924,0,1,6,18,25
37925,0,0,16,24,40
37926,0,1,5,12,18
37927,0,0,8,15,23
37928,0,2,0,4,6
37929,1,0,6,40,47
37930,0,0,6,22,28
37931,1,0,6,6,13
37932,0,0,2,5,7
37933,0,1,8,20,29
37934,0,0,5,13,18
37935,0,0,1,15,16
37936,0,1,1,6,8
37937,0,1,5,35,41
37938,0,1,2,11,14
37939,0,0,10,23,33
37941,0,1,4,35,40
37942,0,1,0,11,12
37943,0,0,9,26,35
37944,1,0,16,28,45
37945,0,0,15,34,49
37946,1,0,5,13,19
37947,2,3,4,23,32
37948,1,0,2,32,35
37949,3,1,3,14,21
37950,0,1,6,12,19
37951,0,2,4,27,33
37952,1,0,2,15,18
37953,0,0,8,18,26
37954,0,0,1,8,9
37955,0,0,11,24,35
37956,0,0,4,12,16
37957,0,0,16,34,50
37958,1,0,8,17,26
37959,0,0,1,4,5
37961,0,0,4,6,10
37962,2,0,4,23,29
37963,0,0,2,10,12
37964,0,1,3,18,22
37965,0,0,15,33,48
37966,0,0,7,5,12
37967,0,1,6,16,23
37968,0,0,1,4,5
37969,0,0,6,13,19
37970,0,2,3,5,10
37971,1,1,4,17,23
37972,0,0,5,5,10
37973,1,0,15,20,36
37974,1,0,10,17,28
37975,0,2,9,39,50
37976,1,1,7,40,49
37977,0,0,4,9,13
37978,0,0,3,10,13
37979,1,1,6,17,25
37980,0,1,4,8,13
37981,0,1,11,20,32
37982,0,0,5,7,12
37983,1,1,9,34,45
37984,0,1,4,11,16
37985,0,1,4,22,27
37986,0,1,4,10,15
37987,0,0,6,16,22
37989,1,0,10,18,29
37990,0,0,2,13,15
37992,0,0,11,9,20
37993,1,0,0,26,27
37996,0,0,5,16,21
37997,0,0,9,13,22
37998,3,1,4,31,39
37999,2,0,2,11,15
38000,0,0,11,13,24
38001,0,1,11,14,26
38002,0,0,4,6,10
38003,0,0,6,21,27
38004,1,0,3,5,9
38005,0,0,3,6,9
38006,0,0,3,11,14
38008,0,0,1,14,15
38009,1,0,0,9,10
38010,0,0,3,7,10
38011,0,1,0,11,12
38012,1,0,5,44,50
38013,0,0,2,12,14
38014,1,0,7,21,29
38015,0,0,3,12,15
38016,1,1,10,38,50
38017,0,0,1,5,6
38018,8,0,4,38,50
38019,5,1,5,39,50
38020,0,1,3,5,9
38021,0,0,1,6,7
38022,1,2,2,9,14
38023,1,7,2,13,23
38024,1,3,9,34,47
38025,1,1,5,15,22
38026,0,0,8,38,46
38027,0,1,5,41,47
38028,4,0,6,38,48
38029,0,1,6,43,50
38030,0,0,0,18,18
38031,0,0,0,12,12
38032,0,0,1,5,6
38033,0,0,1,16,17
38034,0,0,12,38,50
38035,0,1,3,7,11
38036,0,0,16,33,49
38037,0,0,6,12,18
38038,0,1,0,11,12
38039,3,1,4,31,39
38040,0,0,1,14,15
38041,0,0,3,3,6
38042,1,0,0,9,10
38043,0,1,11,38,50
38044,0,0,3,22,25
38045,1,0,2,15,18
38046,0,0,2,19,21
38047,4,0,10,34,48
38048,1,1,10,38,50
38049,0,0,8,19,27
38050,1,0,8,22,31
38051,0,0,3,13,16
38052,0,0,5,11,16
38053,0,0,9,15,24
38054,1,1,10,38,50
38055,0,0,8,21,29
38056,0,0,13,19,32
38057,4,0,10,34,48
38058,0,0,2,9,11
38060,1,1,10,38,50
38061,1,0,5,13,19
38062,0,0,4,10,14
38064,0,0,2,8,10
38065,0,0,6,12,18
38066,0,0,0,7,7
38067,0,1,2,4,7
38068,0,1,4,22,27
38069,0,0,6,11,17
38072,0,0,6,7,13
38073,0,0,7,13,20
38074,0,0,0,5,5
38075,0,0,6,20,26
38076,0,1,2,4,7
38077,0,0,5,4,9
38078,0,0,5,4,9
38079,0,0,5,14,19
38080,0,0,2,3,5
38081,0,1,7,33,41
38082,0,0,1,12,13
38083,0,0,4,14,18
38084,0,1,1,21,23
38085,0,1,4,25,30
38086,0,0,6,24,30
38087,0,0,2,12,14
38088,0,0,13,21,34
38089,0,0,1,14,15
38091,0,0,5,45,50
38092,1,0,8,23,32
38093,0,1,9,25,35
38094,0,1,2,15,18
38095,0,1,1,25,27
38096,1,0,6,22,29
38097,0,1,9,21,31
38098,0,0,8,18,26
38099,0,0,2,13,15
38100,0,0,9,9,18
38101,0,0,7,31,38
38102,0,0,2,9,11
38103,0,0,15,26,41
38104,1,0,4,17,22
38105,0,0,1,9,10
38106,0,1,4,19,24
38107,0,0,8,14,22
38108,0,0,10,32,42
38109,0,0,9,34,43
38110,0,0,3,15,18
38111,0,0,5,13,18
38112,0,0,2,6,8
38113,0,0,2,24,26
38114,0,0,0,3,3
38115,1,0,4,41,46
38116,0,0,6,22,28
38118,0,0,13,15,28
38119,0,0,3,7,10
38120,0,0,1,6,7
38121,0,0,2,8,10
38122,0,0,8,13,21
38123,2,1,9,27,39
38124,0,0,7,16,23
38125,0,0,1,14,15
38126,0,1,8,20,29
38127,0,2,4,17,23
38128,0,0,0,7,7
38129,0,1,6,8,15
38131,0,0,4,3,7
38132,0,0,8,12,20
38133,1,0,7,30,38
38134,0,0,0,14,14
38135,0,0,6,6,12
38136,0,0,5,11,16
38137,0,0,2,4,6
38139,0,0,11,7,18
38140,0,0,3,5,8
38141,0,0,2,21,23
38142,0,3,5,7,15
38143,0,0,4,1,5
38144,0,1,3,20,24
38145,0,1,10,37,48
38146,1,0,8,33,42
38147,0,0,4,12,16
38148,0,1,2,13,16
38149,0,0,6,10,16
38150,0,0,4,21,25
38151,0,0,4,11,15
38152,1,0,4,10,15
38153,1,0,5,16,22
38154,0,0,3,18,21
38155,0,1,2,17,20
38156,0,0,5,16,21
38157,0,0,1,1,2
38158,0,0,0,17,17
38159,1,0,2,3,6
38161,0,0,9,33,42
38162,1,0,8,25,34
38163,0,0,6,38,44
38164,0,0,7,10,17
38165,0,1,0,14,15
38166,1,1,6,10,18
38167,0,0,5,10,15
38169,1,0,11,17,29
38170,2,1,1,15,19
38171,0,0,1,9,10
38172,0,0,4,17,21
38173,0,1,1,16,18
38174,0,0,7,15,22
38175,0,0,3,6,9
38176,0,0,8,19,27
38177,0,0,4,11,15
38178,0,0,2,8,10
38180,0,0,4,14,18
38181,0,0,9,38,47
38182,0,1,5,10,16
38183,0,0,11,25,36
38184,0,0,8,28,36
38185,0,0,7,8,15
38186,1,0,5,19,25
38187,0,0,7,10,17
38188,0,0,0,5,5
38189,0,0,4,13,17
38190,0,0,8,22,30
38191,0,1,1,8,10
38192,0,0,1,15,16
38193,0,1,6,21,28
38194,0,1,6,13,20
38195,0,1,1,25,27
38196,0,0,7,8,15
38197,0,1,13,36,50
38198,0,1,5,15,21
38199,0,0,6,5,11
38200,0,0,8,12,20
38201,0,1,10,14,25
38202,0,0,4,17,21
38203,0,0,6,9,15
38204,0,0,1,8,9
38205,0,0,6,11,17
38206,0,1,2,17,20
38207,1,1,10,17,29
38208,0,0,7,11,18
38209,0,0,6,11,17
38210,0,0,7,8,15
38211,0,1,4,7,12
38212,0,4,14,31,49
38213,0,0,1,3,4
38214,0,0,1,8,9
38215,1,0,5,23,29
38216,0,0,1,17,18
38217,0,0,7,9,16
38218,0,1,8,27,36
38219,0,0,4,1,5
38221,0,0,4,4,8
38222,0,1,7,15,23
38223,0,0,1,12,13
38224,0,0,5,4,9
38226,0,0,1,4,5
38227,1,2,2,27,32
38228,0,0,9,4,13
38229,0,0,9,22,31
38230,1,0,2,30,33
38231,0,0,17,26,43
38232,0,0,3,13,16
38233,1,1,8,26,36
38234,0,1,2,8,11
38235,0,0,5,16,21
38236,0,0,10,29,39
38237,0,0,3,4,7
38238,0,0,3,13,16
38239,0,0,0,7,7
38240,0,0,2,17,19
38241,0,0,4,4,8
38242,0,0,6,4,10
38243,0,1,2,8,11
38244,0,0,0,5,5
38245,0,0,5,5,10
38246,0,0,2,8,10
38247,0,2,2,3,7
38248,1,0,7,42,50
38249,0,0,2,7,9
38251,0,1,2,9,12
38252,0,1,6,22,29
38253,0,0,0,11,11
38254,0,0,1,7,8
38255,0,0,1,9,10
38256,0,0,6,4,10
38257,0,0,4,8,12
38258,0,1,4,3,8
38259,0,1,6,13,20
38260,0,1,8,18,27
38261,0,0,1,11,12
38262,0,0,7,4,11
38263,0,0,7,8,15
38265,0,1,7,41,49
38266,0,0,3,5,8
38267,0,0,8,8,16
38269,0,0,3,7,10
38270,0,0,1,9,10
38271,0,0,8,6,14
38272,0,0,11,23,34
38273,0,0,9,14,23
38274,0,1,6,34,41
38275,2,2,12,25,41
38276,0,0,5,8,13
38277,0,1,9,37,47
38278,0,0,11,25,36
38279,0,0,5,3,8
38280,0,0,2,5,7
38281,1,2,13,33,49
38283,0,0,2,13,15
38284,0,0,6,44,50
38285,0,0,0,5,5
38286,0,0,19,31,50
38287,0,0,2,10,12
38288,0,0,10,27,37
38289,0,0,1,9,10
38290,0,0,6,9,15
38291,0,0,4,20,24
38292,0,0,2,14,16
38293,0,1,13,29,43
38294,0,0,9,24,33
38295,0,0,8,6,14
38296,0,0,5,8,13
38297,0,0,9,24,33
38298,1,1,10,26,38
38299,0,0,14,17,31
38300,0,0,8,15,23
38301,0,0,11,26,37
38302,1,1,1,16,19
38303,1,0,9,25,35
38304,0,2,2,20,24
38305,0,0,2,13,15
38306,0,0,1,7,8
38307,0,0,1,4,5
38308,0,0,5,11,16
38309,0,0,5,6,11
38310,0,0,9,9,18
38311,0,0,6,13,19
38313,0,0,1,25,26
38314,0,0,2,8,10
38315,0,1,4,9,14
38316,0,0,1,3,4
38317,0,0,8,14,22
38318,0,1,9,16,26
38319,0,0,1,7,8
38320,0,0,3,31,34
38321,0,0,5,12,17
38322,0,1,4,33,38
38324,0,0,13,9,22
38325,0,0,9,6,15
38326,0,0,3,4,7
38327,0,0,4,8,12
38328,0,1,4,16,21
38329,0,0,5,13,18
38330,0,0,10,19,29
38331,0,0,0,1,1
38332,0,0,4,25,29
38333,0,0,1,6,7
38334,0,0,4,2,6
38335,0,0,2,10,12
38336,0,0,5,5,10
38337,0,0,8,9,17
38338,0,0,5,11,16
38339,0,0,2,14,16
38340,0,0,2,8,10
38341,0,0,3,5,8
38342,0,0,0,11,11
38343,0,0,6,8,14
38344,0,1,8,13,22
38345,0,1,0,9,10
38346,0,1,7,12,20
38347,1,1,11,26,39
38348,0,1,4,12,17
38349,0,1,1,16,18
38350,0,1,3,7,11
38351,2,0,11,11,24
38352,0,0,7,18,25
38353,0,0,2,12,14
38354,0,0,0,6,6
38355,0,0,7,3,10
38356,0,1,1,6,8
38357,0,0,4,10,14
38358,0,1,1,5,7
38359,0,0,1,19,20
38360,0,0,3,4,7
38361,0,1,6,13,20
38362,0,0,3,6,9
38363,0,0,4,1,5
38364,0,0,8,11,19
38365,0,0,6,14,20
38366,0,0,4,8,12
38367,0,0,3,3,6
38368,0,0,9,8,17
38369,0,0,5,5,10
38370,0,1,2,12,15
38371,0,0,3,13,16
38372,0,0,4,5,9
38373,0,1,6,19,26
38374,0,0,6,15,21
38375,0,0,10,10,20
38376,0,0,5,7,12
38377,0,0,8,24,32
38378,0,0,4,3,7
38379,0,0,9,14,23
38380,0,0,8,9,17
38381,0,1,7,16,24
38382,0,0,5,18,23
38383,0,0,5,9,14
38384,0,0,5,3,8
38385,0,0,9,16,25
38386,0,0,5,15,20
38387,0,0,5,13,18
38388,0,0,1,1,2
38389,0,0,16,34,50
38390,1,2,1,30,34
38391,0,1,5,28,34
38393,0,1,9,10,20
38394,0,0,10,15,25
38395,0,0,7,28,35
38396,0,0,2,5,7
38397,0,0,4,26,30
38398,1,1,1,3,6
38399,2,1,2,31,36
38400,1,1,9,15,26
38401,0,0,4,6,10
38402,0,0,2,5,7
38403,0,0,2,13,15
38404,0,0,0,5,5
38405,2,0,9,39,50
38406,0,0,3,16,19
38407,0,0,4,8,12
38408,0,0,1,10,11
38409,0,0,1,7,8
38410,0,0,2,7,9
38411,2,2,11,35,50
38412,0,0,1,12,13
38413,0,0,5,17,22
38414,0,0,4,6,10
38415,0,0,10,19,29
38417,0,0,7,25,32
38418,0,0,3,6,9
38419,0,0,1,7,8
38421,0,0,3,3,6
38422,1,1,6,17,25
38423,0,0,5,2,7
38424,0,2,6,27,35
38425,0,0,4,9,13
38426,0,0,0,2,2
38427,0,0,12,28,40
38428,0,0,4,9,13
38429,0,0,7,12,19
38430,0,0,2,8,10
38431,0,0,2,14,16
38432,0,0,1,8,9
38433,0,1,6,42,49
38434,0,0,8,9,17
38435,0,0,5,7,12
38436,0,0,5,9,14
38438,0,0,3,3,6
38439,0,1,4,9,14
38440,0,0,7,26,33
38441,0,0,2,7,9
38442,0,0,7,30,37
38443,0,0,6,8,14
38444,0,0,3,15,18
38445,0,0,0,5,5
38446,0,1,5,18,24
38449,0,1,13,29,43
38450,0,1,3,2,6
38451,0,1,1,10,12
38452,0,1,2,10,13
38454,0,0,5,17,22
38455,0,0,7,15,22
38456,0,0,6,6,12
38457,0,1,8,24,33
38458,0,0,1,16,17
38459,0,0,11,17,28
38460,0,1,4,29,34
38461,0,0,5,4,9
38462,0,0,5,14,19
38463,0,0,3,11,14
38465,0,0,6,11,17
38466,0,0,14,16,30
38467,0,0,3,10,13
38469,0,0,3,18,21
38470,1,0,4,15,20
38471,0,0,6,9,15
38472,4,0,4,23,31
38473,0,0,4,2,6
38474,1,1,7,13,22
38475,0,0,1,8,9
38476,0,0,8,11,19
38477,0,2,4,9,15
38480,0,0,20,29,49
38481,0,0,8,10,18
38483,0,2,7,11,20
38485,0,2,7,25,34
38486,0,0,6,14,20
38487,0,0,1,4,5
38488,0,0,2,8,10
38489,3,0,1,1,5
38490,0,0,1,2,3
38491,0,0,4,7,11
38492,0,0,3,9,12
38493,0,0,3,7,10
38494,0,2,2,14,18
38495,0,1,4,17,22
38496,0,0,4,15,19
38497,0,0,6,5,11
38498,0,0,8,14,22
38500,1,0,0,8,9
38502,0,0,8,40,48
38504,0,0,4,11,15
38505,0,0,3,2,5
38506,0,0,6,5,11
38507,0,0,2,5,7
38508,0,0,0,5,5
38511,0,0,0,4,4
38513,0,0,7,7,14
38516,0,1,12,19,32
38517,0,0,7,23,30
38519,0,0,15,35,50
38520,0,0,4,13,17
38521,0,0,1,16,17
38522,0,0,2,19,21
38523,0,0,7,7,14
38524,0,0,2,3,5
38525,0,1,3,5,9
38526,0,1,13,25,39
38527,1,0,4,11,16
38528,0,1,3,18,22
38529,1,1,10,38,50
38530,0,0,6,7,13
38531,0,0,4,3,7
38532,0,0,7,13,20
38533,0,1,4,22,27
38534,0,1,2,5,8
38535,0,0,6,20,26
38536,0,0,0,11,11
38537,1,0,3,16,20
38538,0,0,4,20,24
38539,0,0,0,10,10
38540,0,1,2,4,7
38541,0,0,8,21,29
38542,0,0,1,8,9
38543,0,0,7,9,16
38544,0,0,8,36,44
38545,0,0,9,31,40
38546,0,0,8,21,29
38547,0,1,12,19,32
38548,0,0,15,35,50
38549,0,1,1,21,23
38550,0,1,9,21,31
38551,0,1,16,33,50
38553,0,0,8,18,26
38554,0,0,12,30,42
38555,0,2,3,38,43
38556,0,0,5,45,50
38557,0,0,12,10,22
38558,0,0,4,23,27
38559,1,0,3,20,24
38560,0,0,3,18,21
38561,0,0,4,14,18
38563,0,0,2,4,6
38564,0,0,8,25,33
38565,0,3,9,38,50
38566,0,5,4,37,46
38567,0,0,6,33,39
38568,0,1,17,32,50
38569,0,0,11,35,46
38570,0,0,1,9,10
38571,0,0,6,23,29
38573,0,2,8,12,22
38574,1,0,22,24,47
38575,0,0,1,29,30
38576,0,1,7,25,33
38577,0,0,3,13,16
38578,0,1,1,18,20
38579,0,2,8,20,30
38580,0,0,12,21,33
38581,0,0,2,24,26
38582,0,1,4,15,20
38583,0,0,4,45,49
38584,2,0,7,21,30
38585,1,0,3,23,27
38586,0,1,6,33,40
38587,0,0,8,13,21
38588,0,0,1,6,7
38589,0,1,6,8,15
38590,1,1,10,38,50
38591,0,0,7,14,21
38592,0,0,2,27,29
38593,1,0,9,40,50
38594,0,0,8,14,22
38595,1,0,4,11,16
38596,4,3,2,17,26
38597,0,0,8,12,20
38598,0,0,2,7,9
38599,0,0,3,31,34
38600,0,2,3,32,37
38601,2,0,1,25,28
38602,0,0,3,6,9
38603,0,0,16,34,50
38604,0,0,3,13,16
38605,0,1,3,20,24
38606,0,0,1,4,5
38607,2,1,12,31,46
38608,0,0,1,37,38
38609,0,1,10,37,48
38610,1,2,9,27,39
38611,0,0,2,9,11
38612,0,0,1,18,19
38613,0,0,9,9,18
38614,0,0,0,8,8
38615,0,0,9,41,50
38616,0,0,7,10,17
38617,2,0,8,25,35
38618,1,0,6,19,26
38619,5,0,3,19,27
38620,0,0,4,11,15
38621,0,0,10,18,28
38622,0,0,3,5,8
38623,0,0,8,42,50
38624,0,0,7,18,25
38625,0,0,1,14,15
38626,0,0,3,1,4
38627,0,0,9,41,50
38628,0,0,1,9,10
38629,0,0,10,18,28
38630,0,1,1,15,17
38631,0,1,0,14,15
38632,0,2,13,35,50
38633,0,1,14,27,42
38634,0,1,6,27,34
38635,0,2,8,17,27
38636,3,0,12,30,45
38637,1,0,12,35,48
38638,0,0,3,18,21
38639,0,0,1,15,16
38640,0,1,11,25,37
38641,0,0,4,17,21
38643,0,0,9,12,21
38644,0,2,3,37,42
38645,0,1,7,15,23
38646,0,0,11,25,36
38647,1,0,8,20,29
38648,0,0,2,8,10
38649,0,1,2,46,49
38650,1,0,6,10,17
38651,0,0,11,25,36
38652,1,0,2,9,12
38653,0,0,2,21,23
38654,0,0,4,12,16
38655,0,0,12,30,42
38656,0,0,1,15,16
38657,0,0,6,5,11
38658,0,0,2,3,5
38659,0,0,1,8,9
38660,0,0,8,24,32
38661,0,0,8,9,17
38663,0,0,7,11,18
38664,0,1,2,12,15
38665,0,0,6,16,22
38666,0,0,0,6,6
38667,0,0,4,13,17
38668,0,1,0,11,12
38669,0,0,6,25,31
38670,1,0,7,27,35
38671,0,0,8,16,24
38673,0,0,18,32,50
38675,0,0,8,25,33
38676,0,1,8,13,22
38677,0,0,11,29,40
38678,3,0,3,11,17
38679,0,0,6,44,50
38680,1,2,7,29,39
38681,0,1,6,17,24
38682,0,0,4,10,14
38683,0,0,6,5,11
38684,0,0,5,9,14
38685,0,0,5,22,27
38686,0,1,8,41,50
38687,0,1,11,19,31
38688,0,0,3,10,13
38689,0,0,12,29,41
38690,0,1,5,17,23
38691,0,0,5,11,16
38693,0,1,1,4,6
38694,0,1,8,40,49
38695,0,0,11,37,48
38696,0,0,9,8,17
38697,0,4,1,19,24
38698,0,0,11,25,36
38699,0,0,8,17,25
38700,0,1,3,20,24
38701,0,1,1,11,13
38702,0,1,10,30,41
38703,0,0,17,24,41
38704,1,0,9,16,26
38705,1,2,4,12,19
38706,0,0,5,4,9
38707,0,1,1,17,19
38708,0,0,1,4,5
38710,0,0,11,5,16
38711,0,0,14,32,46
38712,0,0,5,10,15
38713,0,0,7,18,25
38714,0,1,2,9,12
38715,0,0,7,16,23
38718,0,0,5,9,14
38719,0,0,6,5,11
38720,0,0,7,9,16
38722,0,0,9,8,17
38723,0,0,5,10,15
38724,0,0,9,17,26
38725,0,1,4,10,15
38726,0,1,9,32,42
38727,1,0,7,38,46
38728,0,0,5,33,38
38729,0,0,5,4,9
38730,0,0,3,6,9
38731,1,0,4,22,27
38732,1,0,10,15,26
38733,0,0,4,9,13
38734,1,0,10,29,40
38735,1,0,7,24,32
38736,0,0,8,16,24
38737,0,0,3,24,27
38738,0,1,9,16,26
38739,0,0,4,17,21
38740,1,0,12,16,29
38741,0,1,10,34,45
38742,0,1,1,13,15
38743,0,0,3,7,10
38744,0,0,10,40,50
38745,0,2,7,34,43
38746,2,0,9,16,27
38747,0,0,2,9,11
38748,1,2,7,31,41
38749,0,0,7,6,13
38750,0,0,8,11,19
38751,1,0,5,12,18
38752,0,0,9,18,27
38753,0,0,6,26,32
38754,0,0,2,5,7
38755,0,0,9,31,40
38756,0,0,10,26,36
38757,0,0,15,30,45
38758,0,0,6,19,25
38759,0,0,2,16,18
38760,0,0,7,5,12
38761,3,0,5,26,34
38762,0,0,2,19,21
38763,0,1,9,30,40
38764,1,0,8,6,15
38765,0,0,10,17,27
38766,0,0,8,41,49
38767,0,1,11,17,29
38768,1,0,10,27,38
38769,0,1,4,42,47
38770,1,1,8,16,26
38771,0,0,1,9,10
38772,0,0,6,25,31
38773,0,1,4,18,23
38775,7,2,7,32,48
38776,3,0,3,33,39
38777,0,1,7,12,20
38778,0,0,7,21,28
38779,0,0,4,5,9
38780,0,0,2,4,6
38781,1,0,4,13,18
38782,0,0,0,13,13
38783,0,0,5,13,18
38784,0,1,2,11,14
38785,0,0,10,36,46
38786,0,0,4,11,15
38787,1,1,6,9,17
38788,0,0,3,11,14
38789,1,1,13,24,39
38790,0,0,5,15,20
38791,0,2,0,15,17
38792,0,0,8,16,24
38793,1,0,2,11,14
38794,7,0,0,16,23
38795,1,0,3,24,28
38796,1,0,2,13,16
38797,2,0,4,31,37
38798,3,1,6,22,32
38800,0,0,11,36,47
38801,0,1,1,4,6
38802,0,0,2,5,7
38803,0,0,4,13,17
38804,0,0,2,16,18
38805,0,0,7,13,20
38806,0,0,3,24,27
38807,0,0,1,2,3
38808,0,0,9,7,16
38809,1,0,1,11,13
38810,0,1,3,21,25
38811,0,0,0,4,4
38813,0,0,5,8,13
38814,0,0,9,24,33
38815,1,0,3,9,13
38816,0,0,19,31,50
38817,1,0,4,11,16
38818,1,1,4,7,13
38819,0,0,19,22,41
38820,0,0,1,16,17
38821,0,0,9,9,18
38822,0,0,0,2,2
38824,1,0,4,2,7
38825,0,0,16,34,50
38826,0,0,0,11,11
38827,0,0,9,16,25
38828,0,1,3,5,9
38829,1,1,10,38,50
38831,1,0,6,15,22
38832,0,0,5,3,8
38833,0,0,1,7,8
38834,0,1,10,19,30
38835,0,1,14,35,50
38836,2,0,9,39,50
38837,0,2,3,15,20
38838,0,1,2,4,7
38839,0,0,8,21,29
38840,0,0,6,9,15
38841,0,0,1,8,9
38842,0,0,13,27,40
38843,0,0,10,23,33
38845,0,1,6,43,50
38846,0,0,8,21,29
38847,2,0,7,21,30
38848,0,0,8,18,26
38849,1,0,22,24,47
38850,0,0,4,45,49
38851,0,5,4,37,46
38853,1,0,3,12,16
38854,0,2,1,9,12
38855,0,1,4,30,35
38856,4,0,4,20,28
38857,0,0,0,11,11
38858,0,0,0,2,2
38859,0,0,12,27,39
38860,0,0,7,18,25
38861,0,0,4,11,15
38862,0,0,0,6,6
38863,0,0,6,12,18
38864,0,0,12,31,43
38865,0,1,1,20,22
38866,0,0,2,19,21
38868,0,1,15,34,50
38869,1,0,12,35,48
38870,1,0,1,13,15
38871,0,0,1,16,17
38872,0,0,2,7,9
38873,0,0,8,11,19
38875,1,0,3,16,20
38876,0,0,11,37,48
38877,1,0,9,18,28
38878,0,0,13,20,33
38879,0,1,3,20,24
38880,2,0,12,34,48
38881,0,0,0,5,5
38882,1,0,7,11,19
38884,0,0,0,1,1
38885,0,1,5,26,32
38886,0,1,1,13,15
38887,0,0,8,41,49
38888,0,0,8,4,12
38890,3,0,3,33,39
38892,1,0,4,2,7
38893,0,0,4,11,15
38894,1,1,10,38,50
38895,1,0,6,19,26
38896,0,1,1,13,15
38898,0,0,8,12,20
38899,0,1,2,14,17
38900,0,1,3,18,22
38901,0,0,1,16,17
38902,0,1,3,22,26
38903,0,1,7,36,44
38904,0,1,2,21,24
38905,1,1,4,18,24
38906,0,2,3,38,43
38907,3,0,4,10,17
38909,5,0,3,19,27
38910,1,1,7,21,30
38911,0,1,5,15,21
38912,0,1,14,35,50
38913,0,2,3,15,20
38914,0,0,7,7,14
38915,1,1,10,38,50
38916,0,0,1,16,17
38917,0,0,5,3,8
38918,1,1,10,38,50
38919,1,1,4,7,13
38920,4,3,2,17,26
38921,1,0,6,15,22
38922,0,0,9,16,25
38923,1,1,4,7,13
38924,1,1,10,38,50
38925,1,1,4,7,13
38926,0,0,10,26,36
38927,0,2,3,15,20
38928,0,1,10,19,30
38929,1,0,3,9,13
38930,0,0,9,16,25
38931,0,0,2,12,14
38932,1,1,4,7,13
38933,1,1,4,8,14
38934,0,0,2,20,22
38935,1,0,5,15,21
38936,0,0,3,7,10
38937,0,4,18,28,50
38939,0,0,3,4,7
38940,1,1,13,33,48
38941,0,0,2,9,11
38942,0,0,3,9,12
38943,0,0,10,18,28
38944,0,0,4,12,16
38945,0,1,0,6,7
38946,0,0,12,19,31
38947,0,0,1,6,7
38948,1,2,9,32,44
38949,0,4,18,28,50
38950,1,0,14,32,47
38951,0,0,12,19,31
38952,1,2,9,32,44
38953,1,0,10,7,18
38954,0,0,10,18,28
38955,1,1,4,8,14
38956,0,0,12,19,31
38957,0,0,10,18,28
38958,0,0,10,19,29
38959,0,1,6,12,19
38960,0,1,7,14,22
38962,0,1,11,17,29
38963,0,0,4,23,27
38964,0,0,6,10,16
38965,0,0,11,22,33
38966,0,0,8,17,25
38967,0,0,11,19,30
38968,0,0,3,7,10
38969,0,3,1,4,8
38970,0,0,2,2,4
38971,0,0,8,20,28
38972,0,0,8,18,26
38973,0,0,9,15,24
38974,0,1,1,25,27
38975,0,0,12,32,44
38976,0,0,8,26,34
38977,0,0,4,8,12
38978,0,0,4,11,15
38979,0,0,7,5,12
38980,0,0,1,5,6
38981,0,0,4,14,18
38982,0,0,3,6,9
38983,0,2,3,1,6
38984,0,0,8,10,18
38985,0,0,5,6,11
38986,1,3,6,22,32
38987,0,0,4,6,10
38988,0,1,6,12,19
38989,1,0,4,17,22
38991,1,1,12,33,47
38992,3,2,3,31,39
38993,0,0,10,27,37
38994,0,0,1,5,6
38995,0,0,1,8,9
38996,0,0,9,18,27
38997,0,0,4,5,9
38999,0,1,3,11,15
39000,0,0,5,16,21
39001,0,0,5,18,23
39002,0,0,7,6,13
39003,0,0,5,26,31
39004,0,1,14,35,50
39005,0,0,9,20,29
39006,0,0,1,16,17
39007,0,0,9,16,25
39008,0,0,6,21,27
39009,0,0,5,21,26
39010,0,0,1,13,14
39011,0,3,2,15,20
39012,0,0,6,11,17
39013,0,0,7,38,45
39014,1,0,15,30,46
39015,0,0,9,13,22
39016,0,0,4,16,20
39017,0,0,6,7,13
39018,0,0,4,14,18
39019,0,0,7,13,20
39020,0,0,1,4,5
39021,0,0,5,8,13
39022,0,0,7,17,24
39024,0,0,1,5,6
39025,0,0,3,14,17
39026,0,0,5,4,9
39027,0,2,6,10,18
39028,0,0,3,4,7
39029,0,1,6,21,28
39030,0,0,16,21,37
39031,0,0,0,6,6
39032,0,1,7,7,15
39033,0,0,10,5,15
39034,0,0,7,12,19
39035,0,0,8,15,23
39036,0,0,2,4,6
39037,0,0,3,4,7
39038,0,1,8,6,15
39039,0,0,8,14,22
39040,0,0,4,2,6
39041,0,0,4,11,15
39042,0,0,0,2,2
39043,0,0,2,9,11
39044,0,0,9,12,21
39045,0,0,2,5,7
39046,0,3,4,37,44
39047,0,1,4,11,16
39049,0,5,3,10,18
39050,0,0,3,9,12
39051,0,0,3,6,9
39052,0,0,3,25,28
39053,0,0,6,11,17
39054,0,1,7,18,26
39055,0,0,3,8,11
39056,0,0,5,12,17
39058,0,0,2,8,10
39059,0,0,4,5,9
39060,0,0,3,19,22
39061,0,0,6,10,16
39062,0,0,2,5,7
39063,0,0,5,4,9
39064,0,0,2,7,9
39065,0,0,8,23,31
39066,0,0,9,12,21
39067,0,0,4,11,15
39068,0,0,4,5,9
39069,0,0,8,12,20
39070,0,0,8,2,10
39071,0,0,2,5,7
39072,0,0,8,15,23
39073,0,0,2,13,15
39074,0,0,5,11,16
39075,0,0,2,3,5
39076,0,1,5,13,19
39077,0,0,3,5,8
39078,0,0,0,3,3
39079,0,0,2,16,18
39080,0,0,1,4,5
39081,0,1,5,9,15
39082,0,0,5,19,24
39083,0,0,4,11,15
39084,0,0,7,16,23
39085,0,0,3,3,6
39086,0,0,4,19,23
39087,0,2,5,43,50
39088,0,1,7,21,29
39089,0,0,5,6,11
39090,0,0,12,22,34
39092,0,1,17,31,49
39093,1,1,0,24,26
39094,1,2,5,30,38
39095,0,0,7,8,15
39096,0,0,3,5,8
39097,0,0,4,28,32
39098,0,0,2,5,7
39099,0,0,0,5,5
39101,0,0,1,2,3
39102,0,0,4,1,5
39103,0,0,7,9,16
39105,0,0,0,5,5
39106,0,0,7,22,29
39107,0,0,2,8,10
39108,1,0,2,7,10
39109,0,0,3,2,5
39111,0,2,15,15,32
39112,1,0,1,3,5
39113,0,0,3,12,15
39114,0,0,2,8,10
39116,0,0,3,4,7
39118,1,0,0,3,4
39121,0,0,5,17,22
39122,0,0,10,27,37
39123,0,0,15,22,37
39124,0,0,7,19,26
39125,1,1,9,13,24
39126,0,3,8,39,50
39127,0,0,4,8,12
39128,0,0,1,12,13
39129,0,1,5,21,27
39130,0,0,1,9,10
39131,0,1,4,20,25
39132,0,2,3,22,27
39133,0,3,14,25,42
39134,0,0,12,28,40
39135,0,0,6,15,21
39136,0,0,5,13,18
39137,1,1,4,8,14
39138,0,0,7,16,23
39139,0,0,0,2,2
39140,0,0,8,13,21
39141,0,0,7,12,19
39142,1,0,3,16,20
39143,0,1,3,6,10
39144,0,0,2,13,15
39145,0,1,0,6,7
39146,0,0,7,14,21
39147,1,0,0,4,5
39148,0,1,11,24,36
39149,0,0,0,10,10
39150,0,0,2,9,11
39151,4,0,2,17,23
39152,0,0,8,19,27
39153,1,0,14,32,47
39154,0,1,15,26,42
39155,0,0,10,27,37
39156,0,1,10,21,32
39157,0,0,7,19,26
39158,0,0,2,10,12
39159,1,0,9,39,49
39160,0,3,8,39,50
39161,0,1,5,11,17
39162,0,1,4,22,27
39163,0,1,9,21,31
39164,0,0,17,24,41
39165,0,0,8,13,21
39166,0,0,10,5,15
39167,0,0,6,7,13
39168,0,0,7,21,28
39169,0,2,6,20,28
39170,0,2,6,10,18
39171,0,0,3,2,5
39172,0,0,10,12,22
39173,0,0,7,17,24
39174,0,0,3,2,5
39175,1,0,1,1,3
39176,0,0,10,23,33
39177,0,0,16,15,31
39178,1,0,0,4,5
39179,0,0,2,4,6
39180,0,0,6,7,13
39181,0,0,3,1,4
39183,0,0,0,7,7
39184,0,0,13,17,30
39185,0,0,14,27,41
39186,0,0,9,9,18
39187,0,0,7,15,22
39188,0,0,3,7,10
39189,0,0,0,3,3
39190,1,0,3,16,20
39191,0,1,4,20,25
39192,0,0,7,16,23
39193,0,1,5,21,27
39194,0,0,0,2,2
39195,0,0,7,38,45
39196,0,0,5,26,31
39197,0,0,4,14,18
39198,0,0,8,18,26
39199,0,0,8,26,34
39200,0,0,4,6,10
39201,0,0,6,8,14
39202,0,0,6,11,17
39203,0,0,7,8,15
39204,0,0,7,12,19
39205,0,0,4,4,8
39206,0,0,3,8,11
39207,0,1,6,22,29
39208,0,0,2,9,11
39209,0,0,10,27,37
39210,0,0,6,38,44
39211,0,1,9,35,45
39212,0,0,7,38,45
39213,0,0,8,13,21
39214,0,1,11,26,38
39215,1,0,1,1,3
39216,0,0,0,3,3
39217,1,2,2,14,19
39218,1,0,1,1,3
39219,0,0,2,4,6
39220,4,0,2,17,23
39221,0,0,1,9,10
39222,0,0,16,15,31
39223,0,0,10,27,37
39224,0,0,7,17,24
39225,0,0,7,21,28
39226,0,1,6,22,29
39227,0,0,3,2,5
39228,0,0,5,8,13
39229,0,0,2,7,9
39230,0,0,4,18,22
39231,1,1,4,8,14
39232,0,0,3,7,10
39233,0,0,5,4,9
39234,0,0,3,14,17
39235,0,0,6,6,12
39236,4,0,2,17,23
39238,0,1,15,26,42
39239,0,0,15,22,37
39240,0,0,5,17,22
39241,0,0,8,26,34
39242,0,2,15,15,32
39243,0,0,4,8,12
39245,0,0,14,27,41
39246,1,1,9,13,24
39247,0,1,5,11,17
39248,0,2,3,22,27
39249,0,0,5,13,18
39250,0,0,0,2,2
39251,0,0,4,14,18
39252,0,0,6,15,21
39253,0,0,4,8,12
39254,0,0,6,10,16
39255,1,1,12,33,47
39256,0,0,10,5,15
39257,0,0,4,4,8
39258,0,0,6,8,14
39259,0,0,4,11,15
39260,0,2,11,37,50
39261,0,0,1,6,7
39262,0,0,5,8,13
39263,0,0,4,12,16
39264,0,0,7,5,12
39265,0,0,3,5,8
39266,0,0,3,5,8
39267,0,0,1,6,7
39268,0,0,2,9,11
39269,0,0,1,8,9
39270,0,1,3,10,14
39271,0,0,10,20,30
39272,0,0,10,11,21
39273,0,0,5,7,12
39274,0,0,5,19,24
39275,0,0,10,19,29
39276,0,0,3,18,21
39277,0,0,4,13,17
39278,0,3,8,38,49
39279,0,2,15,15,32
39280,0,0,10,36,46
39281,0,0,7,10,17
39282,6,3,5,25,39
39283,0,0,4,4,8
39284,0,0,7,7,14
39285,0,0,2,2,4
39286,0,0,7,15,22
39287,0,0,10,14,24
39288,0,1,13,35,49
39289,0,0,7,19,26
39290,0,0,8,17,25
39291,0,0,3,14,17
39292,0,0,4,12,16
39293,0,1,6,11,18
39294,0,0,1,9,10
39295,0,0,4,12,16
39296,0,0,2,21,23
39297,0,0,4,10,14
39298,0,0,7,14,21
39299,0,0,4,11,15
39300,0,0,8,13,21
39301,0,0,10,27,37
39302,0,0,8,19,27
39303,0,0,9,35,44
39304,0,0,1,4,5
39305,0,0,8,13,21
39306,1,0,18,31,50
39307,0,0,5,16,21
39308,0,0,13,24,37
39309,0,0,10,18,28
39310,0,0,4,1,5
39311,0,0,3,12,15
39312,0,0,2,3,5
39313,0,1,6,7,14
39314,0,0,12,16,28
39315,0,0,4,7,11
39316,0,0,11,14,25
39317,0,0,1,5,6
39318,0,2,14,22,38
39319,0,1,8,23,32
39320,0,0,4,8,12
39321,0,2,2,12,16
39322,0,3,14,27,44
39323,0,0,6,18,24
39324,0,0,1,6,7
39325,0,1,4,13,18
39326,0,0,0,10,10
39327,0,0,8,13,21
39328,0,0,2,12,14
39329,0,3,14,24,41
39330,0,0,5,13,18
39331,0,0,9,19,28
39332,0,0,2,4,6
39333,0,0,5,10,15
39334,0,2,5,20,27
39335,0,0,5,6,11
39336,0,0,14,15,29
39337,0,0,9,19,28
39338,0,4,18,28,50
39339,0,0,9,17,26
39340,0,0,5,4,9
39341,1,0,3,9,13
39342,0,0,4,23,27
39343,1,1,4,8,14
39344,0,0,15,24,39
39345,0,0,3,10,13
39346,5,8,8,27,48
39347,0,0,1,7,8
39348,0,0,1,8,9
39349,0,0,3,4,7
39350,0,0,11,8,19
39351,0,0,9,18,27
39352,0,0,2,8,10
39354,0,0,4,14,18
39355,0,0,6,15,21
39356,0,1,3,11,15
39357,0,0,9,11,20
39358,0,2,8,14,24
39359,0,0,7,30,37
39360,0,1,5,15,21
39361,0,0,2,11,13
39362,0,1,5,3,9
39363,0,0,8,24,32
39364,0,0,5,26,31
39365,0,0,5,8,13
39366,0,0,8,18,26
39367,1,0,7,9,17
39368,0,0,3,11,14
39369,0,1,2,6,9
39370,0,0,1,8,9
39371,0,0,6,6,12
39372,0,0,10,16,26
39373,0,0,8,17,25
39374,0,0,3,7,10
39375,0,0,11,19,30
39376,0,0,1,3,4
39377,0,2,3,10,15
39378,2,3,6,37,48
39379,0,0,4,9,13
39380,0,0,4,5,9
39381,0,0,4,6,10
39382,0,0,11,12,23
39383,0,0,5,9,14
39384,0,0,0,8,8
39385,0,0,4,9,13
39386,0,4,1,11,16
39387,0,1,1,3,5
39388,0,0,17,19,36
39389,0,0,11,20,31
39390,0,0,5,10,15
39391,1,0,8,26,35
39392,0,0,5,17,22
39393,0,1,8,19,28
39394,0,0,5,11,16
39395,0,0,1,9,10
39396,0,0,1,4,5
39397,0,0,11,34,45
39398,0,1,9,9,19
39399,0,0,4,14,18
39400,0,0,12,12,24
39401,0,0,6,12,18
39402,0,0,6,9,15
39403,0,0,9,12,21
39404,0,0,1,5,6
39405,0,1,4,13,18
39406,0,0,3,10,13
39407,0,0,5,10,15
39408,1,0,4,10,15
39409,0,0,6,9,15
39410,0,0,2,8,10
39411,0,0,2,5,7
39412,0,0,3,6,9
39413,1,1,8,36,46
39414,0,0,12,29,41
39415,0,0,7,13,20
39416,0,0,6,12,18
39417,0,0,6,9,15
39418,1,1,19,28,49
39419,0,0,9,24,33
39420,0,0,5,9,14
39421,0,0,7,5,12
39422,0,0,5,14,19
39423,0,0,4,24,28
39424,0,0,5,13,18
39425,0,2,4,19,25
39426,1,1,4,8,14
39427,0,0,4,8,12
39428,0,0,9,18,27
39429,0,0,4,8,12
39430,0,0,2,3,5
39431,0,0,3,3,6
39432,0,0,5,9,14
39433,0,1,7,15,23
39434,0,0,5,6,11
39435,0,0,3,3,6
39436,0,0,7,11,18
39437,0,2,11,24,37
39438,0,0,11,29,40
39439,0,0,7,15,22
39440,0,0,0,11,11
39441,0,0,9,11,20
39442,0,0,10,12,22
39443,0,0,8,8,16
39444,0,0,5,10,15
39445,0,0,6,11,17
39446,0,1,9,33,43
39447,0,0,4,9,13
39448,0,0,1,5,6
39449,0,0,8,12,20
39450,0,0,5,25,30
39451,0,0,4,8,12
39452,0,0,4,10,14
39453,0,0,4,10,14
39454,0,0,15,25,40
39455,0,0,3,12,15
39456,0,0,3,7,10
39457,0,0,11,19,30
39458,0,0,14,21,35
39459,0,0,1,6,7
39460,0,0,5,8,13
39461,0,2,4,5,11
39462,0,0,6,10,16
39463,0,1,7,19,27
39464,0,0,10,20,30
39465,0,0,4,11,15
39466,1,1,1,8,11
39468,0,0,2,26,28
39469,0,0,6,8,14
39470,0,1,5,8,14
39471,0,0,5,12,17
39472,0,0,10,18,28
39473,0,1,10,18,29
39474,0,0,3,14,17
39475,0,0,1,6,7
39476,0,2,12,18,32
39477,0,0,4,8,12
39478,0,0,1,6,7
39479,0,0,4,10,14
39480,0,0,4,11,15
39481,0,0,7,13,20
39482,0,0,4,10,14
39483,0,0,7,6,13
39484,0,0,8,7,15
39485,0,0,3,4,7
39486,0,0,12,24,36
39487,0,0,7,7,14
39488,0,2,6,17,25
39489,0,0,4,3,7
39490,0,0,12,22,34
39491,0,0,2,12,14
39492,0,0,8,15,23
39493,0,0,2,12,14
39494,0,2,7,34,43
39495,0,0,8,19,27
39496,1,0,3,16,20
39497,0,0,7,6,13
39498,0,1,4,11,16
39499,1,0,9,40,50
39500,0,0,5,9,14
39501,0,0,4,13,17
39502,0,0,5,9,14
39503,0,0,4,7,11
39504,0,0,3,6,9
39505,0,1,5,21,27
39507,0,0,0,5,5
39508,0,0,2,2,4
39509,0,1,3,21,25
39510,0,0,5,7,12
39511,0,0,6,11,17
39512,0,0,1,15,16
39514,0,1,18,23,42
39516,1,0,6,9,16
39517,0,0,8,14,22
39518,0,0,10,8,18
39519,0,0,8,18,26
39520,0,0,12,15,27
39521,0,0,2,6,8
39522,0,0,6,10,16
39523,0,1,7,24,32
39524,0,0,1,2,3
39525,0,1,4,3,8
39526,0,0,0,1,1
39527,0,0,7,11,18
39528,0,0,5,13,18
39529,0,0,5,5,10
39530,0,0,6,13,19
39531,0,0,11,21,32
39532,0,0,10,28,38
39533,0,0,6,4,10
39534,0,2,4,6,12
39535,0,0,12,38,50
39536,0,0,2,6,8
39537,0,1,13,10,24
39538,0,0,5,5,10
39539,0,0,5,6,11
39540,0,0,6,12,18
39541,0,0,2,4,6
39542,0,2,5,7,14
39543,0,0,3,2,5
39544,1,0,4,16,21
39545,0,0,2,6,8
39546,0,0,13,17,30
39547,0,1,4,13,18
39548,0,0,0,5,5
39549,0,1,10,28,39
39550,0,0,3,2,5
39551,0,0,3,10,13
39552,0,0,0,5,5
39553,0,0,12,15,27
39554,0,0,10,7,17
39555,0,1,9,29,39
39556,0,0,2,8,10
39557,0,0,10,29,39
39558,0,0,6,14,20
39559,0,0,8,18,26
39560,0,0,2,4,6
39561,0,0,8,16,24
39562,0,0,5,5,10
39563,0,0,1,10,11
39564,0,0,5,7,12
39565,1,1,5,11,18
39566,0,1,11,31,43
39567,0,0,5,18,23
39568,0,4,2,12,18
39569,0,0,2,11,13
39570,0,2,7,17,26
39571,0,0,0,20,20
39572,0,0,5,7,12
39573,0,1,12,37,50
39574,0,0,8,9,17
39575,0,0,5,9,14
39576,0,0,6,14,20
39577,1,0,0,10,11
39578,0,0,10,2,12
39579,0,0,9,19,28
39580,0,1,2,4,7
39581,0,2,4,7,13
39582,0,0,3,4,7
39583,0,0,3,4,7
39584,0,0,13,21,34
39585,0,0,7,5,12
39586,0,0,4,4,8
39587,0,3,7,19,29
39588,0,1,3,11,15
39589,0,0,3,12,15
39590,0,0,1,1,2
39591,0,0,1,6,7
39592,0,0,12,12,24
39593,0,1,5,14,20
39594,0,0,8,18,26
39595,0,0,2,4,6
39596,0,0,13,28,41
39597,0,0,3,6,9
39598,0,0,6,6,12
39599,0,0,2,9,11
39600,0,0,0,9,9
39601,0,0,7,12,19
39602,2,0,6,24,32
39603,0,0,5,11,16
39604,0,0,4,6,10
39605,0,0,0,1,1
39606,0,0,6,19,25
39607,0,0,5,10,15
39608,0,0,5,5,10
39609,0,3,7,6,16
39610,0,0,0,6,6
39611,0,0,1,2,3
39612,0,0,4,2,6
39613,0,0,2,2,4
39614,1,2,6,33,42
39615,0,0,6,19,25
39616,0,0,4,6,10
39617,0,0,3,20,23
39618,0,0,3,7,10
39619,0,0,5,17,22
39620,0,0,0,5,5
39621,2,1,7,20,30
39622,0,0,6,9,15
39623,0,1,5,2,8
39624,0,0,9,10,19
39625,0,0,3,7,10
39626,0,0,0,5,5
39627,0,0,5,5,10
39628,1,1,6,41,49
39629,0,0,14,32,46
39630,0,0,12,27,39
39631,0,0,1,10,11
39632,0,0,2,6,8
39633,0,2,10,19,31
39634,0,0,2,6,8
39635,0,0,3,9,12
39636,0,2,9,12,23
39637,0,0,6,13,19
39638,0,1,2,15,18
39639,0,0,11,25,36
39640,0,2,5,17,24
39641,0,0,9,13,22
39642,0,0,5,10,15
39643,0,0,0,2,2
39645,0,1,2,8,11
39646,0,0,5,21,26
39647,0,1,1,4,6
39648,0,1,5,3,9
39649,0,0,10,11,21
39650,0,0,4,6,10
39651,0,0,2,3,5
39652,0,0,2,10,12
39653,0,0,5,18,23
39654,0,0,1,6,7
39655,0,0,6,11,17
39656,0,2,3,11,16
39658,0,0,14,24,38
39659,0,0,3,11,14
39660,0,0,2,9,11
39661,0,0,5,4,9
39662,0,0,3,12,15
39663,0,0,6,19,25
39664,0,0,8,12,20
39665,0,0,7,3,10
39666,0,1,6,8,15
39667,0,0,3,5,8
39668,0,1,1,21,23
39669,0,1,4,6,11
39670,0,0,2,3,5
39671,0,1,1,8,10
39672,0,0,1,9,10
39674,0,0,1,6,7
39676,0,0,7,15,22
39677,0,0,1,8,9
39678,0,0,9,41,50
39679,1,0,4,10,15
39680,0,3,14,25,42
39681,0,0,5,8,13
39682,0,0,4,20,24
39683,0,0,1,15,16
39684,1,0,6,15,22
39685,0,0,0,1,1
39686,0,0,8,26,34
39687,1,1,8,14,24
39688,1,0,10,3,14
39689,0,0,6,17,23
39690,0,0,2,7,9
39691,0,0,1,7,8
39692,0,0,3,23,26
39693,0,1,5,24,30
39694,0,0,8,6,14
39695,0,0,9,14,23
39696,0,0,3,4,7
39697,0,0,3,4,7
39698,0,1,4,12,17
39699,0,0,7,16,23
39700,0,0,0,9,9
39701,0,0,5,7,12
39702,0,0,3,12,15
39703,0,0,2,4,6
39704,0,1,1,9,11
39705,0,0,8,12,20
39706,0,0,5,10,15
39707,0,0,7,12,19
39709,0,1,7,15,23
39710,0,0,0,7,7
39711,1,0,0,5,6
39712,0,0,7,5,12
39713,0,0,7,22,29
39714,0,0,3,7,10
39715,0,0,2,9,11
39717,2,1,3,13,19
39718,0,0,7,11,18
39719,0,0,5,7,12
39721,0,0,3,7,10
39722,0,0,4,2,6
39723,0,0,14,33,47
39724,0,0,5,5,10
39726,0,1,4,6,11
39727,0,0,2,10,12
39728,0,0,14,23,37
39729,7,0,1,37,45
39730,0,0,2,8,10
39731,0,0,7,10,17
39732,0,0,3,3,6
39733,0,0,5,11,16
39734,0,0,1,8,9
39736,0,0,1,0,1
39737,0,2,3,37,42
39738,0,0,4,4,8
39739,0,0,4,2,6
39740,0,0,2,4,6
39741,0,1,2,10,13
39742,0,0,5,1,6
39744,0,0,0,8,8
39746,1,0,5,28,34
39747,0,4,7,21,32
39748,0,0,7,20,27
39749,0,0,8,26,34
39750,0,0,8,15,23
39751,0,0,8,13,21
39752,0,0,9,19,28
39753,0,0,0,2,2
39755,1,1,12,33,47
39756,1,0,11,27,39
39757,0,2,8,15,25
39758,0,0,12,19,31
39759,0,0,8,12,20
39760,1,2,9,32,44
39761,0,4,0,10,14
39762,0,1,7,20,28
39763,0,0,4,14,18
39764,0,0,6,6,12
39765,0,0,11,36,47
39767,0,0,2,6,8
39768,0,0,3,8,11
39769,0,1,12,36,49
39770,0,0,5,19,24
39771,0,1,5,6,12
39772,0,0,10,11,21
39773,0,0,2,4,6
39774,0,0,6,11,17
39775,0,0,2,1,3
39776,0,0,14,9,23
39777,0,0,8,23,31
39778,0,0,0,10,10
39779,0,0,2,16,18
39780,0,0,2,9,11
39782,0,0,4,5,9
39783,0,0,5,7,12
39784,0,1,12,22,35
39785,0,1,7,10,18
39786,0,0,16,25,41
39787,1,0,14,31,46
39788,0,0,13,31,44
39789,0,1,9,12,22
39790,0,0,1,2,3
39791,0,0,1,0,1
39793,0,0,13,14,27
39794,0,0,8,26,34
39795,0,0,16,33,49
39796,1,0,18,31,50
39797,0,0,5,14,19
39798,0,0,13,17,30
39799,0,1,8,23,32
39800,0,0,4,9,13
39801,0,2,14,34,50
39802,0,2,7,17,26
39803,0,0,8,26,34
39804,1,0,16,30,47
39805,0,0,4,9,13
39806,0,0,8,19,27
39807,0,0,6,33,39
39808,0,0,12,18,30
39809,0,0,7,20,27
39810,0,1,8,22,31
39811,0,0,15,25,40
39812,0,0,8,13,21
39813,0,0,14,25,39
39815,0,0,6,15,21
39816,0,0,12,30,42
39817,0,2,8,14,24
39818,1,0,11,33,45
39819,1,1,15,19,36
39820,0,0,12,38,50
39821,0,0,4,3,7
39822,0,0,6,18,24
39823,1,0,15,26,42
39824,0,0,17,27,44
39825,0,0,11,22,33
39826,0,0,10,26,36
39827,0,0,10,27,37
39828,0,0,2,4,6
39829,0,1,12,27,40
39830,1,0,9,18,28
39831,0,0,4,9,13
39832,0,1,10,19,30
39833,0,0,8,9,17
39834,1,0,5,28,34
39835,0,0,10,30,40
39836,0,0,2,7,9
39837,0,0,10,24,34
39838,0,0,4,22,26
39839,0,1,9,22,32
39840,0,0,3,14,17
39841,0,0,6,10,16
39842,0,1,2,7,10
39844,0,0,11,36,47
39845,0,3,5,13,21
39846,0,0,11,38,49
39847,0,0,9,7,16
39848,0,0,10,22,32
39849,0,0,11,17,28
39850,0,0,8,21,29
39851,0,0,6,44,50
39852,0,0,10,29,39
39853,0,0,8,16,24
39854,0,4,0,10,14
39855,0,2,8,17,27
39856,0,0,11,16,27
39857,0,0,13,33,46
39858,0,0,8,10,18
39859,0,0,6,28,34
39861,0,1,5,8,14
39862,1,0,5,16,22
39863,1,0,5,30,36
39864,2,3,9,30,44
39865,2,1,9,13,25
39866,0,0,2,13,15
39867,1,1,6,18,26
39868,2,0,4,7,13
39869,0,2,15,23,40
39870,2,1,3,22,28
39871,0,0,7,21,28
39872,0,0,15,34,49
39873,0,0,8,18,26
39874,0,0,10,23,33
39875,0,0,12,19,31
39876,0,0,11,31,42
39877,1,0,11,27,39
39878,1,0,8,28,37
39879,0,0,1,14,15
39880,0,1,17,32,50
39881,0,0,1,7,8
39882,1,0,10,19,30
39883,0,0,2,14,16
39884,0,1,13,30,44
39885,0,0,9,18,27
39886,0,0,4,12,16
39887,0,0,5,18,23
39888,0,0,1,4,5
39889,0,0,4,6,10
39890,3,1,1,13,18
39891,0,0,5,14,19
39892,0,0,5,30,35
39893,0,0,10,13,23
39894,0,0,7,13,20
39895,0,2,8,39,49
39896,0,0,4,4,8
39897,0,0,11,11,22
39898,0,1,5,12,18
39899,0,1,6,11,18
39900,0,0,4,7,11
39902,1,0,0,9,10
39903,0,0,4,6,10
39904,0,4,18,28,50
39905,0,1,13,35,49
39906,0,0,6,8,14
39907,0,0,9,13,22
39908,0,2,11,37,50
39909,0,0,10,27,37
39910,0,0,7,19,26
39912,0,4,7,21,32
39913,0,0,8,15,23
39914,0,2,11,24,37
39915,0,0,0,2,2
39916,0,0,4,14,18
39917,0,0,8,13,21
39918,1,2,9,32,44
39919,2,3,6,37,48
39920,0,0,8,17,25
39921,0,0,1,6,7
39922,0,1,13,10,24
39923,0,0,10,8,18
39924,0,0,2,4,6
39925,0,0,3,8,11
39926,0,0,16,15,31
39927,0,1,5,11,17
39928,0,1,5,21,27
39929,1,0,1,1,3
39930,0,0,6,11,17
39931,0,0,2,6,8
39932,0,0,14,9,23
39933,1,1,8,14,24
39934,0,0,0,3,3
39935,1,0,0,5,6
39936,0,1,8,10,19
39937,0,0,8,23,31
39938,1,0,5,43,49
39939,0,2,7,40,49
39940,7,0,1,37,45
39941,0,0,7,21,28
39942,0,0,14,22,36
39943,0,0,3,18,21
39944,0,0,10,18,28
39945,0,1,5,6,12
39946,1,0,15,28,44
39947,0,0,0,10,10
39948,0,2,3,37,42
39949,0,3,3,34,40
39950,0,0,10,23,33
39952,0,0,12,12,24
39953,0,1,8,16,25
39954,0,0,5,18,23
39955,2,3,9,30,44
39956,0,0,2,1,3
39957,0,0,3,7,10
39958,0,0,11,12,23
39959,0,0,8,27,35
39960,1,0,5,43,49
39961,2,1,3,13,19
39962,0,1,1,9,11
39963,0,0,12,16,28
39964,0,1,12,36,49
39965,1,0,1,1,3
39966,0,0,6,21,27
39968,0,0,4,9,13
39969,0,0,0,3,3
39970,0,0,8,13,21
39971,1,0,1,1,3
39972,0,0,2,4,6
39973,0,0,9,13,22
39974,0,0,9,19,28
39975,1,0,18,31,50
39976,0,1,9,9,19
39977,0,0,16,15,31
39978,0,0,1,9,10
39979,0,0,10,27,37
39980,0,2,7,40,49
39981,0,0,1,2,3
39982,0,0,4,9,13
39983,0,0,4,9,13
39984,1,0,11,33,45
39985,0,0,10,22,32
39986,0,0,8,26,34
39987,0,0,9,13,22
39988,0,0,6,15,21
39989,0,0,5,13,18
39990,1,1,4,8,14
39991,0,2,15,15,32
39992,0,0,9,15,24
39993,0,2,8,15,25
39994,0,0,1,2,3
39995,0,0,12,19,31
39996,0,1,5,11,17
39997,0,0,8,12,20
39998,0,0,4,14,18
39999,0,1,12,36,49
40000,0,0,0,2,2
40001,0,0,6,6,12
40002,1,1,12,33,47
40003,0,1,8,10,19
40004,0,0,6,8,14
40006,0,0,4,4,8
40007,0,0,7,10,17
40008,0,1,6,33,40
40009,0,0,5,3,8
40010,0,0,4,7,11
40011,0,0,5,10,15
40012,0,0,5,19,24
40013,0,1,0,5,6
40014,0,0,3,14,17
40015,0,0,0,1,1
40016,0,0,16,24,40
40017,0,0,9,17,26
40018,0,0,3,21,24
40019,0,1,7,22,30
40020,1,0,8,38,47
40021,1,0,11,26,38
40022,0,1,8,16,25
40023,0,0,6,19,25
40024,0,0,3,10,13
40025,0,3,8,38,49
40026,0,1,3,10,14
40027,0,0,6,13,19
40028,0,0,1,0,1
40029,0,0,2,15,17
40030,0,0,2,6,8
40031,0,0,3,18,21
40032,0,0,3,7,10
40033,0,4,4,28,36
40034,0,0,9,32,41
40035,0,0,9,15,24
40036,0,0,21,25,46
40037,0,0,12,13,25
40038,0,1,4,14,19
40039,0,1,5,16,22
40040,0,0,26,24,50
40041,0,0,15,31,46
40042,0,1,0,8,9
40043,0,0,3,3,6
40044,0,1,8,25,34
40045,0,0,4,7,11
40046,1,0,1,5,7
40047,0,0,2,3,5
40048,1,0,2,8,11
40049,1,0,8,36,45
40050,0,0,0,5,5
40051,0,0,3,12,15
40052,1,0,2,8,11
40053,0,0,4,4,8
40054,0,0,9,9,18
40055,0,0,5,8,13
40056,0,1,3,16,20
40057,0,0,1,16,17
40058,0,1,7,18,26
40059,0,0,8,20,28
40060,1,0,5,17,23
40061,0,3,4,41,48
40062,0,1,6,17,24
40063,2,0,16,30,48
40064,1,1,9,13,24
40066,0,0,1,2,3
40068,0,0,9,22,31
40069,0,1,6,12,19
40070,0,0,3,17,20
40071,2,0,11,35,48
40073,0,0,5,4,9
40074,3,0,1,8,12
40075,0,0,13,27,40
40076,0,0,8,19,27
40077,0,0,1,24,25
40078,0,1,6,17,24
40079,0,0,8,10,18
40080,0,1,5,7,13
40081,0,0,3,8,11
40082,0,0,8,24,32
40083,0,3,3,16,22
40084,0,0,2,6,8
40086,0,0,8,18,26
40087,0,0,1,5,6
40088,0,0,9,22,31
40089,0,0,1,6,7
40090,0,0,4,4,8
40092,0,0,8,11,19
40093,0,0,5,30,35
40094,0,0,4,3,7
40095,0,0,2,11,13
40096,0,0,7,8,15
40097,0,0,4,5,9
40098,0,0,5,25,30
40099,0,4,8,22,34
40100,1,0,2,13,16
40101,0,0,8,24,32
40102,0,0,9,26,35
40103,0,2,5,8,15
40104,0,0,4,8,12
40106,0,0,5,11,16
40107,1,0,10,21,32
40108,0,0,12,38,50
40109,0,0,15,10,25
40110,1,0,0,9,10
40111,0,0,9,12,21
40112,0,0,11,8,19
40113,0,0,1,4,5
40114,0,0,2,11,13
40115,0,0,9,23,32
40116,0,0,2,6,8
40117,0,0,0,9,9
40118,0,2,2,15,19
40119,0,1,5,23,29
40120,0,0,8,16,24
40121,0,0,6,33,39
40122,0,0,2,6,8
40123,0,0,9,18,27
40124,0,0,2,5,7
40126,0,0,0,12,12
40127,0,0,2,14,16
40128,0,0,5,9,14
40129,0,0,3,6,9
40130,0,0,4,4,8
40131,0,2,7,21,30
40132,0,2,3,8,13
40133,0,0,4,9,13
40134,0,0,11,31,42
40135,0,0,6,24,30
40136,0,1,3,16,20
40137,0,0,3,13,16
40138,0,0,14,36,50
40139,0,0,0,3,3
40140,0,0,3,4,7
40141,0,0,5,10,15
40142,0,0,2,3,5
40143,0,0,2,12,14
40144,0,0,2,11,13
40145,0,0,2,14,16
40146,0,0,0,12,12
40147,0,2,6,20,28
40148,0,4,7,21,32
40149,1,0,5,28,34
40150,0,0,4,9,13
40151,0,0,11,23,34
40152,0,1,7,10,18
40153,0,0,3,8,11
40154,0,2,8,18,28
40155,0,0,5,7,12
40156,0,0,10,21,31
40157,0,0,5,11,16
40158,0,0,1,4,5
40159,0,0,6,9,15
40160,0,2,1,22,25
40161,2,1,8,16,27
40162,0,0,3,9,12
40163,0,0,5,14,19
40164,0,1,7,36,44
40165,0,0,4,7,11
40166,0,0,9,10,19
40167,0,0,2,7,9
40168,0,0,18,32,50
40169,0,0,2,8,10
40170,0,0,10,23,33
40171,0,1,4,14,19
40172,1,0,13,22,36
40173,0,0,11,36,47
40174,0,0,8,18,26
40175,0,0,6,37,43
40176,0,1,14,20,35
40177,0,0,5,2,7
40178,0,0,0,8,8
40179,0,0,10,20,30
40180,0,0,5,8,13
40181,0,0,3,11,14
40182,0,0,8,8,16
40183,0,0,5,9,14
40184,0,0,8,14,22
40185,2,2,3,21,28
40186,0,0,1,10,11
40187,0,1,10,27,38
40188,0,0,4,16,20
40189,0,0,9,17,26
40190,0,0,3,5,8
40191,0,0,6,2,8
40192,0,0,4,19,23
40193,0,0,4,21,25
40194,0,0,10,24,34
40195,0,0,9,21,30
40196,0,1,15,23,39
40197,0,1,5,36,42
40198,0,0,3,4,7
40199,0,0,13,13,26
40200,0,0,6,34,40
40201,0,1,6,13,20
40202,0,0,3,7,10
40203,0,1,6,37,44
40204,0,0,6,5,11
40205,0,0,3,13,16
40206,0,0,6,21,27
40207,1,0,6,18,25
40208,0,0,7,2,9
40209,0,0,1,14,15
40210,0,2,3,22,27
40211,0,0,4,5,9
40212,0,0,7,10,17
40213,0,0,6,10,16
40214,0,1,9,9,19
40215,0,0,7,14,21
40216,0,0,1,8,9
40217,0,0,2,15,17
40218,0,0,1,14,15
40219,0,0,7,20,27
40220,1,0,1,3,5
40221,1,0,6,16,23
40222,0,0,7,20,27
40223,0,0,5,7,12
40224,0,1,11,19,31
40225,0,3,6,11,20
40226,0,0,4,19,23
40227,0,0,5,2,7
40228,0,1,3,15,19
40229,0,3,8,21,32
40230,0,0,5,20,25
40231,0,0,5,7,12
40232,0,0,6,9,15
40233,0,0,7,6,13
40234,0,1,2,15,18
40236,0,0,9,21,30
40237,0,0,1,1,2
40238,0,0,5,12,17
40239,0,0,3,9,12
40240,0,0,2,10,12
40241,0,1,8,9,18
40242,0,0,0,4,4
40243,0,0,4,3,7
40244,0,2,10,15,27
40245,0,0,5,5,10
40246,0,0,2,5,7
40247,0,0,1,11,12
40249,0,0,12,23,35
40250,11,0,0,16,27
40251,0,0,8,9,17
40252,0,0,5,14,19
40253,0,0,4,9,13
40254,0,0,6,17,23
40255,0,0,2,7,9
40256,0,0,0,5,5
40257,0,0,4,6,10
40258,0,0,1,9,10
40259,0,1,3,19,23
40260,0,0,6,37,43
40261,0,0,12,19,31
40262,0,0,9,12,21
40263,0,1,7,14,22
40264,0,0,6,4,10
40265,0,0,1,15,16
40266,0,0,5,14,19
40267,0,0,9,15,24
40268,0,0,2,9,11
40271,0,0,7,2,9
40272,0,0,3,6,9
40273,0,0,4,9,13
40274,0,2,6,11,19
40275,0,0,6,23,29
40276,0,0,11,23,34
40277,0,3,8,39,50
40278,0,0,3,7,10
40279,0,1,7,14,22
40280,0,1,5,7,13
40281,0,1,9,19,29
40282,0,1,10,26,37
40283,0,0,3,16,19
40284,0,0,1,12,13
40286,0,0,6,14,20
40287,0,0,3,23,26
40288,0,1,5,44,50
40289,0,0,13,23,36
40290,0,0,9,22,31
40291,0,0,3,2,5
40292,0,0,6,8,14
40293,0,0,2,9,11
40294,0,1,2,3,6
40295,0,0,5,5,10
40296,0,0,7,11,18
40297,0,1,6,14,21
40298,1,1,7,15,24
40299,4,0,6,10,20
40300,0,0,1,2,3
40301,0,0,4,8,12
40302,0,0,4,9,13
40303,0,0,4,15,19
40304,0,0,4,26,30
40305,0,0,3,10,13
40306,0,0,3,8,11
40307,0,0,0,25,25
40308,0,0,4,12,16
40309,0,0,11,21,32
40310,0,0,4,18,22
40311,0,0,7,4,11
40312,0,0,8,12,20
40313,0,0,6,20,26
40314,0,0,2,4,6
40316,0,0,7,16,23
40318,0,0,9,12,21
40319,0,0,5,14,19
40320,0,0,8,19,27
40321,0,0,5,19,24
40322,0,0,3,8,11
40323,0,0,6,7,13
40324,0,0,3,8,11
40325,0,0,6,13,19
40326,2,3,0,6,11
40327,0,0,3,5,8
40328,2,2,9,33,46
40329,0,0,10,16,26
40330,0,0,2,33,35
40331,1,5,4,30,40
40332,0,0,4,8,12
40333,0,1,6,5,12
40334,0,1,9,13,23
40335,0,0,3,12,15
40336,0,0,13,10,23
40337,0,0,16,28,44
40338,0,0,6,4,10
40339,0,0,0,7,7
40340,0,0,5,7,12
40341,0,0,13,34,47
40342,0,0,9,12,21
40343,0,0,5,9,14
40344,0,0,9,18,27
40346,0,0,3,7,10
40347,0,0,2,2,4
40348,0,0,15,35,50
40350,0,0,2,13,15
40351,0,2,5,24,31
40352,0,0,7,17,24
40353,0,0,1,5,6
40354,0,0,10,24,34
40355,0,0,4,11,15
40356,0,0,5,5,10
40357,0,2,10,26,38
40358,0,0,7,2,9
40359,0,3,10,14,27
40360,0,0,8,13,21
40361,0,0,5,15,20
40362,0,0,1,2,3
40363,0,0,7,7,14
40364,0,0,8,12,20
40365,0,0,2,15,17
40366,0,0,6,4,10
40368,0,0,3,9,12
40369,0,0,0,6,6
40370,0,0,16,27,43
40371,0,0,3,5,8
40372,0,0,5,15,20
40373,0,1,1,9,11
40374,0,0,4,17,21
40375,0,0,1,7,8
40376,0,3,4,28,35
40377,0,0,2,9,11
40378,0,1,7,8,16
40379,0,0,2,33,35
40380,0,0,20,26,46
40381,0,0,1,7,8
40382,0,0,7,4,11
40383,0,0,10,32,42
40385,0,0,5,15,20
40386,0,0,4,4,8
40387,0,0,0,25,25
40388,0,1,13,31,45
40389,0,0,9,11,20
40390,0,0,8,14,22
40391,0,0,5,7,12
40393,0,0,1,5,6
40394,0,0,11,13,24
40395,0,0,7,6,13
40396,0,0,9,12,21
40397,0,0,4,2,6
40398,0,0,4,7,11
40399,0,0,2,7,9
40400,0,0,6,9,15
40401,1,0,14,21,36
40402,0,0,5,7,12
40403,0,0,0,5,5
40404,0,0,1,8,9
40405,0,0,1,4,5
40406,0,0,5,3,8
40408,0,0,1,4,5
40410,0,0,2,6,8
40411,1,0,8,41,50
40412,0,0,4,2,6
40413,0,1,12,7,20
40414,0,2,13,35,50
40415,1,0,3,12,16
40416,0,1,2,9,12
40418,0,1,7,13,21
40419,1,1,0,24,26
40421,0,0,7,20,27
40423,0,0,0,5,5
40425,0,0,7,13,20
40426,0,0,2,3,5
40427,0,1,5,18,24
40428,0,2,11,24,37
40429,0,2,6,10,18
40430,0,0,5,13,18
40431,0,0,5,25,30
40432,0,0,14,29,43
40433,0,0,10,27,37
40434,0,0,3,4,7
40435,0,0,8,17,25
40436,0,0,6,11,17
40437,0,1,6,33,40
40438,0,0,2,6,8
40439,0,0,14,9,23
40440,2,1,3,13,19
40441,0,1,5,10,16
40442,0,0,7,8,15
40443,0,1,1,32,34
40444,0,0,2,5,7
40445,0,1,14,33,48
40446,0,0,7,21,28
40447,1,0,16,30,47
40448,0,0,2,3,5
40449,0,0,22,25,47
40450,0,1,0,18,19
40451,0,0,13,30,43
40452,0,0,0,1,1
40453,1,0,8,20,29
40454,0,1,11,35,47
40455,1,0,6,35,42
40456,0,0,17,24,41
40457,0,0,2,11,13
40458,0,0,3,20,23
40459,0,0,1,22,23
40460,1,0,5,23,29
40461,0,1,5,9,15
40462,0,0,5,10,15
40463,0,0,20,23,43
40464,0,1,12,14,27
40465,0,0,13,17,30
40466,2,0,16,30,48
40467,0,0,21,25,46
40468,0,0,6,11,17
40469,0,0,10,39,49
40470,0,2,14,34,50
40471,1,0,5,17,23
40472,0,5,11,34,50
40473,0,0,4,11,15
40474,0,0,11,39,50
40475,1,1,1,16,19
40476,0,0,1,8,9
40477,0,0,9,24,33
40478,0,0,8,17,25
40479,0,0,11,18,29
40480,0,1,3,16,20
40481,0,0,7,20,27
40482,0,1,8,17,26
40483,0,0,15,35,50
40484,0,0,4,6,10
40485,0,0,11,31,42
40486,0,0,8,24,32
40487,0,0,7,19,26
40488,0,1,14,22,37
40489,0,0,7,36,43
40490,2,0,11,35,48
40491,0,0,16,33,49
40492,0,0,2,14,16
40494,0,0,9,36,45
40495,0,1,14,25,40
40496,0,0,2,9,11
40497,0,0,3,18,21
40498,0,0,10,14,24
40499,0,0,1,11,12
40500,0,0,0,3,3
40501,0,0,11,25,36
40502,0,0,14,32,46
40503,0,0,3,4,7
40504,0,0,8,16,24
40505,0,0,6,21,27
40506,0,0,0,10,10
40507,0,0,6,9,15
40508,0,0,17,30,47
40509,0,1,8,40,49
40510,0,0,8,14,22
40511,0,0,1,17,18
40512,0,3,8,38,49
40513,0,0,7,20,27
40514,0,0,12,15,27
40515,0,0,7,8,15
40516,0,0,14,35,49
40517,0,1,3,11,15
40518,0,0,10,25,35
40520,1,0,4,6,11
40521,0,1,2,7,10
40522,0,0,8,17,25
40523,0,0,14,28,42
40524,0,0,16,34,50
40525,0,0,16,16,32
40526,0,2,13,35,50
40527,0,1,6,6,13
40528,0,1,13,16,30
40529,0,0,4,11,15
40530,0,0,17,32,49
40531,0,0,0,7,7
40532,1,0,7,8,16
40533,0,0,0,6,6
40534,0,1,4,17,22
40535,0,0,9,34,43
40536,0,0,12,38,50
40537,0,0,4,10,14
40538,0,0,10,21,31
40539,0,0,4,16,20
40540,0,0,8,18,26
40541,0,0,7,13,20
40542,0,0,9,7,16
40543,0,0,12,23,35
40544,0,0,10,16,26
40545,0,0,5,8,13
40546,0,1,14,31,46
40547,0,1,14,33,48
40548,0,0,3,11,14
40549,0,0,14,29,43
40550,0,1,3,22,26
40551,0,0,11,5,16
40552,0,0,9,16,25
40553,0,0,3,6,9
40554,0,0,3,31,34
40555,0,0,14,24,38
40556,1,0,10,22,33
40557,0,0,15,26,41
40558,0,0,3,23,26
40559,0,0,6,31,37
40560,0,0,6,25,31
40561,0,0,3,7,10
40562,1,1,8,19,29
40563,0,1,9,33,43
40564,0,0,9,32,41
40565,0,0,4,12,16
40566,0,0,5,18,23
40567,1,0,13,36,50
40568,0,0,13,23,36
40569,0,0,6,8,14
40570,0,0,5,19,24
40571,0,0,1,4,5
40572,0,0,0,7,7
40573,1,0,0,19,20
40574,0,0,11,14,25
40575,0,0,4,12,16
40576,0,2,7,34,43
40577,0,0,10,8,18
40578,0,0,3,2,5
40579,1,0,6,23,30
40580,1,0,8,19,28
40581,0,0,5,6,11
40582,0,1,5,18,24
40583,0,0,8,18,26
40584,1,0,14,31,46
40587,0,0,2,1,3
40588,1,0,8,15,24
40589,0,0,7,24,31
40590,0,0,12,38,50
40591,0,1,6,22,29
40592,0,0,1,6,7
40594,0,0,2,9,11
40595,0,0,3,5,8
40596,0,0,2,17,19
40597,0,0,4,2,6
40598,0,0,7,9,16
40599,0,0,5,9,14
40601,2,2,9,33,46
40602,1,0,4,8,13
40603,0,0,6,5,11
40604,0,0,0,5,5
40605,0,0,6,12,18
40606,0,0,6,6,12
40607,0,0,10,23,33
40608,0,0,4,6,10
40609,0,0,8,17,25
40610,0,0,6,6,12
40611,0,0,7,22,29
40612,0,0,8,9,17
40615,1,0,16,16,33
40616,0,1,3,22,26
40617,1,0,5,28,34
40618,0,4,7,21,32
40619,1,0,2,8,11
40620,0,0,7,20,27
40621,0,0,1,0,1
40622,0,0,5,8,13
40623,0,0,4,13,17
40624,0,0,3,3,6
40625,0,2,6,10,18
40626,0,0,12,19,31
40627,0,0,1,14,15
40628,0,0,11,36,47
40629,0,0,2,3,5
40630,0,2,11,24,37
40631,0,0,6,11,17
40632,0,0,3,10,13
40633,0,0,14,9,23
40634,0,0,9,11,20
40635,0,0,7,8,15
40636,0,0,5,15,20
40637,0,0,10,24,34
40638,0,1,5,10,16
40639,0,1,6,33,40
40640,0,0,1,5,6
40641,0,0,4,34,38
40642,0,0,10,27,37
40643,0,0,2,11,13
40644,0,0,6,11,17
40645,0,0,1,11,12
40646,2,1,8,39,50
40647,0,0,17,32,49
40648,0,1,3,22,26
40649,0,0,1,23,24
40650,0,0,6,17,23
40651,0,0,1,4,5
40652,0,0,2,8,10
40653,0,0,22,28,50
40654,0,0,14,34,48
40655,0,0,1,25,26
40656,0,3,8,36,47
40657,0,0,0,5,5
40658,0,0,9,16,25
40659,0,0,12,26,38
40660,0,0,7,4,11
40661,0,0,6,25,31
40662,0,0,5,13,18
40663,0,1,3,22,26
40664,2,1,3,13,19
40665,0,1,1,32,34
40666,0,0,14,24,38
40667,1,1,1,16,19
40668,0,0,5,8,13
40669,0,0,1,14,15
40670,1,0,4,8,13
40671,0,1,6,33,40
40672,0,0,11,39,50
40673,0,1,6,22,29
40674,0,0,3,14,17
40675,0,0,4,8,12
40676,0,0,12,19,31
40677,1,1,9,13,24
40678,0,2,3,22,27
40680,0,2,11,37,50
40681,0,0,5,0,5
40682,0,1,4,23,28
40683,0,0,6,11,17
40684,0,0,16,34,50
40685,1,0,7,8,16
40686,0,0,2,6,8
40687,0,2,3,37,42
40688,0,0,5,7,12
40689,0,0,10,39,49
40690,0,0,7,18,25
40691,0,0,7,13,20
40692,0,0,7,19,26
40693,0,0,6,6,12
40694,0,0,7,18,25
40695,0,0,5,6,11
40696,0,0,1,0,1
40697,0,0,6,18,24
40698,0,0,0,7,7
40699,0,0,4,2,6
40700,0,0,8,26,34
40701,0,1,11,38,50
40702,0,1,4,14,19
40703,0,0,2,6,8
40704,0,0,3,6,9
40705,0,0,5,16,21
40706,0,0,5,13,18
40707,0,0,3,15,18
40708,0,0,1,19,20
40709,0,1,4,18,23
40710,0,0,8,20,28
40711,0,0,2,21,23
40712,0,0,5,15,20
40713,0,0,5,5,10
40714,0,0,12,25,37
40715,0,0,14,32,46
40716,0,0,7,16,23
40717,0,1,1,7,9
40718,0,1,5,7,13
40719,0,0,14,36,50
40720,0,3,14,32,49
40721,0,0,0,5,5
40722,0,0,5,8,13
40723,0,0,0,9,9
40724,0,1,6,11,18
40725,0,0,1,6,7
40726,0,0,4,12,16
40727,0,2,6,16,24
40728,0,0,5,18,23
40729,1,0,0,9,10
40730,0,0,4,10,14
40732,0,0,9,19,28
40733,0,0,2,9,11
40734,0,0,3,13,16
40735,0,0,3,6,9
40736,2,1,8,13,24
40737,0,0,6,23,29
40738,0,0,4,7,11
40739,0,0,6,36,42
40740,0,2,12,29,43
40741,0,0,2,3,5
40743,0,2,1,14,17
40744,0,0,4,6,10
40745,0,0,4,6,10
40746,0,0,4,5,9
40747,0,0,10,19,29
40748,0,0,4,4,8
40749,0,0,4,11,15
40750,0,0,5,0,5
40752,0,1,12,23,36
40753,0,0,8,32,40
40754,0,1,4,7,12
40755,0,0,6,10,16
40757,0,0,0,4,4
40758,0,0,7,16,23
40759,0,1,10,7,18
40761,0,0,1,9,10
40762,0,0,1,10,11
40763,0,0,10,39,49
40764,0,0,12,20,32
40765,0,0,6,25,31
40766,1,0,2,31,34
40767,2,0,1,22,25
40768,0,0,6,15,21
40769,0,1,13,23,37
40770,0,0,7,15,22
40771,0,0,2,13,15
40772,1,1,9,36,47
40773,0,0,8,11,19
40774,0,0,3,6,9
40775,0,2,8,32,42
40776,0,0,9,15,24
40777,0,1,5,17,23
40778,0,0,3,8,11
40779,0,0,8,17,25
40780,0,1,3,18,22
40781,0,0,7,23,30
40782,0,1,4,9,14
40783,0,2,5,17,24
40784,0,0,4,6,10
40785,0,0,7,6,13
40786,0,2,1,23,26
40787,0,0,6,19,25
40789,0,0,4,9,13
40790,1,1,16,27,45
40791,0,0,4,11,15
40792,0,0,12,13,25
40793,0,0,6,13,19
40794,0,1,2,10,13
40795,0,1,2,6,9
40796,0,0,10,18,28
40797,0,0,9,20,29
40798,0,0,14,35,49
40799,0,0,3,2,5
40800,0,1,13,33,47
40801,1,1,4,20,26
40802,0,0,6,12,18
40803,0,0,8,4,12
40804,0,0,2,1,3
40805,0,0,1,1,2
40806,0,0,1,2,3
40807,0,0,6,16,22
40808,0,0,4,7,11
40809,0,0,4,10,14
40811,0,1,1,8,10
40812,0,1,7,18,26
40813,1,1,7,39,48
40814,1,0,3,8,12
40815,0,1,1,4,6
40816,0,0,2,8,10
40817,0,0,2,14,16
40818,0,0,3,5,8
40819,0,0,3,15,18
40820,0,0,7,8,15
40821,0,0,5,4,9
40823,0,0,10,39,49
40824,0,1,5,6,12
40825,0,0,7,10,17
40826,0,1,11,14,26
40827,0,1,16,23,40
40828,0,4,9,30,43
40829,0,0,1,5,6
40830,0,0,8,9,17
40831,0,0,10,14,24
40832,0,0,3,13,16
40833,0,1,13,33,47
40835,1,0,13,19,33
40836,0,1,7,17,25
40837,0,0,10,21,31
40838,0,0,4,5,9
40839,0,0,2,0,2
40840,0,0,3,2,5
40841,0,0,2,3,5
40842,0,0,1,7,8
40843,0,0,5,5,10
40844,0,1,5,12,18
40845,0,0,5,10,15
40846,1,0,10,34,45
40847,0,0,5,14,19
40848,0,0,13,26,39
40849,0,0,9,9,18
40850,0,0,4,4,8
40851,0,0,4,2,6
40852,0,0,5,10,15
40853,0,0,1,4,5
40854,0,0,7,27,34
40855,0,0,10,14,24
40856,0,0,9,10,19
40857,1,0,10,21,32
40858,0,0,6,4,10
40859,0,0,3,9,12
40860,0,1,9,31,41
40861,1,0,6,16,23
40862,0,0,8,13,21
40863,1,0,2,8,11
40864,0,0,1,9,10
40865,0,1,4,15,20
40866,0,0,6,7,13
40867,0,0,0,1,1
40868,1,0,10,3,14
40869,0,0,8,26,34
40870,0,0,8,9,17
40872,0,0,3,4,7
40873,0,0,6,11,17
40875,0,2,7,27,36
40876,0,0,9,16,25
40877,0,0,1,7,8
40878,0,0,4,7,11
40879,0,0,0,8,8
40880,0,0,3,15,18
40881,0,0,6,2,8
40883,0,0,4,11,15
40884,0,0,1,6,7
40885,0,1,7,14,22
40886,0,0,11,9,20
40887,0,0,5,26,31
40889,1,0,11,27,39
40890,0,0,11,15,26
40891,0,0,0,11,11
40892,0,0,6,13,19
40893,0,0,1,9,10
40894,0,0,6,16,22
40895,0,1,9,31,41
40896,0,0,7,4,11
40897,0,0,1,10,11
40898,0,0,5,0,5
40899,0,0,1,4,5
40900,4,0,12,34,50
40901,1,0,0,5,6
40902,0,0,10,23,33
40903,0,2,11,37,50
40904,0,0,10,22,32
40905,0,0,22,26,48
40906,0,0,7,43,50
40907,1,0,16,32,49
40908,0,1,1,19,21
40909,0,0,2,12,14
40910,0,0,12,34,46
40911,0,1,7,22,30
40912,0,1,16,33,50
40913,0,0,5,7,12
40914,1,0,8,31,40
40915,2,0,6,29,37
40916,0,0,6,22,28
40917,0,1,4,29,34
40918,0,0,3,11,14
40919,0,0,14,26,40
40920,0,0,4,14,18
40921,0,0,13,30,43
40922,0,0,0,8,8
40923,0,0,4,2,6
40924,0,0,1,14,15
40925,1,0,6,8,15
40926,0,0,10,22,32
40927,0,0,2,5,7
40928,0,0,1,42,43
40929,0,0,9,14,23
40930,0,2,10,34,46
40931,0,1,0,10,11
40932,0,0,15,34,49
40933,1,3,2,17,23
40934,0,0,8,7,15
40935,0,0,9,11,20
40936,0,0,3,9,12
40937,0,0,8,22,30
40938,0,0,6,5,11
40939,0,1,12,37,50
40940,0,1,12,23,36
40941,0,0,7,4,11
40942,0,0,13,36,49
40943,0,0,6,16,22
40944,0,0,10,37,47
40945,0,0,5,8,13
40946,0,1,19,30,50
40947,0,0,4,5,9
40948,0,0,7,2,9
40949,0,0,11,15,26
40950,0,0,13,37,50
40951,0,0,9,19,28
40952,0,0,5,26,31
40953,0,1,1,7,9
40954,0,1,4,17,22
40955,0,0,0,13,13
40956,0,1,5,11,17
40957,0,0,18,32,50
40958,0,0,1,6,7
40959,0,1,7,14,22
40960,0,0,7,11,18
40961,0,1,8,14,23
40962,0,0,13,20,33
40963,0,2,4,9,15
40964,0,0,17,32,49
40965,0,0,7,9,16
40966,0,0,7,43,50
40967,0,0,3,14,17
40968,0,0,17,32,49
40969,0,0,3,8,11
40970,0,1,8,16,25
40971,0,0,9,15,24
40972,0,1,5,20,26
40973,0,1,16,32,49
40974,0,0,8,8,16
40975,0,1,6,12,19
40976,0,1,3,19,23
40977,0,0,4,2,6
40978,0,0,7,13,20
40980,0,0,4,4,8
40981,0,0,9,24,33
40982,0,0,0,11,11
40983,1,0,5,25,31
40984,1,0,0,10,11
40985,0,0,1,1,2
40986,0,0,5,8,13
40987,1,0,3,4,8
40988,0,0,5,12,17
40989,0,0,6,5,11
40990,0,0,5,20,25
40991,0,0,8,23,31
40992,0,0,13,25,38
40993,0,0,11,20,31
40994,0,0,2,11,13
40995,0,0,7,3,10
40996,0,0,5,9,14
40997,0,0,12,38,50
40998,0,2,13,34,49
40999,0,0,5,13,18
41000,0,0,5,9,14
41001,3,1,5,9,18
41002,0,2,11,37,50
41003,0,0,2,3,5
41004,0,0,13,20,33
41005,0,1,12,37,50
41006,1,1,13,17,32
41007,0,0,1,6,7
41008,0,0,17,28,45
41009,0,1,5,26,32
41011,0,0,5,14,19
41012,0,0,8,26,34
41013,0,0,6,11,17
41014,0,0,4,9,13
41015,0,0,2,3,5
41016,0,0,1,7,8
41018,0,0,3,11,14
41019,1,0,5,6,12
41020,0,0,6,29,35
41021,0,0,6,13,19
41022,0,0,0,11,11
41023,0,0,1,9,10
41024,1,0,11,27,39
41025,0,0,7,16,23
41026,0,0,6,16,22
41027,0,0,0,4,4
41028,0,1,6,11,18
41029,0,0,4,11,15
41031,1,0,15,25,41
41032,0,0,1,16,17
41033,0,0,15,33,48
41034,0,0,0,13,13
41035,0,0,14,26,40
41036,0,0,2,12,14
41037,0,0,0,8,8
41038,1,0,5,23,29
41039,2,0,12,33,47
41040,0,0,2,12,14
41042,0,0,18,32,50
41043,0,2,3,37,42
41044,1,0,3,22,26
41045,0,0,0,11,11
41046,0,1,3,19,23
41047,0,1,4,17,22
41048,0,0,7,4,11
41049,0,0,2,16,18
41050,0,0,0,11,11
41051,0,0,11,27,38
41052,0,0,0,11,11
41053,0,0,7,43,50
41054,0,0,1,9,10
41055,0,0,5,20,25
41056,0,1,1,19,21
41057,0,0,10,18,28
41058,0,0,4,9,13
41059,0,0,5,13,18
41060,0,0,10,18,28
41061,0,0,8,26,34
41062,0,1,6,33,40
41063,0,1,5,10,16
41064,0,0,2,26,28
41065,0,2,8,28,38
41066,0,0,5,12,17
41067,0,0,7,10,17
41068,0,0,5,5,10
41069,0,1,2,14,17
41071,0,0,1,6,7
41072,0,0,9,18,27
41073,0,1,3,16,20
41074,0,1,17,32,50
41075,1,3,3,33,40
41076,0,0,2,35,37
41077,0,0,2,6,8
41078,0,0,13,33,46
41079,0,1,15,31,47
41080,0,0,4,7,11
41081,0,0,8,17,25
41082,0,0,2,20,22
41083,0,0,7,16,23
41084,0,0,6,17,23
41085,0,0,10,34,44
41086,0,0,6,17,23
41087,0,0,9,21,30
41088,0,0,7,20,27
41089,0,0,2,8,10
41090,0,0,3,7,10
41091,0,0,0,14,14
41093,0,0,6,9,15
41094,0,0,1,2,3
41095,0,2,5,23,30
41096,0,1,6,40,47
41097,0,0,8,15,23
41098,0,0,8,24,32
41099,0,0,5,8,13
41100,1,1,6,14,22
41102,0,0,5,1,6
41103,0,0,10,25,35
41104,0,0,4,16,20
41106,0,0,6,2,8
41107,0,0,1,2,3
41108,0,0,5,8,13
41109,2,3,6,37,48
41110,0,0,2,27,29
41112,0,0,4,9,13
41113,0,2,0,23,25
41114,0,0,4,6,10
41115,0,0,6,12,18
41116,0,0,14,23,37
41117,0,0,4,10,14
41118,0,0,10,28,38
41119,0,0,7,13,20
41120,0,1,6,41,48
41121,0,2,4,5,11
41122,0,0,2,7,9
41123,0,0,2,12,14
41124,1,0,11,36,48
41125,0,0,10,15,25
41126,0,0,0,12,12
41127,0,0,5,5,10
41128,0,0,6,5,11
41129,0,1,8,19,28
41130,0,0,2,1,3
41131,0,0,4,6,10
41132,0,0,11,21,32
41133,0,1,13,22,36
41134,0,0,5,12,17
41135,0,0,2,7,9
41136,0,2,11,14,27
41137,0,0,6,15,21
41138,0,0,0,8,8
41139,1,1,11,18,31
41140,0,0,2,4,6
41141,0,0,10,7,17
41142,0,1,7,20,28
41143,0,0,1,2,3
41144,0,0,4,4,8
41145,0,0,2,2,4
41146,0,2,4,12,18
41147,0,1,6,28,35
41148,0,0,7,9,16
41149,0,0,4,2,6
41150,0,0,8,12,20
41151,0,1,11,24,36
41152,0,0,5,13,18
41153,0,0,4,9,13
41154,0,0,10,12,22
41155,0,0,1,21,22
41156,0,1,7,9,17
41157,0,0,9,26,35
41158,0,0,4,9,13
41159,2,0,5,27,34
41160,0,0,5,6,11
41161,0,1,4,15,20
41162,0,0,4,21,25
41163,0,0,4,4,8
41165,0,0,4,4,8
41166,0,1,14,27,42
41167,0,0,10,21,31
41168,0,0,7,11,18
41170,0,0,5,11,16
41171,0,0,2,5,7
41172,0,0,15,31,46
41173,1,1,8,40,50
41174,0,0,3,8,11
41175,1,0,10,20,31
41176,0,0,7,19,26
41178,0,1,2,16,19
41179,0,0,8,2,10
41180,2,0,3,20,25
41181,0,0,2,10,12
41182,0,1,6,10,17
41183,0,0,6,15,21
41184,0,1,10,27,38
41185,0,0,2,8,10
41186,0,0,5,3,8
41188,0,0,1,4,5
41189,0,0,7,5,12
41190,0,0,0,6,6
41191,0,0,10,20,30
41192,0,0,1,2,3
41193,0,0,4,2,6
41194,0,0,0,1,1
41195,0,0,9,27,36
41196,0,0,7,41,48
41197,0,0,6,7,13
41198,0,0,6,7,13
41199,0,0,6,7,13
41201,0,0,4,13,17
41202,1,0,2,23,26
41205,0,0,11,22,33
41206,0,0,12,21,33
41207,0,0,10,17,27
41208,0,0,17,25,42
41209,0,0,3,6,9
41210,0,0,0,7,7
41211,0,0,5,5,10
41213,0,0,0,6,6
41214,0,0,5,6,11
41215,0,0,4,6,10
41216,0,1,9,31,41
41217,0,0,6,11,17
41219,0,0,10,34,44
41220,1,0,1,7,9
41221,0,1,6,11,18
41223,0,0,1,6,7
41224,0,0,11,25,36
41225,0,0,9,29,38
41226,0,0,9,11,20
41227,0,0,6,15,21
41228,0,1,6,33,40
41229,0,0,1,9,10
41230,0,1,7,7,15
41231,0,0,4,11,15
41232,0,1,4,9,14
41233,1,0,2,28,31
41234,0,0,3,3,6
41235,0,0,9,24,33
41236,0,0,9,13,22
41237,0,0,13,33,46
41238,1,3,3,33,40
41240,0,0,7,10,17
41241,0,0,2,35,37
41242,0,0,12,38,50
41243,0,1,11,25,37
41244,0,0,0,14,14
41245,0,0,8,34,42
41246,0,0,7,14,21
41247,0,0,5,21,26
41248,0,0,8,10,18
41249,0,0,6,11,17
41250,1,0,14,32,47
41251,0,1,4,11,16
41252,0,0,12,21,33
41254,0,0,5,29,34
41255,0,0,3,6,9
41256,0,0,4,12,16
41257,0,0,12,33,45
41258,0,0,8,17,25
41259,0,0,2,27,29
41260,0,1,5,25,31
41261,0,0,4,9,13
41262,0,1,13,13,27
41263,0,0,9,28,37
41264,0,1,4,24,29
41265,0,0,5,8,13
41266,0,1,12,20,33
41267,0,0,9,12,21
41268,0,0,5,10,15
41269,0,0,8,16,24
41271,0,1,6,11,18
41272,0,0,3,10,13
41273,0,0,7,20,27
41274,0,0,12,37,49
41275,0,0,10,40,50
41276,0,2,4,14,20
41277,0,1,1,16,18
41278,0,0,12,31,43
41279,0,1,9,11,21
41280,0,1,6,20,27
41281,0,1,3,10,14
41282,0,1,8,19,28
41283,0,0,18,26,44
41284,3,0,5,19,27
41285,0,0,0,7,7
41286,0,0,4,11,15
41287,0,0,7,14,21
41288,0,0,5,35,40
41289,0,0,2,12,14
41290,0,0,9,12,21
41291,0,0,6,9,15
41292,0,0,6,13,19
41293,0,1,4,14,19
41294,0,0,15,31,46
41295,0,0,6,8,14
41296,0,0,14,31,45
41297,1,0,13,8,22
41298,0,0,1,6,7
41299,1,0,4,3,8
41300,0,0,5,5,10
41301,0,0,11,24,35
41302,1,0,8,17,26
41303,0,0,8,24,32
41304,0,2,9,39,50
41305,0,0,9,15,24
41306,0,0,5,13,18
41307,0,0,4,9,13
41308,0,0,14,34,48
41309,0,0,14,36,50
41310,0,0,6,15,21
41311,0,0,9,37,46
41312,0,0,12,27,39
41313,0,0,9,26,35
41314,0,1,9,40,50
41315,0,0,7,15,22
41316,0,2,6,26,34
41317,0,0,2,6,8
41318,0,0,1,9,10
41319,0,0,3,1,4
41320,0,0,4,18,22
41321,0,0,10,20,30
41322,0,0,2,2,4
41324,2,3,6,37,48
41325,0,0,8,24,32
41326,0,0,8,15,23
41327,0,0,4,6,10
41328,0,0,10,34,44
41329,0,0,9,29,38
41331,0,0,1,6,7
41332,0,1,6,33,40
41333,0,0,6,5,11
41334,0,0,9,11,20
41336,0,1,0,15,16
41337,1,0,9,40,50
41338,0,0,7,32,39
41339,1,0,9,38,48
41340,1,0,10,16,27
41341,2,0,17,30,49
41342,0,0,3,8,11
41343,0,0,1,6,7
41344,0,0,15,35,50
41345,0,2,5,31,38
41346,0,0,8,10,18
41347,0,0,1,6,7
41349,0,1,6,33,40
41350,0,0,9,13,22
41351,0,0,9,13,22
41352,0,2,11,37,50
41353,1,1,11,11,24
41354,0,0,8,15,23
41355,0,0,5,0,5
41356,0,0,2,12,14
41357,0,1,5,7,13
41358,0,0,5,7,12
41359,0,0,10,20,30
41360,0,0,9,11,20
41361,0,0,5,8,13
41362,0,0,4,14,18
41363,0,0,11,23,34
41364,1,0,8,30,39
41365,0,1,9,32,42
41366,0,0,2,7,9
41367,0,0,11,15,26
41368,0,1,6,14,21
41369,0,0,6,16,22
41370,0,0,2,5,7
41371,0,0,5,7,12
41372,0,0,1,17,18
41373,0,0,9,25,34
41374,0,0,3,33,36
41375,0,1,2,34,37
41376,0,0,8,5,13
41377,0,0,8,19,27
41378,0,0,4,7,11
41379,0,0,10,15,25
41380,1,0,3,16,20
41381,1,2,11,15,29
41382,0,0,2,42,44
41383,0,0,1,11,12
41384,0,0,6,19,25
41385,0,1,3,11,15
41386,0,1,12,37,50
41387,0,1,3,16,20
41388,0,0,4,8,12
41389,0,0,6,19,25
41390,0,0,2,21,23
41391,0,0,15,22,37
41393,0,0,2,20,22
41394,0,0,16,27,43
41395,0,0,6,24,30
41396,0,0,0,9,9
41397,0,0,4,15,19
41398,0,2,7,34,43
41399,0,0,2,8,10
41400,0,0,5,17,22
41401,2,0,7,35,44
41402,1,1,9,13,24
41403,0,0,7,11,18
41404,0,0,7,18,25
41405,0,1,9,24,34
41406,0,0,2,19,21
41407,0,0,4,17,21
41408,0,1,16,17,34
41409,0,3,14,24,41
41410,0,0,9,22,31
41411,0,0,5,11,16
41412,0,0,4,8,12
41413,0,0,0,9,9
41414,0,0,2,12,14
41415,0,1,2,13,16
41416,0,0,15,28,43
41417,0,0,17,33,50
41418,0,0,0,23,23
41419,0,0,1,18,19
41420,0,0,4,31,35
41421,0,0,5,5,10
41422,0,1,5,23,29
41423,0,1,4,9,14
41424,0,1,4,18,23
41425,0,0,1,11,12
41426,0,1,18,24,43
41427,0,0,7,13,20
41428,0,1,10,13,24
41429,1,1,10,33,45
41430,0,0,6,9,15
41431,0,0,1,8,9
41432,0,0,9,9,18
41433,0,0,1,9,10
41434,0,1,11,24,36
41435,0,1,11,29,41
41436,0,0,2,24,26
41437,0,0,6,18,24
41438,0,0,6,30,36
41439,0,0,7,8,15
41440,0,0,5,10,15
41441,0,0,10,29,39
41443,0,0,2,19,21
41444,0,0,2,15,17
41445,0,0,6,18,24
41446,0,0,7,14,21
41447,0,1,9,22,32
41448,0,0,3,6,9
41449,1,0,10,30,41
41451,0,0,9,9,18
41452,0,1,6,12,19
41453,0,0,12,25,37
41454,0,0,14,28,42
41455,0,0,4,20,24
41457,0,1,0,0,1
41458,0,0,6,20,26
41459,0,0,15,15,30
41460,0,1,9,27,37
41461,0,0,1,5,6
41462,0,0,2,3,5
41463,0,0,7,9,16
41464,0,0,9,11,20
41465,0,0,8,14,22
41466,0,0,6,9,15
41467,0,0,6,22,28
41468,0,0,10,28,38
41469,0,0,6,10,16
41470,0,0,8,7,15
41471,0,0,12,26,38
41473,0,0,1,6,7
41474,0,1,2,5,8
41475,1,0,1,4,6
41476,0,0,4,5,9
41477,0,0,4,14,18
41478,0,0,1,12,13
41479,0,0,13,25,38
41480,0,0,2,10,12
41481,0,1,6,29,36
41482,0,0,3,2,5
41483,0,0,3,4,7
41484,0,0,2,12,14
41485,0,0,8,22,30
41486,0,0,11,31,42
41487,0,1,7,17,25
41488,0,0,16,22,38
41489,0,1,0,12,13
41490,0,0,2,7,9
41491,0,0,6,14,20
41492,0,0,4,12,16
41493,0,0,12,21,33
41494,0,0,0,1,1
41495,0,1,11,32,44
41496,0,0,4,10,14
41497,0,2,3,21,26
41498,0,0,1,15,16
41499,2,1,13,34,50
41500,1,0,5,10,16
41501,0,0,4,13,17
41502,0,0,7,19,26
41503,0,0,7,18,25
41504,0,0,10,13,23
41505,0,0,9,29,38
41506,0,0,5,6,11
41507,0,1,2,13,16
41508,0,1,7,15,23
41509,0,0,11,19,30
41510,0,0,7,18,25
41511,0,0,14,29,43
41512,0,0,6,9,15
41513,0,2,5,12,19
41514,0,0,14,12,26
41515,0,0,10,11,21
41516,0,0,5,25,30
41517,0,0,2,7,9
41518,0,0,4,13,17
41519,0,0,3,12,15
41520,0,0,7,8,15
41521,0,0,0,17,17
41522,0,0,11,16,27
41523,0,0,6,20,26
41524,1,0,10,38,49
41525,0,0,8,32,40
41526,0,0,6,16,22
41527,0,1,8,19,28
41528,0,0,11,7,18
41529,1,0,10,33,44
41531,0,0,7,9,16
41532,0,0,3,13,16
41533,0,0,3,2,5
41534,0,1,5,11,17
41535,0,0,7,43,50
41536,0,1,12,32,45
41537,0,0,3,15,18
41538,0,0,10,13,23
41539,0,0,13,20,33
41540,0,0,5,5,10
41541,0,0,6,7,13
41542,0,0,0,16,16
41543,0,0,4,6,10
41544,0,1,4,7,12
41545,0,1,11,27,39
41546,1,0,1,8,10
41548,0,0,13,16,29
41549,0,0,0,16,16
41550,0,0,5,16,21
41551,0,0,6,20,26
41552,0,0,2,3,5
41553,0,2,8,22,32
41554,0,0,9,16,25
41556,0,1,12,30,43
41557,0,1,5,36,42
41558,0,0,5,5,10
41559,0,0,8,4,12
41560,0,0,1,6,7
41561,0,0,5,6,11
41563,0,0,3,8,11
41564,0,0,4,9,13
41565,1,2,5,39,47
41566,0,0,3,8,11
41567,0,0,1,2,3
41568,0,0,6,6,12
41569,0,0,3,7,10
41570,0,0,10,26,36
41571,0,0,5,10,15
41572,1,0,4,8,13
41573,0,1,1,12,14
41575,0,1,19,29,49
41576,0,0,11,26,37
41577,0,0,9,17,26
41578,0,0,12,14,26
41579,0,0,2,6,8
41580,0,0,5,15,20
41581,0,0,7,3,10
41582,0,0,1,9,10
41583,0,0,7,15,22
41584,0,0,5,9,14
41585,0,0,4,15,19
41586,0,1,10,38,49
41587,0,1,10,34,45
41588,0,0,3,7,10
41589,0,0,5,4,9
41590,0,1,7,20,28
41591,0,0,9,18,27
41592,0,0,2,11,13
41593,1,0,4,26,31
41594,0,0,7,18,25
41595,0,3,4,37,44
41596,0,1,7,10,18
41597,0,2,10,15,27
41599,0,0,1,4,5
41600,0,0,17,26,43
41601,0,0,7,26,33
41602,0,0,12,12,24
41603,0,0,11,21,32
41604,1,1,10,23,35
41605,0,0,0,5,5
41606,0,0,3,9,12
41607,0,0,5,6,11
41608,0,0,3,5,8
41609,0,0,2,3,5
41610,0,0,7,7,14
41611,0,0,5,2,7
41612,0,0,4,9,13
41613,0,0,5,6,11
41614,0,0,4,3,7
41615,0,2,1,16,19
41616,0,1,0,6,7
41617,0,0,6,2,8
41618,0,0,5,7,12
41619,0,0,1,12,13
41620,0,1,3,10,14
41621,0,0,7,10,17
41622,0,0,1,4,5
41623,0,0,5,16,21
41624,0,0,6,23,29
41625,0,0,7,21,28
41626,1,1,9,28,39
41627,0,0,3,8,11
41628,0,0,6,17,23
41629,1,0,1,22,24
41630,0,1,12,36,49
41631,0,1,0,11,12
41632,0,0,7,16,23
41633,0,0,9,3,12
41634,0,0,2,10,12
41635,0,0,8,23,31
41636,0,0,9,29,38
41637,0,0,4,11,15
41639,2,0,9,22,33
41640,0,0,6,8,14
41641,0,0,7,12,19
41642,0,0,1,7,8
41643,0,0,3,3,6
41644,0,1,14,30,45
41645,0,0,5,28,33
41646,0,0,7,15,22
41647,1,0,12,17,30
41648,0,0,8,14,22
41649,0,0,3,8,11
41650,0,0,5,6,11
41651,0,0,12,22,34
41652,0,0,5,0,5
41653,1,1,10,38,50
41654,0,0,5,16,21
41655,0,0,1,4,5
41656,0,0,3,42,45
41657,1,0,3,3,7
41658,0,0,9,6,15
41659,0,0,1,5,6
41660,0,0,3,2,5
41661,0,0,1,6,7
41663,0,0,3,3,6
41664,0,0,1,8,9
41665,0,0,10,33,43
41666,0,0,2,2,4
41667,0,0,9,30,39
41668,0,0,4,6,10
41669,0,0,10,20,30
41670,1,0,7,41,49
41671,0,0,1,4,5
41672,0,0,9,11,20
41673,0,0,10,9,19
41674,0,0,12,24,36
41675,0,0,6,15,21
41676,0,1,19,18,38
41677,0,0,12,17,29
41678,0,0,1,17,18
41679,1,0,7,39,47
41680,0,0,9,11,20
41681,0,0,8,22,30
41682,0,0,2,7,9
41683,0,0,9,18,27
41684,0,0,5,5,10
41685,0,0,1,0,1
41686,1,0,4,24,29
41687,0,1,3,9,13
41688,0,0,2,1,3
41689,0,0,9,18,27
41690,0,1,3,14,18
41691,0,0,5,4,9
41692,0,0,1,4,5
41693,0,1,4,10,15
41694,0,0,2,15,17
41695,0,0,18,20,38
41696,0,0,2,4,6
41697,0,1,8,29,38
41698,0,0,5,10,15
41699,0,0,6,13,19
41700,0,1,2,7,10
41701,0,1,7,8,16
41702,0,0,6,2,8
41704,2,2,3,20,27
41705,0,0,5,9,14
41706,0,0,6,13,19
41707,0,3,5,16,24
41708,0,0,11,11,22
41709,0,0,8,11,19
41710,0,2,14,23,39
41711,0,0,4,6,10
41712,0,0,2,13,15
41714,0,0,11,16,27
41715,0,0,0,4,4
41716,0,0,7,13,20
41717,0,0,4,9,13
41718,0,1,0,6,7
41719,0,0,10,18,28
41720,0,0,13,13,26
41721,0,0,6,11,17
41722,1,1,3,10,15
41723,0,2,10,15,27
41724,0,0,4,2,6
41725,0,0,5,11,16
41726,0,0,11,17,28
41727,0,0,3,12,15
41728,0,1,7,21,29
41729,0,0,4,7,11
41730,0,0,5,11,16
41731,0,0,2,9,11
41732,0,2,8,9,19
41733,0,0,5,2,7
41734,0,0,2,3,5
41736,0,0,1,7,8
41737,0,0,6,8,14
41738,0,0,6,9,15
41739,0,0,7,17,24
41740,0,0,2,17,19
41741,0,0,0,1,1
41742,0,0,5,11,16
41743,0,0,2,6,8
41744,0,0,3,10,13
41745,1,0,5,7,13
41746,0,0,7,10,17
41747,0,0,7,16,23
41748,0,1,5,5,11
41749,0,0,3,7,10
41751,0,0,8,10,18
41752,0,0,4,9,13
41753,0,1,11,18,30
41755,0,0,1,11,12
41756,0,0,4,2,6
41757,0,0,1,1,2
41758,0,0,2,3,5
41759,0,0,3,6,9
41761,0,0,6,19,25
41763,0,0,12,32,44
41764,0,2,7,17,26
41765,0,0,3,3,6
41766,0,0,0,2,2
41767,0,0,10,20,30
41768,0,0,3,4,7
41769,0,1,2,12,15
41770,0,0,0,3,3
41773,0,0,8,15,23
41774,0,0,0,7,7
41775,1,1,11,11,24
41776,1,0,11,27,39
41777,0,0,2,12,14
41778,0,0,6,9,15
41779,0,0,6,44,50
41780,0,0,3,4,7
41781,1,6,13,30,50
41782,0,0,3,10,13
41783,0,3,2,2,7
41784,0,0,8,15,23
41785,0,0,3,7,10
41786,0,0,5,7,12
41787,1,1,0,24,26
41788,0,0,3,2,5
41789,0,1,5,7,13
41790,1,0,2,5,8
41791,0,0,8,14,22
41792,0,0,1,20,21
41793,0,0,10,19,29
41794,0,0,6,25,31
41795,2,1,7,14,24
41796,0,0,1,3,4
41797,0,0,7,29,36
41798,0,2,4,18,24
41799,0,0,6,16,22
41800,1,0,9,39,49
41801,0,1,0,18,19
41802,0,0,0,9,9
41803,0,0,1,17,18
41804,0,2,11,37,50
41805,0,0,4,15,19
41806,0,0,8,24,32
41807,0,0,2,5,7
41808,0,0,10,20,30
41809,0,0,11,18,29
41810,1,2,11,15,29
41811,0,1,10,38,49
41812,0,0,10,14,24
41813,0,1,5,40,46
41814,0,2,7,41,50
41815,1,5,10,31,47
41816,0,4,10,36,50
41817,0,0,4,1,5
41819,0,0,7,9,16
41820,0,0,6,10,16
41821,0,0,2,5,7
41822,0,0,0,9,9
41823,0,0,4,8,12
41824,0,0,7,10,17
41825,0,0,10,26,36
41826,0,0,5,25,30
41827,0,0,2,22,24
41828,0,0,11,36,47
41829,0,1,13,18,32
41830,1,0,7,23,31
41832,1,0,17,32,50
41833,0,1,6,21,28
41834,0,0,8,21,29
41835,0,1,12,30,43
41836,0,0,6,9,15
41837,1,1,13,33,48
41838,0,0,9,19,28
41839,0,1,8,15,24
41840,0,0,5,7,12
41841,0,0,10,33,43
41842,0,1,2,22,25
41843,0,0,8,13,21
41844,0,0,9,19,28
41845,2,0,9,18,29
41846,0,0,9,8,17
41847,0,2,9,16,27
41848,0,0,8,28,36
41849,0,0,9,21,30
41850,2,0,2,21,25
41851,0,0,5,14,19
41852,0,2,11,32,45
41853,0,0,13,22,35
41854,0,0,21,29,50
41855,0,1,11,24,36
41856,0,0,5,10,15
41857,0,2,13,35,50
41858,0,0,12,32,44
41859,0,0,6,24,30
41860,0,1,3,22,26
41861,0,0,10,20,30
41862,0,1,13,36,50
41863,0,0,5,9,14
41864,0,0,8,29,37
41865,0,1,9,21,31
41866,0,0,5,32,37
41867,0,0,6,19,25
41868,2,3,12,18,35
41869,0,0,16,33,49
41870,0,0,12,26,38
41871,0,1,1,24,26
41872,2,2,1,2,7
41874,0,0,6,12,18
41875,0,0,7,21,28
41876,1,1,12,36,50
41877,0,1,2,5,8
41878,0,0,10,7,17
41879,0,1,9,11,21
41880,0,4,9,37,50
41881,0,1,6,21,28
41882,0,0,8,23,31
41883,0,3,6,34,43
41884,0,0,15,32,47
41885,0,0,9,8,17
41886,0,0,8,17,25
41887,0,1,11,15,27
41888,0,2,3,21,26
41889,0,0,10,39,49
41890,0,2,11,33,46
41891,1,0,8,34,43
41892,1,2,4,26,33
41893,0,0,6,15,21
41894,0,0,7,43,50
41895,0,0,5,7,12
41896,0,0,7,12,19
41897,0,0,16,25,41
41898,0,0,10,13,23
41899,0,0,6,10,16
41900,0,0,2,12,14
41902,0,1,12,24,37
41903,0,0,1,16,17
41904,0,0,6,3,9
41905,0,0,3,15,18
41906,0,0,9,12,21
41907,1,0,2,12,15
41908,1,1,1,26,29
41909,0,0,7,21,28
41910,0,0,3,12,15
41911,0,1,21,23,45
41912,0,0,13,29,42
41913,0,1,10,15,26
41914,0,0,4,14,18
41915,0,0,14,24,38
41916,0,0,2,12,14
41917,0,1,4,9,14
41918,0,0,8,14,22
41919,1,1,3,18,23
41920,0,1,3,20,24
41921,0,0,5,12,17
41922,0,0,10,19,29
41923,0,0,6,4,10
41924,0,0,14,19,33
41925,1,0,10,17,28
41926,0,0,4,13,17
41927,0,0,1,20,21
41928,0,0,9,26,35
41929,0,0,3,8,11
41930,0,0,12,33,45
41931,0,1,2,4,7
41932,0,0,8,7,15
41933,0,0,8,16,24
41934,0,0,6,25,31
41935,0,1,5,13,19
41936,0,0,6,6,12
41937,0,1,4,42,47
41938,1,0,6,43,50
41939,0,1,8,39,48
41941,0,0,2,8,10
41942,0,0,6,24,30
41943,1,1,4,8,14
41944,0,0,11,12,23
41945,0,0,15,32,47
41946,0,0,4,7,11
41947,0,0,5,19,24
41948,0,0,11,39,50
41949,0,0,0,7,7
41950,1,0,3,25,29
41951,0,0,0,1,1
41952,0,0,6,11,17
41953,0,0,5,7,12
41954,0,0,0,2,2
41955,0,0,6,21,27
41956,0,0,7,12,19
41957,0,0,7,15,22
41958,1,0,11,27,39
41959,0,0,9,27,36
41960,0,2,3,7,12
41961,0,0,2,7,9
41962,0,0,1,3,4
41963,0,0,1,4,5
41964,0,1,10,35,46
41965,1,0,7,4,12
41966,0,0,4,4,8
41967,0,0,5,18,23
41968,0,0,3,17,20
41969,0,0,10,12,22
41970,0,0,3,2,5
41971,0,0,10,21,31
41972,0,0,13,37,50
41973,0,0,5,4,9
41974,1,2,11,18,32
41975,0,2,4,26,32
41976,0,0,14,36,50
41977,0,0,4,10,14
41978,0,1,8,41,50
41979,0,0,5,11,16
41981,0,1,11,36,48
41982,0,0,0,9,9
41983,0,0,11,21,32
41984,0,0,7,16,23
41985,0,0,4,5,9
41986,0,0,11,17,28
41987,0,0,4,14,18
41988,0,0,2,9,11
41990,0,0,0,2,2
41992,0,0,5,39,44
41993,0,0,5,21,26
41994,0,0,7,17,24
41995,0,0,5,15,20
41996,0,1,2,7,10
41997,1,0,9,11,21
41998,0,0,4,33,37
41999,0,0,8,15,23
42001,0,0,1,5,6
42003,0,0,8,25,33
42004,0,0,9,20,29
42005,0,1,2,9,12
42006,0,0,5,27,32
42007,0,1,5,18,24
42008,0,0,10,15,25
42009,1,0,8,12,21
42010,0,0,0,6,6
42011,0,0,6,20,26
42012,0,0,3,6,9
42013,0,0,4,6,10
42014,0,1,10,19,30
42015,0,1,1,30,32
42016,0,0,4,18,22
42017,0,0,8,8,16
42019,0,4,5,11,20
42020,0,0,4,7,11
42022,0,0,4,20,24
42023,1,6,13,30,50
42024,0,0,1,6,7
42025,0,0,16,27,43
42026,0,0,6,44,50
42027,1,1,11,11,24
42028,0,0,14,29,43
42029,0,0,9,29,38
42030,0,0,3,10,13
42032,0,2,14,23,39
42033,0,0,5,5,10
42034,0,0,6,13,19
42035,0,0,8,22,30
42036,0,0,6,9,15
42037,1,0,1,8,10
42038,1,1,10,38,50
42039,0,0,1,10,11
42040,0,0,4,28,32
42041,0,0,4,15,19
42042,0,0,15,33,48
42043,0,1,4,45,50
42044,0,0,3,30,33
42045,0,0,21,29,50
42046,1,1,13,33,48
42047,0,0,5,32,37
42048,0,0,2,3,5
42049,1,0,7,9,17
42051,1,0,2,12,15
42052,0,0,14,36,50
42053,0,2,3,21,26
42054,0,0,0,11,11
42055,0,3,6,34,43
42056,0,0,4,14,18
42057,0,0,6,14,20
42058,0,1,1,24,26
42059,0,0,10,20,30
42060,0,0,6,16,22
42061,0,1,2,5,8
42062,0,0,4,18,22
42063,0,0,1,10,11
42064,0,0,4,20,24
42065,0,0,9,11,20
42066,0,0,10,12,22
42068,0,0,2,6,8
42069,0,0,5,18,23
42070,0,0,4,14,18
42072,0,0,2,1,3
42073,0,0,7,26,33
42074,0,1,12,36,49
42075,2,0,0,8,10
42076,0,0,1,7,8
42077,0,0,14,24,38
42078,0,0,0,2,2
42079,2,1,0,9,12
42080,0,0,7,21,28
42081,0,1,12,36,49
42082,0,0,5,17,22
42083,0,0,15,22,37
42084,1,1,9,13,24
42085,1,1,11,11,24
42086,0,1,2,12,15
42087,1,1,10,29,41
42088,0,0,2,6,8
42089,0,0,12,33,45
42090,0,0,2,14,16
42091,0,0,4,13,17
42093,0,0,2,28,30
42094,0,0,3,7,10
42095,1,1,13,33,48
42096,0,0,0,6,6
42097,0,0,3,11,14
42098,0,1,5,18,24
42099,2,1,2,11,16
42100,0,0,11,38,49
42101,0,1,12,17,30
42102,1,0,18,31,50
42103,0,0,2,3,5
42104,0,0,2,29,31
42106,0,0,0,9,9
42107,0,1,3,18,22
42108,0,1,8,11,20
42110,0,0,3,12,15
42111,0,1,4,11,16
42112,0,0,12,20,32
42113,0,0,0,20,20
42114,0,0,6,8,14
42115,0,0,10,24,34
42116,0,0,4,12,16
42117,0,0,4,17,21
42119,0,0,5,4,9
42120,1,2,7,40,50
42121,0,1,7,14,22
42122,0,0,4,10,14
42123,0,0,3,14,17
42124,0,0,3,5,8
42126,1,0,5,11,17
42127,2,0,9,17,28
42128,0,0,10,15,25
42129,2,0,8,16,26
42130,0,0,2,12,14
42131,0,1,7,13,21
42132,1,1,4,43,49
42133,0,2,0,4,6
42134,0,0,1,4,5
42135,0,1,5,12,18
42136,0,0,3,11,14
42137,0,0,8,29,37
42138,0,1,1,11,13
42139,0,0,4,11,15
42140,0,1,4,17,22
42141,0,0,5,21,26
42142,0,0,2,11,13
42143,0,0,4,12,16
42144,0,0,8,12,20
42145,0,0,7,4,11
42146,0,0,6,16,22
42147,0,0,4,4,8
42148,0,0,15,30,45
42150,0,0,5,8,13
42151,0,0,6,11,17
42152,0,0,5,9,14
42153,0,0,0,9,9
42154,0,0,4,6,10
42155,0,1,11,14,26
42156,0,0,3,7,10
42157,0,1,6,17,24
42158,0,0,2,14,16
42159,0,0,13,34,47
42160,0,2,2,12,16
42161,0,1,7,22,30
42162,0,0,4,3,7
42163,0,0,0,5,5
42164,0,0,4,10,14
42165,0,1,3,8,12
42166,0,0,14,22,36
42167,0,0,1,9,10
42168,0,0,2,15,17
42169,0,0,0,7,7
42170,0,0,1,10,11
42171,0,2,5,43,50
42172,0,0,0,7,7
42173,0,0,4,7,11
42174,0,0,11,29,40
42175,0,1,8,41,50
42176,0,0,2,3,5
42177,1,0,3,44,48
42178,2,0,1,8,11
42179,0,0,2,3,5
42180,0,0,8,28,36
42181,0,1,17,24,42
42182,0,1,0,6,7
42183,0,0,2,21,23
42184,0,2,2,12,16
42186,0,0,9,8,17
42187,0,2,4,9,15
42188,0,0,6,11,17
42190,0,0,3,6,9
42191,0,1,6,8,15
42192,0,0,3,11,14
42193,0,0,15,6,21
42194,0,0,7,11,18
42195,0,1,6,5,12
42196,1,0,11,22,34
42197,0,0,1,5,6
42198,0,0,2,0,2
42199,0,1,9,15,25
42200,0,0,5,12,17
42201,0,0,8,18,26
42203,0,0,3,8,11
42204,0,0,2,9,11
42205,0,0,2,3,5
42206,1,1,11,11,24
42207,1,0,0,9,10
42208,0,1,13,10,24
42209,3,0,1,8,12
42210,0,0,5,21,26
42211,2,1,10,35,48
42212,0,0,9,18,27
42213,0,0,14,26,40
42214,1,0,11,22,34
42215,0,1,14,29,44
42216,0,1,9,37,47
42217,0,1,8,41,50
42218,0,0,16,34,50
42219,0,1,9,15,25
42220,0,5,11,31,47
42221,0,0,5,11,16
42222,1,0,5,25,31
42223,0,0,8,13,21
42224,0,0,1,9,10
42225,0,1,12,17,30
42226,0,0,8,18,26
42227,0,1,6,43,50
42228,0,0,1,10,11
42229,0,0,4,12,16
42230,0,1,2,17,20
42231,0,1,4,23,28
42232,0,0,8,34,42
42233,1,1,5,20,27
42234,0,0,7,24,31
42235,1,2,7,40,50
42236,0,0,7,31,38
42237,0,0,10,23,33
42238,0,1,6,14,21
42239,1,0,4,24,29
42240,0,0,3,8,11
42242,0,1,8,12,21
42243,0,0,10,7,17
42244,0,0,5,28,33
42245,0,0,17,26,43
42246,0,1,6,21,28
42247,0,0,7,9,16
42248,0,0,2,7,9
42249,3,0,5,12,20
42250,0,1,6,8,15
42251,0,1,3,24,28
42252,0,0,15,30,45
42253,0,1,5,32,38
42254,0,0,4,13,17
42255,0,0,3,6,9
42256,0,1,1,11,13
42257,0,0,4,10,14
42258,0,0,0,7,7
42259,0,0,8,10,18
42260,0,0,7,6,13
42261,0,0,2,18,20
42262,0,0,2,8,10
42263,0,0,5,18,23
42264,1,0,9,40,50
42265,1,0,0,9,10
42266,0,0,8,19,27
42267,0,1,0,18,19
42268,0,0,6,25,31
42269,0,0,12,16,28
42270,0,0,8,17,25
42271,0,0,6,24,30
42272,0,0,0,5,5
42273,0,0,4,11,15
42274,0,0,5,4,9
42275,0,0,12,38,50
42276,0,1,6,10,17
42277,0,0,2,3,5
42278,0,0,2,9,11
42279,0,0,4,3,7
42280,0,0,5,10,15
42281,0,0,10,25,35
42282,1,1,11,37,50
42283,0,0,8,9,17
42284,0,0,6,21,27
42285,0,0,2,11,13
42286,1,0,18,31,50
42287,1,1,11,11,24
42288,0,1,13,10,24
42289,0,1,8,41,50
42290,0,0,4,4,8
42291,0,0,1,3,4
42292,0,0,3,5,8
42293,0,1,11,27,39
42294,0,0,3,12,15
42295,0,2,1,28,31
42296,0,0,2,36,38
42297,3,0,5,12,20
42298,0,0,8,30,38
42299,0,1,6,43,50
42300,1,0,4,24,29
42301,0,0,2,11,13
42302,0,0,3,8,11
42303,0,0,5,18,23
42304,1,1,15,30,47
42305,0,0,1,4,5
42306,1,0,18,31,50
42307,0,0,8,12,20
42308,1,1,11,11,24
42309,0,1,6,33,40
42310,0,0,4,15,19
42311,0,0,5,22,27
42312,0,0,7,12,19
42313,0,0,16,24,40
42314,0,0,12,26,38
42315,0,2,2,16,20
42316,0,1,1,4,6
42317,0,0,2,11,13
42318,0,0,5,17,22
42319,0,0,3,17,20
42320,0,0,8,11,19
42321,0,0,7,18,25
42322,0,0,5,6,11
42323,0,0,2,6,8
42324,0,0,5,7,12
42325,0,0,9,16,25
42326,0,0,10,19,29
42327,0,1,17,32,50
42328,0,2,4,27,33
42329,0,0,10,34,44
42330,0,0,9,17,26
42331,0,1,4,39,44
42332,0,0,1,4,5
42333,0,2,4,33,39
42334,0,1,9,15,25
42335,0,0,8,10,18
42336,0,0,2,13,15
42337,0,1,12,17,30
42338,0,1,3,10,14
42339,0,0,6,14,20
42340,0,1,0,8,9
42341,0,0,2,11,13
42342,0,0,4,20,24
42343,0,0,8,13,21
42344,0,1,14,19,34
42345,0,1,5,36,42
42346,0,0,1,6,7
42347,0,0,3,9,12
42348,1,0,0,5,6
42349,0,0,5,21,26
42350,0,0,3,10,13
42351,0,0,5,15,20
42352,0,1,4,43,48
42353,0,0,0,23,23
42354,0,0,4,35,39
42355,0,0,9,19,28
42356,0,3,14,32,49
42357,0,0,7,13,20
42358,0,0,8,19,27
42359,0,2,6,38,46
42360,0,0,2,19,21
42361,0,0,5,14,19
42362,0,0,7,19,26
42363,1,0,8,25,34
42364,0,0,6,8,14
42365,0,0,1,14,15
42366,0,0,7,38,45
42367,0,0,8,22,30
42368,0,0,8,9,17
42370,0,0,12,28,40
42371,0,0,6,7,13
42372,0,0,8,9,17
42373,0,0,9,10,19
42374,0,0,9,22,31
42375,0,0,7,15,22
42376,0,0,12,32,44
42377,0,0,3,10,13
42378,0,0,2,31,33
42381,0,0,3,19,22
42382,1,0,8,40,49
42383,0,0,9,29,38
42384,0,2,11,22,35
42385,0,0,8,9,17
42386,0,0,4,5,9
42387,0,0,4,4,8
42388,0,0,14,22,36
42389,1,2,11,18,32
42390,0,1,6,29,36
42391,0,0,4,12,16
42392,0,0,0,9,9
42393,0,0,9,5,14
42394,0,1,2,3,6
42395,0,0,10,24,34
42396,0,0,8,8,16
42397,0,1,9,19,29
42398,0,0,2,7,9
42399,0,0,4,17,21
42400,0,0,6,20,26
42402,2,0,7,23,32
42403,0,0,3,15,18
42404,0,1,9,17,27
42405,0,0,5,12,17
42406,0,0,15,6,21
42407,0,0,5,19,24
42408,0,0,4,6,10
42409,0,0,10,20,30
42410,0,0,11,12,23
42411,0,0,7,16,23
42412,0,0,4,13,17
42413,0,0,10,18,28
42414,0,0,2,17,19
42415,0,1,5,12,18
42416,0,0,7,19,26
42417,0,0,3,10,13
42418,0,0,0,2,2
42419,0,0,8,12,20
42421,0,0,4,5,9
42422,0,0,0,8,8
42423,0,1,7,40,48
42424,0,0,7,16,23
42425,0,0,8,11,19
42426,0,0,1,9,10
42427,0,0,4,13,17
42428,0,0,9,26,35
42429,0,0,3,5,8
42430,0,0,4,6,10
42431,0,0,1,6,7
42432,0,0,16,26,42
42433,0,1,4,20,25
42434,0,0,3,2,5
42435,0,1,10,19,30
42436,0,0,5,8,13
42437,0,0,7,7,14
42438,1,0,6,22,29
42439,0,0,6,28,34
42440,0,0,5,21,26
42441,0,0,9,9,18
42442,0,0,2,16,18
42443,0,0,5,13,18
42444,0,1,6,24,31
42445,0,0,6,18,24
42446,0,0,6,17,23
42447,0,0,4,20,24
42448,0,0,16,34,50
42449,0,0,10,10,20
42450,0,0,7,9,16
42451,0,1,3,8,12
42452,0,1,5,7,13
42453,1,1,6,18,26
42454,0,0,3,8,11
42455,0,0,5,10,15
42456,0,0,12,29,41
42457,0,0,8,17,25
42458,2,1,2,10,15
42459,0,0,8,17,25
42460,0,0,5,18,23
42461,0,0,4,16,20
42463,0,0,9,17,26
42464,0,0,5,21,26
42465,0,0,8,18,26
42466,1,0,1,7,9
42467,0,0,2,7,9
42468,0,0,4,8,12
42469,0,2,7,13,22
42470,0,0,2,14,16
42471,0,1,3,12,16
42473,0,0,1,30,31
42474,0,1,10,17,28
42475,0,0,6,26,32
42476,0,0,4,4,8
42477,0,0,4,18,22
42478,0,0,13,19,32
42479,1,0,10,17,28
42480,0,0,5,4,9
42481,0,0,3,5,8
42483,0,0,2,25,27
42484,0,0,0,3,3
42485,0,0,4,6,10
42486,0,0,5,14,19
42487,0,2,10,37,49
42488,0,1,4,14,19
42489,0,0,0,10,10
42490,0,2,8,15,25
42491,0,0,5,11,16
42492,0,0,5,19,24
42493,1,0,1,8,10
42494,1,1,11,27,40
42495,0,2,18,29,49
42496,0,0,6,17,23
42497,1,0,6,22,29
42498,0,0,3,6,9
42499,1,0,1,15,17
42500,0,0,9,20,29
42501,0,0,4,8,12
42502,0,0,6,6,12
42503,1,0,3,16,20
42504,0,0,7,19,26
42506,0,0,8,19,27
42507,0,0,6,12,18
42508,0,0,11,18,29
42509,0,0,6,6,12
42510,0,0,2,5,7
42511,0,0,1,6,7
42512,0,0,3,21,24
42513,0,0,2,24,26
42516,0,0,4,15,19
42517,0,0,6,9,15
42518,0,0,8,19,27
42519,0,0,9,12,21
42520,0,0,2,6,8
42521,0,0,2,12,14
42522,0,0,8,39,47
42523,0,0,10,10,20
42524,0,0,9,15,24
42525,0,0,4,20,24
42526,0,1,13,22,36
42527,0,0,0,4,4
42528,1,0,5,15,21
42529,0,0,3,15,18
42530,0,0,0,5,5
42531,0,0,6,14,20
42532,0,0,3,8,11
42533,0,1,4,21,26
42534,5,0,4,19,28
42535,0,0,1,11,12
42536,0,0,12,25,37
42537,0,1,6,14,21
42538,0,0,7,18,25
42539,0,0,4,3,7
42540,0,0,5,5,10
42541,0,0,4,17,21
42542,0,0,10,22,32
42543,0,2,7,14,23
42544,0,0,9,21,30
42545,0,1,7,18,26
42546,1,0,9,4,14
42547,0,0,4,10,14
42548,0,1,5,10,16
42550,0,0,1,15,16
42551,0,1,9,23,33
42552,0,0,5,10,15
42553,0,0,4,6,10
42554,1,0,8,5,14
42555,0,1,6,33,40
42556,1,0,2,5,8
42557,0,0,4,22,26
42558,0,1,14,20,35
42559,0,0,6,12,18
42560,0,0,2,3,5
42561,0,0,1,2,3
42562,0,0,0,12,12
42563,0,0,6,10,16
42565,0,0,10,20,30
42567,0,0,6,16,22
42568,0,1,7,19,27
42569,0,0,6,16,22
42570,0,0,1,2,3
42573,1,1,12,27,41
42577,0,0,1,12,13
42578,0,0,2,6,8
42579,0,0,6,7,13
42580,0,0,0,3,3
42581,0,0,14,29,43
42582,0,0,4,4,8
42583,1,0,3,10,14
42584,1,0,5,10,16
42585,0,0,5,9,14
42586,0,0,5,6,11
42588,0,0,2,7,9
42589,0,0,10,13,23
42591,0,0,13,34,47
42592,0,1,10,15,26
42594,0,0,3,10,13
42595,0,1,8,40,49
42596,0,1,11,21,33
42597,0,3,2,45,50
42598,0,0,2,7,9
42599,0,0,6,25,31
42600,0,0,2,15,17
42601,0,0,6,13,19
42602,0,0,0,9,9
42604,0,1,7,9,17
42605,0,0,6,3,9
42606,0,0,13,18,31
42607,0,0,2,21,23
42608,0,0,8,15,23
42609,0,0,1,6,7
42610,0,0,1,4,5
42611,0,6,5,17,28
42613,1,0,0,12,13
42614,0,0,0,2,2
42616,0,0,7,21,28
42619,0,0,6,14,20
42620,0,0,5,17,22
42623,0,0,5,6,11
42624,0,2,4,20,26
42626,0,0,21,28,49
42627,0,0,2,17,19
42630,0,0,5,5,10
42631,0,2,9,19,30
42632,0,0,1,4,5
42633,0,0,2,2,4
42634,0,4,18,28,50
42635,0,0,6,44,50
42636,1,1,12,33,47
42638,0,2,0,6,8
42639,0,0,1,4,5
42640,0,0,3,14,17
42641,0,4,15,30,49
42643,1,0,1,16,18
42644,0,0,13,26,39
42645,0,0,5,4,9
42646,1,1,11,11,24
42647,0,0,0,11,11
42648,0,3,5,16,24
42649,0,0,6,9,15
42650,0,0,1,6,7
42651,0,2,17,31,50
42652,0,0,0,8,8
42653,0,0,2,3,5
42654,0,0,4,12,16
42655,0,0,4,11,15
42656,0,0,2,4,6
42657,0,0,7,11,18
42658,0,2,4,27,33
42659,0,0,2,8,10
42660,0,0,5,10,15
42661,1,0,16,33,50
42662,0,1,3,3,7
42663,0,0,10,19,29
42664,0,1,10,38,49
42665,0,1,12,34,47
42666,0,0,3,21,24
42667,0,0,8,17,25
42669,0,0,3,20,23
42670,0,0,9,23,32
42671,0,0,14,27,41
42672,0,1,3,14,18
42673,0,1,12,17,30
42674,0,0,14,36,50
42675,0,0,15,26,41
42676,0,1,2,19,22
42677,0,0,6,33,39
42678,1,0,0,27,28
42679,0,0,8,13,21
42680,0,0,13,29,42
42681,0,0,5,11,16
42682,0,0,6,19,25
42683,0,0,4,2,6
42684,0,0,1,7,8
42685,2,2,7,25,36
42686,1,1,3,18,23
42687,0,4,18,28,50
42688,0,0,11,24,35
42689,2,1,13,22,38
42690,0,0,5,12,17
42691,0,0,3,3,6
42692,0,0,6,4,10
42693,0,0,0,11,11
42694,1,0,5,10,16
42695,0,0,8,20,28
42696,0,0,6,11,17
42697,0,2,12,35,49
42698,0,0,3,6,9
42699,1,0,3,7,11
42700,1,0,14,35,50
42701,1,1,5,9,16
42702,0,0,8,17,25
42703,1,0,9,35,45
42704,0,0,1,8,9
42705,0,0,6,17,23
42706,0,0,8,13,21
42707,0,0,1,8,9
42708,0,1,0,17,18
42709,0,2,11,32,45
42710,0,0,15,21,36
42711,0,0,9,9,18
42712,0,0,8,35,43
42713,0,0,11,26,37
42714,0,0,5,13,18
42715,0,0,16,34,50
42716,0,0,10,24,34
42717,0,0,5,21,26
42718,0,0,5,8,13
42719,1,0,8,40,49
42720,0,0,7,8,15
42721,0,1,4,11,16
42722,0,1,13,19,33
42723,0,0,3,8,11
42725,0,0,9,22,31
42726,0,0,11,27,38
42727,0,1,3,22,26
42728,0,0,12,33,45
42729,0,0,5,16,21
42730,0,1,11,22,34
42731,0,0,2,42,44
42732,0,0,10,19,29
42733,0,0,5,45,50
42734,1,0,6,21,28
42735,0,0,11,34,45
42736,0,0,2,5,7
42737,0,0,11,20,31
42738,0,0,10,27,37
42739,0,1,16,27,44
42740,1,1,2,23,27
42741,0,0,1,4,5
42742,0,0,9,16,25
42743,0,1,6,17,24
42744,0,0,0,2,2
42745,0,0,10,3,13
42746,0,1,2,18,21
42747,0,0,9,8,17
42748,0,1,1,17,19
42749,0,1,3,20,24
42750,0,0,6,44,50
42751,0,1,8,25,34
42752,1,0,4,20,25
42753,0,0,2,3,5
42754,0,0,7,32,39
42755,0,0,10,15,25
42756,0,0,10,24,34
42757,0,0,6,3,9
42758,0,0,0,16,16
42759,0,0,10,15,25
42760,1,0,6,24,31
42761,0,0,2,2,4
42762,0,0,6,14,20
42763,0,0,13,31,44
42764,1,0,1,16,18
42765,0,0,4,7,11
42766,0,0,9,22,31
42767,0,0,10,18,28
42768,0,0,15,35,50
42769,1,0,5,16,22
42771,0,0,10,12,22
42772,0,2,7,34,43
42773,0,0,4,18,22
42774,0,0,5,4,9
42775,0,1,2,9,12
42776,0,0,4,30,34
42777,0,1,6,33,40
42778,0,0,6,15,21
42779,0,0,10,18,28
42780,0,0,3,4,7
42781,0,0,9,35,44
42782,0,0,1,13,14
42783,0,0,2,7,9
42784,0,0,9,27,36
42785,0,0,5,27,32
42786,0,3,0,14,17
42787,0,1,3,14,18
42788,0,0,10,6,16
42789,1,0,8,28,37
42790,0,0,8,37,45
42791,0,0,10,39,49
42792,0,0,7,6,13
42793,0,0,12,36,48
42794,0,0,5,17,22
42796,1,0,4,4,9
42797,0,0,6,9,15
42798,0,0,2,6,8
42799,0,0,9,15,24
42800,0,0,3,24,27
42801,0,0,5,14,19
42802,0,0,4,7,11
42803,1,0,5,25,31
42804,0,0,4,19,23
42805,0,2,12,18,32
42806,0,0,4,15,19
42807,0,0,8,8,16
42808,0,2,7,40,49
42809,1,0,9,19,29
42811,0,1,3,11,15
42812,0,0,4,46,50
42813,1,0,2,5,8
42814,0,0,7,23,30
42815,0,0,0,4,4
42816,0,0,3,15,18
42818,0,0,5,5,10
42820,1,0,4,9,14
42821,1,0,11,16,28
42822,1,0,3,12,16
42824,1,0,1,8,10
42825,0,0,0,1,1
42826,0,0,0,14,14
42827,0,0,2,3,5
42828,0,1,9,15,25
42829,0,0,2,11,13
42830,0,0,10,34,44
42831,0,0,2,31,33
42832,0,0,12,32,44
42833,0,0,8,10,18
42834,0,0,6,12,18
42835,0,4,15,30,49
42836,0,2,9,19,30
42837,0,0,2,12,14
42839,0,1,3,12,16
42841,0,1,4,20,25
42842,1,1,11,11,24
42843,0,0,0,2,2
42844,0,0,1,6,7
42845,0,0,1,6,7
42846,0,0,5,10,15
42847,0,0,0,9,9
42848,0,0,2,17,19
42849,0,1,6,33,40
42850,0,0,6,16,22
42851,0,1,5,10,16
42853,0,0,14,36,50
42854,0,0,2,42,44
42855,0,0,0,11,11
42856,0,1,4,11,16
42857,0,0,8,20,28
42858,0,1,3,22,26
42859,0,0,10,19,29
42860,0,0,5,22,27
42861,0,1,3,18,22
42862,0,1,5,10,16
42863,0,0,3,10,13
42864,0,0,2,3,5
42865,0,0,5,13,18
42866,1,0,9,19,29
42867,0,0,2,11,13
42868,0,0,9,22,31
42869,0,0,0,9,9
42870,0,0,0,11,11
42872,0,0,1,6,7
42873,0,0,8,10,18
42874,1,0,9,19,29
42875,0,0,4,14,18
42876,0,2,16,20,38
42877,0,1,1,18,20
42878,0,0,1,10,11
42879,0,1,6,33,40
42880,1,1,3,18,23
42882,0,0,9,19,28
42883,0,0,5,21,26
42884,0,2,7,40,49
42885,0,0,14,27,41
42886,0,2,8,15,25
42887,0,0,5,21,26
42888,0,0,0,2,2
42889,1,1,12,33,47
42891,1,0,2,3,6
42892,0,0,5,8,13
42893,1,0,1,3,5
42894,1,0,2,3,6
42895,0,0,0,7,7
42896,0,0,5,7,12
42897,0,1,0,11,12
42898,0,0,3,3,6
42899,1,0,0,10,11
42900,1,0,11,22,34
42901,0,1,3,18,22
42902,0,0,0,17,17
42903,0,0,5,7,12
42904,1,0,11,22,34
42905,0,1,13,36,50
42906,1,0,0,10,11
42907,1,0,2,3,6
42908,0,1,8,22,31
42909,1,0,6,8,15
42910,0,0,1,7,8
42911,1,0,11,22,34
42912,0,1,3,18,22
42913,0,0,0,17,17
42914,0,0,3,3,6
42915,1,0,2,2,5
42916,1,0,2,3,6
42917,0,0,0,13,13
42918,0,0,2,3,5
42919,0,0,2,6,8
42920,0,0,4,9,13
42922,0,0,8,17,25
42923,0,2,1,11,14
42924,0,2,6,4,12
42925,0,2,6,21,29
42926,0,0,1,13,14
42927,1,0,6,16,23
42928,0,1,4,17,22
42929,0,0,3,8,11
42930,0,0,1,10,11
42931,0,0,7,15,22
42932,1,1,2,8,12
42933,0,0,5,11,16
42934,0,12,1,11,24
42935,0,0,3,30,33
42936,0,0,3,10,13
42937,0,0,16,18,34
42938,0,0,6,11,17
42939,1,0,0,7,8
42940,0,0,10,19,29
42941,0,0,8,14,22
42942,0,1,2,5,8
42943,0,0,5,4,9
42944,0,2,4,11,17
42945,0,0,7,12,19
42946,0,1,14,24,39
42947,0,0,2,21,23
42948,0,0,5,10,15
42949,0,0,3,14,17
42950,0,0,4,26,30
42951,0,0,6,7,13
42952,0,1,3,14,18
42953,0,0,3,9,12
42954,0,0,4,20,24
42955,0,0,3,4,7
42956,0,0,11,30,41
42957,1,1,2,20,24
42958,0,0,6,34,40
42959,0,2,6,19,27
42960,0,0,3,5,8
42961,0,0,1,4,5
42962,0,0,5,9,14
42963,0,0,2,6,8
42964,1,0,2,2,5
42965,0,1,9,22,32
42966,0,0,3,11,14
42967,0,0,9,17,26
42968,0,0,6,18,24
42969,3,1,1,17,22
42970,0,0,10,7,17
42971,0,0,3,17,20
42972,0,3,3,15,21
42973,0,1,10,35,46
42974,0,0,3,7,10
42975,0,0,2,5,7
42976,1,0,6,20,27
42977,0,2,14,17,33
42978,0,0,1,5,6
42979,0,1,1,6,8
42980,1,1,1,6,9
42981,0,1,5,13,19
42982,0,8,12,30,50
42983,0,0,8,14,22
42984,0,0,0,5,5
42985,0,0,6,8,14
42986,0,1,7,3,11
42987,0,0,1,9,10
42988,0,0,13,25,38
42989,0,0,9,26,35
42990,0,0,6,10,16
42992,0,3,13,20,36
42993,0,0,3,4,7
42994,0,0,8,11,19
42995,0,1,1,3,5
42996,0,1,0,11,12
42997,1,0,12,21,34
42998,0,0,5,9,14
42999,0,0,8,17,25
43000,0,7,17,22,46
43001,0,0,5,13,18
43003,0,0,0,2,2
43004,0,0,1,15,16
43005,0,0,0,6,6
43006,0,0,8,17,25
43007,0,0,2,7,9
43008,0,0,0,6,6
43009,0,0,10,10,20
43010,0,1,17,19,37
43011,0,0,3,7,10
43012,0,0,5,13,18
43013,0,0,3,5,8
43014,0,0,3,12,15
43015,0,0,0,7,7
43016,1,0,2,3,6
43017,0,2,2,7,11
43018,0,0,3,16,19
43019,0,0,5,5,10
43020,0,1,2,3,6
43021,0,1,10,18,29
43022,0,3,2,8,13
43023,0,0,3,7,10
43024,0,0,4,10,14
43026,0,0,2,8,10
43027,1,0,3,11,15
43029,0,0,6,11,17
43030,0,0,7,11,18
43032,0,1,15,30,46
43033,0,0,6,11,17
43034,0,0,1,4,5
43035,0,0,7,20,27
43036,0,0,7,21,28
43037,0,0,0,12,12
43038,0,0,11,17,28
43042,0,1,5,21,27
43043,0,0,0,10,10
43044,1,0,5,13,19
43045,0,0,3,7,10
43046,0,0,0,5,5
43048,1,2,7,8,18
43049,0,2,13,28,43
43050,0,0,8,3,11
43051,0,0,4,9,13
43052,0,0,3,13,16
43053,1,0,0,8,9
43054,0,1,12,37,50
43055,0,4,0,10,14
43056,1,0,3,10,14
43057,0,0,9,18,27
43058,0,1,8,12,21
43059,0,3,7,27,37
43060,0,0,3,6,9
43061,1,0,8,25,34
43062,1,0,1,5,7
43063,0,0,0,13,13
43064,1,0,0,7,8
43065,0,0,0,17,17
43066,0,0,0,6,6
43067,0,0,3,6,9
43068,2,0,14,31,47
43069,0,0,20,30,50
43070,0,0,13,22,35
43071,0,0,11,39,50
43072,0,0,9,18,27
43073,0,2,13,28,43
43074,1,0,12,22,35
43075,0,0,4,12,16
43076,0,2,2,12,16
43077,0,0,6,11,17
43078,0,2,2,12,16
43079,0,0,12,23,35
43080,0,0,12,36,48
43081,0,1,8,11,20
43082,0,0,3,13,16
43083,0,1,10,39,50
43084,0,0,7,20,27
43085,0,2,7,11,20
43086,1,0,2,3,6
43087,2,0,5,23,30
43088,1,1,15,33,50
43089,0,0,0,10,10
43090,0,2,6,22,30
43091,0,2,6,21,29
43092,0,0,3,14,17
43093,1,1,6,23,31
43094,0,0,3,7,10
43095,0,1,14,24,39
43096,1,0,5,13,19
43097,1,0,4,3,8
43098,1,0,0,8,9
43099,1,0,0,7,8
43100,0,1,12,37,50
43101,0,0,9,18,27
43102,0,0,5,9,14
43103,0,3,7,27,37
43104,1,0,3,10,14
43105,0,1,17,19,37
43106,0,0,0,5,5
43107,1,0,2,2,5
43108,0,0,3,6,9
43109,0,0,0,17,17
43110,0,0,7,11,18
43111,0,0,9,23,32
43112,0,0,9,26,35
43113,0,1,14,24,39
43114,0,0,0,10,10
43115,0,0,14,21,35
43116,0,0,3,18,21
43118,2,1,3,16,22
43119,2,0,2,32,36
43120,0,0,3,14,17
43121,0,0,7,15,22
43122,0,12,1,11,24
43123,1,1,4,28,34
43124,0,0,9,18,27
43125,1,0,8,25,34
43126,0,0,3,14,17
43127,0,0,0,5,5
43128,0,0,1,4,5
43129,0,0,9,23,32
43130,0,0,7,20,27
43131,0,1,12,37,50
43132,0,2,1,11,14
43133,0,0,4,12,16
43134,0,0,5,9,14
43135,0,0,0,5,5
43136,0,0,1,4,5
43137,1,1,15,33,50
43138,0,0,4,3,7
43139,0,0,6,11,17
43140,0,0,8,3,11
43141,0,0,4,12,16
43142,0,0,11,39,50
43143,0,0,7,21,28
43144,0,0,5,8,13
43145,0,0,3,7,10
43146,1,1,6,23,31
43147,0,0,9,23,32
43148,0,0,3,6,9
43149,0,0,10,7,17
43150,0,0,8,17,25
43151,0,1,15,30,46
43152,1,0,5,13,19
43153,0,0,0,13,13
43154,0,0,7,11,18
43155,0,1,5,21,27
43156,1,1,2,8,12
43157,0,1,7,11,19
43158,1,0,2,3,6
43159,0,1,0,4,5
43160,0,4,2,30,36
43161,0,0,4,9,13
43162,0,0,5,3,8
43163,0,0,3,9,12
43164,0,0,7,8,15
43165,0,0,1,13,14
43166,0,0,10,5,15
43167,0,2,13,27,42
43168,0,0,10,18,28
43169,0,0,7,12,19
43170,0,0,3,4,7
43171,1,3,13,33,50
43172,0,1,4,17,22
43173,0,0,4,6,10
43174,0,0,2,11,13
43175,0,0,9,16,25
43176,0,0,6,13,19
43177,0,0,7,20,27
43178,0,0,5,18,23
43179,0,0,6,14,20
43180,0,0,7,26,33
43181,0,0,6,11,17
43182,0,0,4,2,6
43183,0,0,2,11,13
43184,0,1,1,9,11
43185,0,0,9,6,15
43186,0,2,10,18,30
43187,0,0,4,19,23
43188,0,0,0,8,8
43189,0,0,4,12,16
43190,0,1,8,11,20
43191,0,0,2,42,44
43192,1,2,15,30,48
43193,0,0,4,16,20
43194,1,0,4,19,24
43195,0,0,9,18,27
43196,0,2,10,36,48
43197,0,0,3,7,10
43198,0,0,8,18,26
43199,0,0,12,25,37
43200,0,1,9,40,50
43201,0,0,2,7,9
43202,0,0,10,16,26
43203,0,1,8,24,33
43204,0,1,12,15,28
43205,0,0,9,21,30
43206,0,0,3,10,13
43207,0,1,8,31,40
43208,0,0,10,19,29
43210,0,0,3,5,8
43211,0,0,17,28,45
43212,0,0,1,1,2
43213,0,0,3,7,10
43214,0,0,4,8,12
43215,1,1,2,8,12
43216,0,0,3,7,10
43217,0,0,4,20,24
43218,0,0,0,4,4
43219,0,0,5,4,9
43220,0,0,3,1,4
43221,0,4,5,12,21
43223,0,0,6,15,21
43224,0,0,8,8,16
43225,0,1,8,8,17
43226,1,0,0,31,32
43227,0,0,13,11,24
43228,0,0,4,12,16
43229,0,2,4,11,17
43230,1,0,5,13,19
43231,0,0,8,10,18
43232,0,1,6,8,15
43233,0,0,6,13,19
43234,0,0,4,10,14
43235,0,1,8,16,25
43236,0,0,6,26,32
43237,0,0,6,16,22
43238,0,0,4,8,12
43239,0,0,11,20,31
43240,0,3,1,5,9
43241,0,0,7,9,16
43242,0,0,4,10,14
43243,0,1,7,26,34
43244,0,0,2,11,13
43245,0,0,11,19,30
43246,0,1,10,20,31
43247,1,1,8,36,46
43248,0,0,10,23,33
43249,0,0,1,4,5
43250,0,2,13,14,29
43251,0,1,3,13,17
43252,0,0,3,3,6
43253,0,0,4,10,14
43254,0,0,13,23,36
43255,1,1,3,11,16
43256,0,1,8,10,19
43257,0,0,4,24,28
43258,1,0,15,32,48
43259,0,1,3,23,27
43260,0,0,9,23,32
43261,1,2,5,11,19
43262,0,0,8,21,29
43263,0,0,8,16,24
43264,0,0,5,0,5
43265,0,0,1,1,2
43266,0,0,4,4,8
43267,0,0,2,22,24
43268,0,1,7,38,46
43269,0,2,7,12,21
43270,0,0,4,9,13
43271,0,0,7,3,10
43272,0,0,4,4,8
43273,0,0,7,19,26
43274,0,1,14,28,43
43275,0,0,4,1,5
43276,0,1,5,4,10
43277,0,0,10,18,28
43278,0,0,1,5,6
43279,0,0,5,14,19
43280,0,0,0,6,6
43281,1,1,12,22,36
43282,0,0,4,14,18
43283,0,0,3,2,5
43284,0,0,8,10,18
43285,0,0,7,13,20
43286,1,0,10,32,43
43287,0,0,1,1,2
43288,0,0,4,8,12
43289,0,0,4,10,14
43290,0,1,3,12,16
43291,0,1,2,6,9
43292,0,0,8,14,22
43293,0,0,10,22,32
43294,0,0,0,11,11
43295,0,0,3,3,6
43296,0,0,10,9,19
43297,0,0,3,9,12
43298,0,1,13,23,37
43299,0,0,9,6,15
43300,0,1,5,24,30
43301,0,0,1,7,8
43303,0,1,6,14,21
43304,0,0,1,10,11
43305,0,0,3,4,7
43306,0,0,3,6,9
43307,0,0,1,6,7
43308,0,0,10,7,17
43309,0,1,3,3,7
43310,0,0,14,33,47
43311,0,0,10,16,26
43312,0,0,1,1,2
43313,0,0,4,8,12
43314,0,0,5,14,19
43315,0,0,3,3,6
43316,0,0,2,13,15
43317,0,0,7,15,22
43318,1,0,15,28,44
43319,0,0,8,31,39
43320,0,1,9,14,24
43321,0,0,3,3,6
43322,0,0,10,18,28
43323,0,0,5,3,8
43324,0,0,1,9,10
43325,0,1,1,11,13
43326,0,1,11,37,49
43327,0,1,2,15,18
43328,0,0,0,7,7
43329,0,0,7,13,20
43330,0,0,4,1,5
43331,0,0,4,5,9
43332,0,0,2,14,16
43333,0,0,6,5,11
43334,0,0,2,3,5
43335,0,0,8,12,20
43336,0,7,4,39,50
43337,0,0,9,33,42
43338,0,0,5,7,12
43339,0,0,17,22,39
43340,1,0,3,11,15
43341,0,0,9,21,30
43342,0,0,2,16,18
43343,1,1,3,36,41
43344,0,1,5,9,15
43345,2,0,11,36,49
43346,0,1,2,16,19
43347,0,1,16,33,50
43348,0,0,4,13,17
43349,0,0,5,8,13
43350,0,0,9,28,37
43351,0,0,3,5,8
43352,0,0,2,11,13
43353,0,0,8,13,21
43354,0,3,9,9,21
43355,0,0,2,2,4
43356,0,1,7,13,21
43358,0,1,5,3,9
43359,0,0,2,4,6
43360,0,0,2,6,8
43361,0,0,7,7,14
43362,0,1,3,10,14
43363,0,0,7,11,18
43364,0,0,0,5,5
43365,0,0,13,12,25
43366,0,0,10,14,24
43368,0,0,2,6,8
43369,0,0,11,14,25
43370,1,2,5,7,15
43371,0,0,1,10,11
43372,0,1,7,8,16
43373,0,0,3,9,12
43374,0,0,10,13,23
43375,4,0,8,36,48
43376,0,0,5,8,13
43378,0,0,3,6,9
43379,0,1,8,12,21
43380,1,1,2,15,19
43381,0,0,1,4,5
43382,0,0,2,8,10
43383,0,0,0,3,3
43385,0,1,1,9,11
43387,0,0,4,2,6
43388,0,0,4,6,10
43389,0,1,6,8,15
43390,0,0,4,10,14
43391,0,1,7,21,29
43392,0,2,6,8,16
43395,0,0,0,6,6
43396,0,0,11,18,29
43397,0,0,4,7,11
43398,0,1,8,11,20
43399,0,0,1,1,2
43400,0,0,3,10,13
43402,0,0,0,7,7
43403,0,1,10,19,30
43404,0,1,7,10,18
43405,0,0,12,27,39
43406,0,2,1,11,14
43407,0,4,0,10,14
43408,0,2,0,11,13
43409,0,0,3,6,9
43410,2,5,6,37,50
43411,1,0,6,12,19
43412,0,0,0,10,10
43413,0,0,11,18,29
43414,0,1,5,10,16
43415,0,1,12,37,50
43416,1,0,2,3,6
43417,0,0,5,9,14
43418,0,0,5,3,8
43419,0,0,3,6,9
43420,0,1,2,16,19
43421,0,1,7,11,19
43422,0,3,7,27,37
43423,2,0,0,24,26
43424,1,1,12,35,49
43425,0,0,8,8,16
43426,0,0,14,28,42
43427,1,1,10,25,37
43428,0,2,11,30,43
43429,0,0,12,37,49
43430,0,1,8,4,13
43431,0,0,7,28,35
43432,0,0,18,32,50
43433,0,0,11,18,29
43434,0,0,23,27,50
43435,0,0,3,10,13
43436,0,0,3,21,24
43437,0,0,12,27,39
43438,0,0,4,10,14
43439,2,1,11,29,43
43440,0,1,10,23,34
43441,1,0,9,20,30
43442,0,0,15,26,41
43443,0,0,7,20,27
43444,0,0,15,35,50
43445,0,0,10,14,24
43446,0,0,13,33,46
43447,0,0,5,12,17
43448,0,1,7,26,34
43449,1,1,6,23,31
43450,0,1,13,36,50
43451,0,0,3,7,10
43452,0,0,5,5,10
43453,0,0,10,16,26
43454,0,1,13,36,50
43455,0,1,9,13,23
43456,0,0,9,22,31
43457,1,0,14,22,37
43458,0,0,18,24,42
43459,0,0,15,32,47
43460,0,0,6,16,22
43461,0,0,4,15,19
43462,0,1,8,22,31
43463,0,0,9,8,17
43464,0,0,10,17,27
43465,0,0,15,29,44
43466,0,0,17,33,50
43467,0,2,3,15,20
43468,0,0,9,10,19
43469,0,1,6,12,19
43470,1,0,12,27,40
43471,0,0,4,9,13
43472,0,0,5,20,25
43473,0,0,9,16,25
43474,0,0,3,8,11
43475,0,0,14,33,47
43476,1,0,12,14,27
43477,0,1,3,23,27
43478,0,0,2,11,13
43479,0,0,13,21,34
43480,1,0,2,11,14
43481,0,0,5,14,19
43482,0,0,8,9,17
43483,0,0,11,15,26
43484,0,0,7,11,18
43485,0,0,5,18,23
43486,0,0,8,10,18
43487,0,0,4,5,9
43488,0,0,5,9,14
43489,1,0,10,39,50
43490,0,0,11,21,32
43491,0,0,7,18,25
43492,0,1,2,15,18
43493,0,0,8,16,24
43494,0,1,5,16,22
43495,0,0,5,21,26
43496,0,1,2,16,19
43497,0,0,9,9,18
43498,0,0,6,13,19
43499,0,0,9,32,41
43500,0,1,13,34,48
43501,0,1,1,28,30
43502,0,0,6,6,12
43503,0,0,4,24,28
43505,0,0,2,3,5
43506,0,0,5,3,8
43507,0,0,9,24,33
43508,1,1,9,30,41
43509,0,0,3,6,9
43510,0,1,15,16,32
43511,0,0,11,18,29
43512,0,0,2,6,8
43514,0,0,9,19,28
43515,1,0,6,12,19
43516,0,0,10,18,28
43517,0,0,6,11,17
43518,0,0,12,26,38
43519,0,0,9,23,32
43520,2,0,12,35,49
43521,0,1,8,31,40
43522,0,0,4,12,16
43523,0,0,3,6,9
43524,0,0,6,16,22
43525,0,0,4,4,8
43526,0,1,7,38,46
43527,0,0,14,33,47
43528,0,0,8,8,16
43529,0,7,4,39,50
43530,1,0,5,13,19
43531,0,1,12,37,50
43532,0,0,0,10,10
43533,1,0,4,3,8
43534,0,1,5,10,16
43535,0,0,1,0,1
43536,0,1,0,4,5
43537,0,0,5,9,14
43538,0,3,7,27,37
43539,0,1,2,16,19
43540,1,0,2,3,6
43541,0,0,3,9,12
43543,0,0,2,17,19
43544,0,0,9,16,25
43545,0,0,0,10,10
43546,0,0,13,33,46
43547,0,0,0,6,6
43548,0,0,0,6,6
43549,1,0,3,13,17
43550,0,0,0,19,19
43551,0,0,7,11,18
43552,0,1,0,4,5
43553,0,0,12,28,40
43554,0,0,10,21,31
43555,0,3,6,12,21
43556,0,2,6,8,16
43558,2,0,5,20,27
43559,0,0,9,19,28
43560,0,0,8,14,22
43561,0,0,3,9,12
43562,0,7,4,39,50
43563,0,1,10,19,30
43564,0,0,4,5,9
43565,0,0,7,20,27
43566,0,1,12,37,50
43567,0,0,9,23,32
43568,0,0,13,33,46
43569,0,1,10,19,30
43570,0,4,2,30,36
43571,0,2,1,11,14
43572,0,0,4,12,16
43573,0,0,9,6,15
43574,0,0,5,9,14
43575,0,1,7,10,18
43576,0,1,10,19,30
43577,0,0,4,12,16
43578,1,0,5,13,19
43579,2,0,12,35,49
43580,0,0,6,11,17
43581,1,1,6,23,31
43582,0,0,3,10,13
43583,1,1,2,8,12
43584,0,0,3,3,6
43585,0,0,1,9,10
43586,2,0,0,24,26
43587,0,4,2,30,36
43588,0,1,2,16,19
43589,0,0,1,11,12
43590,0,0,5,3,8
43591,0,0,8,5,13
43592,1,0,0,5,6
43593,0,0,12,5,17
43594,0,0,0,13,13
43595,0,4,2,30,36
43596,1,0,2,2,5
43597,0,0,4,9,13
43598,0,0,1,16,17
43599,0,0,9,23,32
43600,0,0,15,17,32
43601,0,0,13,29,42
43602,0,0,10,32,42
43603,0,1,10,27,38
43604,0,0,2,3,5
43605,0,0,1,7,8
43606,0,0,9,26,35
43607,0,3,8,28,39
43608,0,0,0,11,11
43609,0,0,2,5,7
43610,0,0,9,19,28
43611,0,0,11,21,32
43612,0,3,21,23,47
43613,0,0,7,17,24
43614,2,1,14,29,46
43615,3,0,1,15,19
43616,0,0,11,20,31
43617,0,0,9,9,18
43618,0,0,4,8,12
43620,0,0,13,25,38
43621,0,1,13,36,50
43622,0,0,3,10,13
43623,0,0,9,30,39
43624,0,0,7,10,17
43625,0,1,2,26,29
43626,0,0,14,13,27
43627,0,2,1,11,14
43628,0,0,5,5,10
43629,0,0,9,12,21
43630,0,0,5,10,15
43631,0,1,15,30,46
43632,0,1,12,15,28
43633,0,0,5,11,16
43634,0,1,10,16,27
43635,0,1,8,17,26
43637,0,0,1,1,2
43638,0,0,10,4,14
43639,0,1,0,7,8
43640,0,0,2,4,6
43641,0,0,5,4,9
43642,0,0,2,6,8
43643,1,0,10,17,28
43644,0,0,0,4,4
43645,0,0,10,18,28
43646,0,2,4,16,22
43647,0,0,10,33,43
43648,0,0,6,19,25
43649,0,0,4,14,18
43650,0,0,0,6,6
43651,0,0,8,6,14
43652,0,0,0,18,18
43653,0,0,7,15,22
43654,0,0,5,17,22
43655,0,0,6,9,15
43656,0,0,18,29,47
43657,0,0,3,6,9
43658,0,0,8,6,14
43659,0,0,9,13,22
43660,1,1,6,42,50
43661,0,0,15,33,48
43664,1,0,10,13,24
43665,0,0,11,8,19
43666,0,2,3,7,12
43667,0,0,0,5,5
43669,0,0,2,6,8
43670,0,0,7,16,23
43671,0,0,3,6,9
43672,0,0,16,34,50
43673,0,0,17,23,40
43674,0,0,3,20,23
43675,1,0,10,25,36
43676,0,0,8,3,11
43677,0,0,4,12,16
43678,0,1,10,19,30
43679,0,0,1,8,9
43680,1,0,10,30,41
43681,1,0,7,42,50
43682,0,0,7,12,19
43683,0,0,8,9,17
43684,0,1,0,9,10
43685,0,0,7,34,41
43686,0,0,9,23,32
43687,0,0,1,4,5
43688,0,0,2,15,17
43690,0,0,5,12,17
43691,0,0,8,15,23
43692,0,0,0,7,7
43693,0,0,10,24,34
43694,0,1,3,18,22
43696,0,0,6,17,23
43697,1,1,0,20,22
43698,0,1,5,12,18
43699,0,0,8,13,21
43700,0,0,2,24,26
43701,0,0,5,15,20
43702,0,1,6,7,14
43703,0,0,7,23,30
43704,0,1,3,9,13
43705,2,5,6,37,50
43706,0,0,6,9,15
43707,0,0,8,9,17
43708,0,0,9,8,17
43709,0,0,1,2,3
43710,2,1,3,36,42
43711,0,0,11,18,29
43712,1,0,11,28,40
43713,0,0,6,14,20
43714,0,0,6,17,23
43715,0,0,16,34,50
43716,0,0,6,14,20
43717,0,0,5,2,7
43718,0,0,1,7,8
43719,0,0,0,18,18
43720,0,0,4,4,8
43721,0,1,5,1,7
43722,0,1,8,19,28
43723,0,0,2,18,20
43724,0,0,1,4,5
43725,1,0,3,10,14
43726,0,0,8,12,20
43727,0,0,7,15,22
43728,4,0,4,5,13
43729,0,0,2,7,9
43730,0,0,2,3,5
43731,5,0,3,22,30
43732,0,1,3,8,12
43733,0,0,8,10,18
43734,0,1,4,15,20
43735,0,0,18,32,50
43736,0,0,3,6,9
43738,0,0,7,14,21
43739,0,0,9,12,21
43740,1,0,8,28,37
43741,0,0,7,12,19
43742,0,0,6,3,9
43743,1,0,0,5,6
43744,1,0,2,6,9
43745,0,0,0,9,9
43746,1,1,1,16,19
43747,0,0,5,3,8
43748,0,1,11,27,39
43749,0,0,2,11,13
43750,0,0,3,14,17
43751,0,0,4,13,17
43752,0,0,2,8,10
43753,0,1,18,30,49
43754,0,0,8,14,22
43755,0,0,4,7,11
43756,0,0,5,6,11
43757,0,0,0,5,5
43758,0,0,6,22,28
43759,0,1,3,12,16
43760,1,0,4,10,15
43761,0,0,4,46,50
43762,0,0,13,22,35
43763,0,0,4,8,12
43764,1,1,7,29,38
43765,0,0,4,7,11
43766,0,0,7,17,24
43767,0,0,10,13,23
43768,0,0,8,14,22
43769,0,1,5,12,18
43770,1,1,4,10,16
43771,4,0,8,36,48
43772,0,1,8,21,30
43773,0,0,2,15,17
43774,0,0,14,31,45
43776,0,0,2,4,6
43777,0,0,9,13,22
43778,0,0,6,11,17
43780,2,0,7,29,38
43781,0,0,4,9,13
43782,1,0,2,2,5
43783,0,2,9,39,50
43784,0,0,10,33,43
43785,0,0,3,14,17
43786,1,0,8,6,15
43787,0,1,10,19,30
43788,2,0,2,12,16
43789,0,0,7,14,21
43790,1,0,18,31,50
43791,0,0,14,12,26
43792,0,0,1,11,12
43793,0,0,5,3,8
43794,0,0,5,9,14
43795,0,0,8,5,13
43796,0,0,0,5,5
43797,0,1,2,16,19
43798,0,0,0,17,17
43799,0,0,0,13,13
43800,0,1,16,32,49
43801,0,0,8,17,25
43802,0,0,13,37,50
43803,0,1,10,24,35
43804,0,0,7,3,10
43805,1,1,9,30,41
43806,0,0,9,23,32
43807,0,0,2,6,8
43808,0,1,16,33,50
43809,2,0,8,26,36
43810,0,1,19,30,50
43811,0,0,3,11,14
43812,0,0,5,16,21
43813,1,0,6,26,33
43814,0,0,7,28,35
43815,1,0,3,9,13
43816,0,0,14,22,36
43817,0,0,10,26,36
43818,0,0,6,22,28
43819,0,0,3,17,20
43820,0,0,7,10,17
43821,0,1,4,24,29
43822,0,0,4,15,19
43823,0,0,14,25,39
43824,0,2,2,12,16
43825,0,0,7,9,16
43826,0,0,2,19,21
43827,1,0,14,31,46
43828,0,0,9,22,31
43829,0,0,15,27,42
43830,0,1,4,19,24
43831,0,0,6,4,10
43832,0,0,7,10,17
43833,0,0,7,24,31
43834,0,0,9,23,32
43835,0,0,11,18,29
43836,3,1,4,36,44
43837,0,1,0,14,15
43838,0,0,10,33,43
43839,0,0,8,34,42
43840,0,1,6,30,37
43841,0,0,9,25,34
43842,0,0,14,18,32
43843,0,1,2,14,17
43844,0,2,6,22,30
43845,0,0,2,5,7
43846,0,0,7,20,27
43847,0,0,6,19,25
43848,0,0,4,14,18
43849,0,0,6,18,24
43850,0,0,6,16,22
43851,2,0,13,34,49
43852,0,0,1,6,7
43853,0,0,3,5,8
43854,2,0,7,29,38
43855,0,0,19,26,45
43856,0,0,15,32,47
43857,0,0,17,33,50
43858,0,0,11,22,33
43859,0,0,3,9,12
43860,0,1,2,7,10
43862,0,0,14,12,26
43863,0,0,8,17,25
43864,0,0,5,5,10
43865,0,0,3,3,6
43866,1,0,18,31,50
43867,0,0,8,5,13
43868,0,0,5,25,30
43870,0,0,4,17,21
43871,2,0,13,32,47
43872,0,1,10,38,49
43873,0,0,3,47,50
43874,0,1,7,21,29
43875,0,1,15,31,47
43876,0,0,13,29,42
43877,0,1,4,3,8
43878,0,0,12,12,24
43879,0,0,6,20,26
43880,0,0,5,13,18
43881,0,0,0,3,3
43882,1,0,4,3,8
43883,0,2,9,39,50
43884,0,0,8,22,30
43885,0,0,9,14,23
43886,1,0,3,10,14
43887,0,0,1,6,7
43888,1,0,2,2,5
43889,0,0,3,14,17
43890,0,0,7,13,20
43891,1,0,0,5,6
43892,0,0,0,17,17
43893,0,0,5,3,8
43894,1,1,1,16,19
43895,0,1,2,16,19
43896,0,0,0,5,5
43897,0,0,5,9,14
43898,0,0,2,5,7
43901,1,2,5,39,47
43902,0,1,0,9,10
43903,0,0,1,8,9
43904,0,0,13,18,31
43905,0,0,3,13,16
43906,1,0,11,38,50
43907,0,1,0,14,15
43908,0,0,1,13,14
43909,0,1,1,9,11
43910,2,0,8,28,38
43911,1,1,7,28,37
43912,3,0,9,21,33
43913,0,0,1,17,18
43914,1,0,16,33,50
43915,0,0,2,4,6
43916,0,0,0,1,1
43917,0,0,7,13,20
43918,0,1,2,7,10
43919,5,0,3,22,30
43920,2,0,2,12,16
43921,0,0,9,14,23
43922,0,0,1,11,12
43923,0,0,3,47,50
43924,0,0,3,14,17
43925,0,0,3,10,13
43926,1,0,4,8,13
43927,0,0,4,2,6
43928,0,1,10,19,30
43929,0,0,3,14,17
43930,0,0,0,5,5
43931,0,1,10,19,30
43932,0,4,2,30,36
43933,0,0,9,23,32
43934,0,2,1,11,14
43935,1,0,0,5,6
43936,0,0,5,9,14
43937,0,0,0,5,5
43938,0,0,14,12,26
43939,0,0,0,13,13
43940,0,0,2,24,26
43941,0,1,3,18,22
43942,0,4,2,30,36
43943,0,1,2,16,19
43944,0,1,10,19,30
43945,0,1,15,30,46
43946,0,0,8,3,11
43947,0,4,2,30,36
43948,0,0,8,5,13
43949,1,0,5,11,17
43950,1,1,4,14,20
43951,0,2,6,34,42
43952,0,2,1,11,14
43953,0,1,13,36,50
43954,0,0,9,26,35
43955,0,0,5,15,20
43956,0,1,8,2,11
43957,0,0,9,24,33
43958,0,0,15,29,44
43960,0,0,9,35,44
43961,0,0,6,14,20
43962,0,0,3,6,9
43963,0,0,3,10,13
43965,0,0,13,34,47
43967,0,0,4,11,15
43968,0,0,5,16,21
43969,0,0,14,36,50
43970,0,0,3,10,13
43971,0,0,2,8,10
43972,0,0,9,12,21
43973,0,0,1,5,6
43974,0,0,18,32,50
43975,0,0,14,29,43
43977,0,0,1,3,4
43978,0,1,5,38,44
43979,0,0,5,4,9
43980,0,0,6,16,22
43981,0,1,8,14,23
43982,0,0,5,8,13
43983,0,0,2,5,7
43984,0,0,2,5,7
43986,0,1,17,32,50
43987,0,0,1,34,35
43988,1,0,1,7,9
43989,0,0,10,17,27
43990,0,0,6,16,22
43991,0,0,0,5,5
43992,0,0,2,10,12
43993,0,1,7,42,50
43995,0,0,8,24,32
43996,0,0,13,21,34
43997,0,0,3,3,6
43998,0,0,3,2,5
43999,0,0,8,3,11
44000,0,0,1,6,7
44002,0,1,2,11,14
44003,0,0,5,11,16
44004,0,1,8,10,19
44005,0,0,8,18,26
44006,0,1,1,10,12
44007,0,0,6,8,14
44008,0,0,1,5,6
44009,0,0,19,31,50
44010,0,1,3,17,21
44011,5,1,1,29,36
44012,0,4,0,10,14
44013,0,0,9,25,34
44014,0,1,5,14,20
44015,0,1,5,21,27
44016,0,0,5,19,24
44017,0,2,4,32,38
44018,0,0,7,7,14
44019,1,0,5,16,22
44020,1,1,8,18,28
44021,0,0,2,8,10
44022,0,1,11,29,41
44023,0,0,8,9,17
44024,0,1,2,4,7
44025,0,2,2,9,13
44026,0,1,12,18,31
44027,0,0,7,11,18
44028,2,0,0,31,33
44029,0,0,4,4,8
44030,0,0,1,0,1
44031,0,0,4,11,15
44032,0,0,12,16,28
44033,0,0,9,16,25
44034,0,0,12,29,41
44035,0,3,0,12,15
44036,0,0,2,1,3
44037,0,0,5,18,23
44038,0,0,2,11,13
44039,0,1,2,10,13
44040,1,0,5,8,14
44041,0,0,8,7,15
44042,0,0,0,13,13
44043,0,0,4,4,8
44044,0,0,0,3,3
44045,0,0,6,9,15
44046,0,0,5,2,7
44047,0,0,3,7,10
44048,0,0,4,9,13
44049,0,0,4,10,14
44050,0,0,0,5,5
44051,0,0,0,2,2
44052,0,1,3,23,27
44053,0,0,3,8,11
44054,0,0,1,6,7
44055,0,0,0,6,6
44056,0,0,2,3,5
44057,0,0,1,4,5
44058,0,0,4,13,17
44059,0,1,0,13,14
44060,0,0,0,5,5
44061,0,0,5,21,26
44062,0,0,3,13,16
44063,0,1,4,9,14
44064,0,0,1,5,6
44065,0,0,5,5,10
44066,0,1,1,3,5
44068,0,0,7,13,20
44069,0,0,4,9,13
44072,0,0,0,17,17
44075,0,0,0,4,4
44076,1,0,2,47,50
44077,0,0,6,17,23
44079,0,12,3,10,25
44080,0,0,3,2,5
44081,0,0,5,6,11
44082,1,0,0,8,9
44083,0,0,3,6,9
44084,0,1,2,16,19
44085,0,0,10,40,50
44086,2,5,6,37,50
44087,0,0,3,14,17
44088,0,0,8,5,13
44089,0,1,5,24,30
44090,0,1,13,32,46
44091,0,0,10,8,18
44092,0,2,6,23,31
44093,0,0,15,29,44
44094,0,0,5,14,19
44095,2,0,5,22,29
44096,0,0,9,19,28
44097,1,1,7,31,40
44098,0,0,7,18,25
44099,0,2,0,12,14
44100,0,0,1,4,5
44101,1,0,12,26,39
44102,1,0,0,5,6
44103,0,0,6,8,14
44104,0,0,3,15,18
44105,0,0,7,10,17
44106,0,0,9,5,14
44107,0,0,1,8,9
44108,0,0,12,28,40
44109,1,0,6,8,15
44110,0,0,5,16,21
44111,0,0,9,16,25
44112,0,0,5,20,25
44113,0,0,7,7,14
44114,0,0,6,14,20
44115,0,1,15,34,50
44116,0,1,9,20,30
44117,0,1,14,17,32
44118,0,1,10,33,44
44119,0,0,9,12,21
44120,0,0,8,8,16
44121,0,0,7,13,20
44122,0,4,1,38,43
44123,0,0,6,15,21
44124,0,0,12,13,25
44125,0,0,23,22,45
44126,0,0,6,24,30
44127,0,2,6,22,30
44128,1,1,15,33,50
44129,0,0,7,10,17
44130,0,1,16,33,50
44131,0,0,1,11,12
44132,0,0,2,14,16
44133,0,0,10,20,30
44134,0,1,9,27,37
44135,0,1,6,33,40
44136,0,0,20,30,50
44137,0,0,7,7,14
44138,1,2,9,20,32
44139,2,0,11,33,46
44140,0,0,8,20,28
44141,0,0,7,19,26
44142,0,0,7,32,39
44143,0,0,3,9,12
44144,0,1,16,18,35
44145,0,0,10,13,23
44146,0,0,7,8,15
44147,0,0,8,16,24
44148,0,1,7,42,50
44149,0,0,4,6,10
44150,0,0,5,22,27
44151,0,0,8,25,33
44152,0,0,2,3,5
44153,0,1,9,25,35
44154,0,0,10,40,50
44155,0,0,3,6,9
44156,0,0,15,34,49
44157,0,0,12,23,35
44159,1,0,0,8,9
44160,0,0,3,6,9
44161,1,0,10,21,32
44162,0,0,9,10,19
44163,0,0,13,20,33
44164,0,0,5,8,13
44165,0,0,8,8,16
44166,0,0,2,4,6
44167,0,0,4,5,9
44168,0,0,12,23,35
44169,0,0,6,4,10
44170,0,0,6,10,16
44171,0,0,1,10,11
44172,0,2,1,15,18
44173,0,0,8,5,13
44174,0,0,8,16,24
44176,0,0,3,6,9
44177,1,0,17,32,50
44178,0,0,3,14,17
44179,0,1,2,16,19
44180,0,0,3,6,9
44181,0,0,5,6,11
44182,0,1,0,13,14
44183,0,0,12,32,44
44184,0,1,0,7,8
44185,0,0,0,12,12
44186,0,0,12,38,50
44187,1,0,0,20,21
44188,0,1,3,22,26
44189,0,0,4,45,49
44190,0,2,0,12,14
44191,0,0,1,10,11
44192,0,0,2,29,31
44194,0,0,12,13,25
44195,0,0,3,2,5
44197,0,0,0,4,4
44198,0,0,1,11,12
44199,1,0,0,5,6
44200,0,0,7,13,20
44201,0,0,9,17,26
44202,0,0,4,5,9
44203,0,0,3,14,17
44204,0,1,9,29,39
44205,0,0,7,32,39
44206,0,2,6,23,31
44207,1,1,0,6,8
44208,0,0,9,19,28
44209,0,0,2,6,8
44210,0,1,0,9,10
44211,0,0,1,21,22
44212,0,0,12,32,44
44213,0,0,3,14,17
44214,0,2,1,11,14
44215,0,4,2,30,36
44216,0,4,2,30,36
44217,1,1,15,33,50
44218,0,1,5,21,27
44219,0,0,0,17,17
44220,0,0,1,11,12
44222,0,0,11,18,29
44223,0,0,0,1,1
44224,0,0,8,3,11
44225,1,0,6,18,25
44226,0,2,9,39,50
44227,0,0,7,3,10
44228,0,0,11,18,29
44229,0,0,1,24,25
44230,0,0,0,8,8
44231,0,0,5,8,13
44232,0,0,3,10,13
44233,0,0,0,3,3
44234,0,0,10,15,25
44235,0,0,3,19,22
44236,0,0,5,10,15
44237,0,0,1,14,15
44238,0,0,5,13,18
44239,0,0,1,23,24
44240,0,0,5,6,11
44241,0,0,4,19,23
44242,0,0,11,30,41
44243,0,0,0,5,5
44244,0,0,0,5,5
44245,0,0,1,10,11
44246,0,0,7,16,23
44247,0,0,4,24,28
44248,0,0,6,7,13
44249,0,0,3,5,8
44250,0,0,2,16,18
44251,0,0,5,4,9
44252,0,10,9,17,36
44253,0,0,7,3,10
44254,0,0,4,6,10
44255,0,0,3,12,15
44256,0,0,8,37,45
44257,1,0,5,44,50
44258,0,0,9,14,23
44259,2,0,5,16,23
44260,0,1,7,9,17
44261,2,0,0,6,8
44262,0,0,3,9,12
44263,0,0,4,10,14
44264,0,0,9,19,28
44265,0,0,4,1,5
44266,0,0,4,19,23
44267,0,0,10,27,37
44268,0,0,7,4,11
44269,0,0,4,21,25
44270,0,0,9,4,13
44271,0,0,1,4,5
44272,0,1,5,22,28
44273,0,0,6,11,17
44274,0,0,11,23,34
44275,0,0,8,18,26
44276,0,0,1,26,27
44277,0,0,3,9,12
44278,0,0,6,4,10
44279,0,0,9,9,18
44281,0,0,1,14,15
44282,0,0,4,7,11
44283,0,1,7,26,34
44284,2,5,6,37,50
44285,0,0,4,13,17
44286,0,0,3,7,10
44287,0,0,9,20,29
44288,0,0,4,7,11
44290,0,0,7,11,18
44291,0,0,3,7,10
44292,0,0,9,16,25
44293,0,0,4,9,13
44294,0,0,15,34,49
44295,0,1,7,3,11
44296,0,0,6,7,13
44297,0,0,5,13,18
44298,0,0,3,8,11
44299,1,0,11,22,34
44300,0,0,10,17,27
44301,0,0,2,6,8
44302,0,0,13,35,48
44303,0,0,10,10,20
44304,0,0,7,8,15
44306,0,0,9,7,16
44307,0,0,2,8,10
44308,0,1,11,35,47
44309,0,1,7,13,21
44310,0,0,0,2,2
44311,0,0,10,5,15
44312,0,0,2,3,5
44313,0,0,1,4,5
44314,1,0,6,12,19
44315,0,1,9,18,28
44317,0,0,5,8,13
44320,0,0,2,14,16
44321,0,0,0,2,2
44322,0,0,5,10,15
44323,0,0,10,19,29
44324,0,0,3,2,5
44325,0,0,1,11,12
44326,0,0,1,4,5
44327,0,0,0,15,15
44328,0,1,17,19,37
44330,1,0,4,3,8
44331,0,0,6,16,22
44333,0,0,8,9,17
44334,0,1,8,41,50
44335,0,0,2,18,20
44336,1,4,7,19,31
44337,1,0,8,30,39
44338,1,2,7,13,23
44339,0,1,9,25,35
44340,2,1,0,20,23
44341,0,0,11,28,39
44342,0,0,13,34,47
44343,0,0,9,24,33
44344,0,0,7,6,13
44345,0,0,8,34,42
44346,0,0,8,17,25
44347,0,1,4,5,10
44348,0,1,12,13,26
44349,0,0,12,37,49
44350,0,1,1,7,9
44351,0,1,18,31,50
44352,0,0,0,9,9
44353,0,0,7,18,25
44354,0,0,10,17,27
44355,0,0,8,16,24
44356,0,1,14,35,50
44357,0,2,8,20,30
44358,1,0,11,35,47
44359,0,0,18,25,43
44360,0,0,16,31,47
44361,0,0,1,4,5
44362,1,0,11,22,34
44363,0,0,12,24,36
44364,0,0,3,5,8
44365,0,1,10,21,32
44366,0,1,6,16,23
44367,1,0,5,32,38
44368,0,3,1,18,22
44369,0,2,10,34,46
44370,2,0,13,29,44
44372,0,0,13,34,47
44373,0,0,7,29,36
44374,0,0,9,25,34
44375,1,0,0,9,10
44376,0,0,10,24,34
44377,0,0,9,13,22
44378,1,0,4,3,8
44379,0,0,12,38,50
44380,0,0,2,5,7
44381,1,0,19,23,43
44382,0,1,6,3,10
44383,0,0,5,14,19
44384,0,0,2,4,6
44385,0,0,3,12,15
44386,1,0,9,12,22
44387,0,0,17,26,43
44388,0,0,6,12,18
44389,0,0,6,8,14
44390,0,0,1,4,5
44391,0,1,6,32,39
44392,0,0,5,9,14
44393,0,0,10,19,29
44394,0,0,9,41,50
44395,0,0,11,18,29
44396,0,0,14,36,50
44397,0,0,5,33,38
44398,0,2,9,39,50
44399,0,0,8,3,11
44400,1,0,6,12,19
44401,0,0,2,14,16
44402,0,0,6,16,22
44403,0,1,17,19,37
44404,1,0,11,22,34
44405,0,0,3,15,18
44406,0,0,2,31,33
44407,0,0,11,18,29
44408,0,0,11,23,34
44409,0,0,13,36,49
44410,0,0,3,2,5
44411,0,0,0,7,7
44412,0,1,0,16,17
44413,0,0,2,13,15
44415,0,0,4,13,17
44416,1,0,9,33,43
44418,1,0,0,9,10
44419,0,0,14,19,33
44420,0,0,0,15,15
44421,1,0,3,43,47
44422,0,0,3,16,19
44423,0,0,3,17,20
44424,0,0,9,41,50
44426,0,0,14,36,50
44427,0,0,1,11,12
44428,0,0,0,1,1
44429,0,1,1,7,9
44430,1,0,3,22,26
44431,0,0,4,24,28
44432,0,0,5,8,13
44433,1,0,2,10,13
44435,0,0,0,1,1
44436,1,0,12,26,39
44437,1,0,11,22,34
44438,1,0,2,2,5
44440,0,0,9,11,20
44441,0,0,6,9,15
44443,0,0,12,31,43
44444,0,0,10,37,47
44445,0,0,18,30,48
44446,0,0,2,5,7
44447,0,0,13,10,23
44448,0,0,2,10,12
44449,0,0,13,33,46
44450,0,0,14,29,43
44452,0,1,4,18,23
44453,0,0,0,3,3
44454,0,0,1,4,5
44455,0,0,6,12,18
44456,0,1,6,8,15
44457,0,1,2,19,22
44458,0,0,7,11,18
44459,0,0,5,18,23
44460,0,0,15,17,32
44461,0,0,6,6,12
44462,0,0,4,9,13
44464,0,0,1,12,13
44465,0,1,13,15,29
44466,0,1,13,36,50
44467,0,1,2,14,17
44468,0,0,2,14,16
44469,0,0,0,5,5
44472,0,0,3,8,11
44473,0,1,3,12,16
44474,0,1,8,34,43
44475,0,0,7,21,28
44476,0,0,3,12,15
44477,0,0,6,6,12
44478,0,0,2,10,12
44479,0,0,10,14,24
44480,0,0,4,16,20
44481,0,0,0,4,4
44482,0,0,2,3,5
44483,0,1,0,32,33
44484,1,0,1,7,9
44485,0,1,15,30,46
44486,0,0,7,11,18
44487,0,0,4,16,20
44488,0,0,7,14,21
44489,0,0,15,35,50
44490,0,0,11,13,24
44491,0,0,4,12,16
44492,0,0,10,37,47
44493,0,0,1,6,7
44494,0,0,8,11,19
44495,0,1,13,35,49
44496,0,0,1,7,8
44498,0,0,10,19,29
44499,0,0,11,16,27
44500,0,0,10,15,25
44501,0,0,9,11,20
44502,0,0,6,2,8
44503,0,0,7,12,19
44504,0,0,11,22,33
44505,0,0,13,31,44
44506,0,1,6,8,15
44507,0,0,2,7,9
44508,0,0,6,21,27
44509,0,1,4,17,22
44510,0,0,4,8,12
44511,0,0,2,6,8
44512,0,0,4,4,8
44513,0,0,11,22,33
44514,0,0,4,11,15
44515,0,0,9,10,19
44516,0,0,4,8,12
44517,0,1,5,4,10
44518,0,0,11,15,26
44519,0,0,5,0,5
44520,0,0,7,16,23
44521,0,0,0,3,3
44522,0,0,6,6,12
44523,0,0,1,2,3
44524,0,0,6,17,23
44525,0,0,2,10,12
44526,0,1,10,19,30
44527,0,1,16,26,43
44528,0,0,3,5,8
44529,0,0,8,6,14
44530,0,0,5,11,16
44531,0,0,6,10,16
44532,0,0,5,5,10
44533,2,1,5,24,32
44534,0,0,0,5,5
44535,0,2,8,26,36
44536,1,0,2,9,12
44537,0,0,0,16,16
44538,0,1,9,12,22
44539,0,0,6,26,32
44540,0,0,0,16,16
44541,0,0,4,2,6
44542,0,0,3,6,9
44543,0,0,3,0,3
44544,0,2,10,24,36
44545,0,0,8,11,19
44546,0,0,7,5,12
44547,0,0,5,12,17
44548,0,0,3,12,15
44549,0,0,6,10,16
44550,0,0,1,10,11
44551,0,0,10,28,38
44552,0,0,9,22,31
44553,0,2,3,6,11
44554,0,0,8,9,17
44555,0,0,12,20,32
44556,0,0,7,14,21
44557,0,0,8,16,24
44558,0,0,7,12,19
44559,0,0,0,6,6
44560,0,0,4,3,7
44561,0,0,3,15,18
44562,0,1,7,15,23
44563,0,0,5,13,18
44564,0,0,4,9,13
44565,0,0,3,5,8
44566,0,0,5,6,11
44567,0,0,8,14,22
44568,0,0,6,3,9
44569,0,0,5,16,21
44570,1,0,8,9,18
44571,0,0,9,11,20
44572,0,1,1,1,3
44573,0,0,7,9,16
44574,0,0,1,4,5
44575,0,0,5,18,23
44576,0,0,8,13,21
44577,0,0,14,36,50
44578,0,0,1,7,8
44579,0,1,3,15,19
44580,0,0,4,10,14
44581,0,0,8,7,15
44582,0,1,7,13,21
44583,0,0,7,11,18
44584,0,0,7,16,23
44586,0,0,12,8,20
44587,0,0,8,15,23
44588,0,0,8,8,16
44589,0,3,10,28,41
44590,0,0,3,22,25
44591,0,0,5,4,9
44593,0,1,6,13,20
44594,1,0,10,24,35
44595,0,0,7,15,22
44596,0,0,11,17,28
44597,0,1,4,17,22
44598,0,0,0,6,6
44599,0,0,5,8,13
44600,0,0,6,10,16
44601,0,0,10,17,27
44602,0,0,3,9,12
44603,0,0,5,8,13
44604,0,1,7,16,24
44605,0,0,0,17,17
44606,0,0,9,22,31
44607,0,0,5,10,15
44608,0,0,10,9,19
44609,0,1,2,9,12
44610,1,0,4,26,31
44611,0,0,1,3,4
44612,0,0,3,9,12
44614,0,0,5,24,29
44615,0,0,7,13,20
44616,0,0,2,2,4
44617,0,0,0,7,7
44618,0,0,10,16,26
44619,0,0,11,18,29
44620,0,0,7,7,14
44621,0,0,7,7,14
44622,0,0,5,9,14
44623,1,0,10,23,34
44624,0,0,7,17,24
44625,0,0,11,17,28
44626,0,0,6,18,24
44627,0,0,5,6,11
44628,0,1,8,14,23
44629,1,0,3,8,12
44630,1,0,13,20,34
44631,0,0,11,9,20
44632,0,0,2,3,5
44633,0,0,9,13,22
44634,0,0,4,2,6
44635,0,0,0,11,11
44636,0,0,4,14,18
44637,0,0,18,32,50
44638,0,1,16,21,38
44639,0,0,11,31,42
44640,0,0,6,5,11
44641,0,0,4,5,9
44642,0,0,3,25,28
44643,0,0,5,11,16
44644,0,0,0,5,5
44645,0,0,1,12,13
44646,0,0,8,13,21
44647,0,0,3,3,6
44648,0,0,5,3,8
44649,0,0,9,13,22
44650,0,0,6,5,11
44651,0,0,2,6,8
44652,0,0,7,7,14
44653,0,1,9,11,21
44655,0,0,8,10,18
44656,0,1,9,36,46
44657,0,0,1,6,7
44658,0,0,1,22,23
44659,0,0,1,6,7
44660,0,0,7,8,15
44661,0,0,5,9,14
44663,0,0,12,15,27
44664,0,0,5,4,9
44665,0,0,6,4,10
44666,0,0,5,5,10
44667,0,0,8,33,41
44668,0,0,6,3,9
44669,0,2,7,9,18
44670,0,0,2,7,9
44671,0,0,2,3,5
44672,0,0,18,20,38
44673,0,0,3,10,13
44674,0,0,7,19,26
44675,0,0,5,25,30
44676,2,3,2,27,34
44677,0,0,7,15,22
44678,0,0,0,3,3
44679,0,1,13,18,32
44680,0,0,4,3,7
44681,0,0,2,8,10
44683,0,0,0,5,5
44684,0,0,7,16,23
44685,0,0,13,21,34
44686,2,0,2,8,12
44687,0,0,5,5,10
44688,0,0,5,3,8
44689,0,1,5,12,18
44690,0,1,12,22,35
44691,0,0,8,13,21
44693,0,0,6,3,9
44694,0,0,2,9,11
44695,0,0,8,8,16
44696,1,0,0,13,14
44697,0,0,12,11,23
44698,0,0,5,21,26
44699,0,0,5,9,14
44700,0,0,0,16,16
44701,0,1,7,14,22
44702,0,0,8,10,18
44703,0,0,4,7,11
44704,0,0,5,4,9
44705,0,0,4,2,6
44706,0,0,9,7,16
44707,0,0,3,10,13
44708,0,0,9,19,28
44709,0,0,6,29,35
44710,0,0,4,15,19
44711,0,1,2,7,10
44712,0,0,6,5,11
44714,0,0,0,5,5
44715,0,0,1,4,5
44716,0,0,8,7,15
44717,0,0,5,8,13
44719,0,0,10,11,21
44720,0,1,0,3,4
44721,0,0,2,5,7
44723,0,0,6,14,20
44724,0,1,1,19,21
44725,0,0,0,15,15
44726,0,0,8,8,16
44727,0,0,6,29,35
44728,0,0,0,9,9
44729,0,2,6,21,29
44730,1,0,5,13,19
44732,0,0,5,8,13
44733,0,0,6,43,49
44734,0,1,0,13,14
44735,2,0,2,12,16
44736,0,7,4,39,50
44737,0,0,1,4,5
44738,0,0,10,40,50
44739,1,0,2,2,5
44740,0,0,9,18,27
44742,0,1,9,13,23
44743,0,0,10,23,33
44744,0,0,16,31,47
44745,0,0,7,43,50
44746,0,0,14,26,40
44747,0,0,6,19,25
44748,0,0,5,15,20
44749,0,0,4,4,8
44750,0,1,4,18,23
44751,0,0,7,14,21
44752,1,0,13,24,38
44753,0,0,11,27,38
44754,0,0,13,19,32
44755,0,0,6,6,12
44756,0,1,2,19,22
44757,0,0,8,8,16
44758,0,0,9,12,21
44759,0,0,8,38,46
44760,0,0,7,19,26
44761,0,1,7,9,17
44762,0,0,7,30,37
44763,0,0,14,23,37
44764,0,2,6,21,29
44765,0,0,15,29,44
44766,0,1,13,36,50
44767,0,1,11,25,37
44768,0,1,2,14,17
44769,0,0,7,13,20
44770,0,0,5,12,17
44771,1,0,0,5,6
44772,0,0,5,7,12
44773,1,0,6,23,30
44774,0,0,15,35,50
44775,0,0,4,11,15
44776,0,0,10,40,50
44777,0,0,2,3,5
44778,1,0,12,37,50
44779,0,0,6,14,20
44780,0,0,7,11,18
44781,0,1,1,11,13
44782,0,0,13,30,43
44783,0,0,6,5,11
44784,0,0,9,28,37
44785,0,0,10,6,16
44786,0,0,8,19,27
44787,0,0,8,5,13
44788,0,0,10,17,27
44789,0,1,11,25,37
44791,0,0,2,18,20
44792,0,0,15,34,49
44793,0,0,12,38,50
44794,0,1,2,14,17
44795,0,0,13,20,33
44796,0,0,9,37,46
44797,0,0,10,21,31
44798,0,0,12,11,23
44799,0,0,4,16,20
44800,0,2,13,35,50
44801,0,0,13,32,45
44802,0,0,7,27,34
44803,0,0,9,17,26
44804,1,0,3,20,24
44805,0,0,6,19,25
44806,0,0,14,20,34
44807,0,2,2,17,21
44808,0,0,3,11,14
44809,1,0,18,31,50
44810,0,0,5,45,50
44811,0,0,6,29,35
44812,0,0,17,29,46
44813,0,0,4,36,40
44814,0,0,10,19,29
44815,0,0,8,17,25
44816,0,1,6,18,25
44817,0,0,7,13,20
44818,0,0,2,28,30
44819,0,0,4,4,8
44820,0,0,4,14,18
44821,0,0,8,8,16
44822,0,0,4,4,8
44823,0,0,7,7,14
44824,0,1,12,31,44
44825,0,0,3,10,13
44826,1,0,17,27,45
44827,0,0,8,6,14
44828,1,0,10,33,44
44829,0,0,14,30,44
44830,0,1,2,13,16
44831,0,0,7,5,12
44832,0,1,12,20,33
44833,0,0,17,32,49
44834,0,0,8,30,38
44836,0,0,14,31,45
44837,0,0,0,5,5
44838,0,0,9,7,16
44839,0,0,1,4,5
44840,0,0,6,6,12
44841,0,0,8,13,21
44842,1,0,16,33,50
44843,0,0,8,16,24
44844,0,0,4,4,8
44845,0,0,10,40,50
44846,3,0,2,17,22
44847,1,1,0,23,25
44848,1,0,7,35,43
44849,0,1,1,14,16
44850,0,0,6,1,7
44851,1,0,3,46,50
44852,0,0,6,12,18
44853,1,0,7,36,44
44854,0,0,9,14,23
44855,0,0,8,7,15
44856,0,0,9,14,23
44857,0,0,2,12,14
44858,0,1,10,17,28
44859,0,0,12,33,45
44860,0,1,6,41,48
44861,0,0,2,5,7
44862,0,0,7,19,26
44863,0,0,10,36,46
44864,0,0,6,24,30
44865,0,0,5,6,11
44866,0,2,15,33,50
44867,0,0,12,24,36
44868,0,0,14,21,35
44869,2,0,4,17,23
44870,0,0,2,6,8
44871,0,0,17,22,39
44872,0,1,7,26,34
44873,1,0,8,13,22
44874,0,1,10,13,24
44875,0,0,3,7,10
44876,0,0,0,18,18
44877,0,0,7,10,17
44878,0,0,5,11,16
44879,0,0,14,10,24
44880,0,0,7,16,23
44881,0,0,7,20,27
44882,0,0,7,22,29
44883,0,0,14,23,37
44884,0,0,15,26,41
44885,0,0,7,39,46
44886,0,0,4,7,11
44887,1,0,8,21,30
44888,1,0,6,43,50
44889,0,0,4,9,13
44890,0,0,6,43,49
44891,0,0,9,18,27
44892,0,0,14,24,38
44893,0,0,13,32,45
44894,0,1,11,27,39
44895,0,0,19,27,46
44896,0,0,9,11,20
44897,0,0,6,28,34
44898,0,1,8,22,31
44901,0,0,1,0,1
44902,0,0,3,7,10
44903,5,1,1,7,14
44904,0,0,11,23,34
44905,0,0,8,17,25
44906,0,0,9,9,18
44907,1,0,1,8,10
44908,0,0,9,25,34
44909,0,1,0,6,7
44910,0,0,3,14,17
44911,0,0,11,23,34
44912,0,0,7,9,16
44913,0,1,5,20,26
44914,0,1,7,6,14
44915,1,0,14,31,46
44916,2,0,2,12,16
44917,0,0,11,16,27
44918,0,0,5,10,15
44919,0,0,6,9,15
44922,0,0,9,9,18
44924,0,0,2,14,16
44925,0,0,3,0,3
44926,0,0,8,20,28
44927,0,1,17,29,47
44928,1,0,4,12,17
44929,1,0,5,13,19
44930,1,0,2,2,5
44931,0,0,1,2,3
44932,0,0,10,40,50
44933,0,2,7,9,18
44934,0,0,1,4,5
44935,0,7,4,39,50
44936,0,0,0,10,10
44937,0,1,0,13,14
44938,2,0,4,29,35
44939,0,0,9,22,31
44940,0,0,3,47,50
44941,0,1,3,35,39
44942,0,1,7,9,17
44943,2,2,13,33,50
44944,0,0,5,40,45
44945,0,0,2,11,13
44946,0,0,3,16,19
44947,0,0,0,19,19
44948,0,0,13,37,50
44950,1,0,18,30,49
44951,0,0,9,32,41
44952,0,1,0,30,31
44953,0,0,0,7,7
44954,0,0,4,24,28
44955,0,0,4,11,15
44956,0,0,3,10,13
44957,0,0,2,28,30
44958,3,0,11,24,38
44959,0,0,8,14,22
44960,0,0,6,15,21
44961,0,1,6,16,23
44962,1,0,9,19,29
44963,0,0,9,23,32
44964,0,0,6,43,49
44965,0,0,8,27,35
44966,0,0,1,2,3
44968,0,0,6,4,10
44970,1,0,4,12,17
44971,0,0,1,4,5
44972,0,0,8,23,31
44973,0,0,9,9,18
44974,0,0,9,18,27
44976,0,0,0,10,10
44977,2,0,4,17,23
44978,0,0,1,6,7
44979,1,0,10,24,35
44980,0,0,0,15,15
44981,1,0,0,5,6
44982,1,1,4,14,20
44983,0,0,0,29,29
44984,0,0,5,8,13
44985,2,0,6,30,38
44986,0,0,1,7,8
44987,0,0,8,7,15
44988,0,1,5,39,45
44990,0,0,3,6,9
44991,0,1,9,29,39
44992,0,0,9,18,27
44993,0,0,11,23,34
44994,0,0,0,16,16
44995,0,7,4,39,50
44996,1,1,7,21,30
44997,0,1,10,19,30
44998,0,0,5,40,45
44999,0,0,9,23,32
45000,0,1,10,19,30
45001,0,0,9,23,32
45002,0,0,6,43,49
45003,1,0,5,13,19
45004,0,1,10,19,30
45005,0,0,7,21,28
45006,0,0,3,5,8
45007,0,1,15,30,46
45008,0,1,3,6,10
45009,0,2,12,35,49
45010,0,3,5,23,31
45011,0,2,3,17,22
45012,0,0,4,8,12
45013,0,0,12,18,30
45014,0,0,12,27,39
45015,0,2,9,28,39
45016,0,2,10,35,47
45018,0,0,5,6,11
45019,0,0,10,16,26
45020,0,0,1,5,6
45021,0,0,15,15,30
45022,0,0,3,8,11
45023,1,1,2,19,23
45024,2,1,5,29,37
45025,0,0,5,9,14
45026,0,0,8,13,21
45027,0,0,2,4,6
45028,0,0,3,17,20
45029,0,0,4,18,22
45031,0,0,4,14,18
45032,0,0,2,11,13
45033,0,0,3,2,5
45034,0,1,8,16,25
45035,0,0,2,28,30
45036,0,0,0,10,10
45037,0,0,6,7,13
45039,0,0,6,4,10
45040,0,0,7,7,14
45042,0,0,11,10,21
45043,0,0,4,11,15
45044,0,0,5,6,11
45045,0,0,0,5,5
45046,0,0,9,10,19
45047,0,0,1,29,30
45048,0,0,4,17,21
45049,0,0,0,7,7
45050,0,0,6,12,18
45051,0,0,9,9,18
45052,0,0,7,2,9
45053,0,0,3,13,16
45054,0,0,4,12,16
45055,0,0,9,12,21
45056,0,1,4,18,23
45057,0,2,8,7,17
45058,0,0,4,18,22
45059,0,2,3,11,16
45060,0,0,9,16,25
45061,0,1,5,9,15
45062,0,1,2,12,15
45063,0,0,1,10,11
45064,0,1,4,12,17
45065,0,0,1,12,13
45067,0,0,6,6,12
45068,0,0,6,4,10
45069,0,0,14,11,25
45070,0,2,5,21,28
45071,0,0,7,18,25
45072,0,1,5,22,28
45073,0,0,9,39,48
45074,0,0,11,17,28
45075,0,1,8,23,32
45076,0,0,1,10,11
45077,1,0,8,27,36
45078,0,0,2,14,16
45079,0,0,7,8,15
45080,0,0,6,12,18
45081,0,0,8,19,27
45082,0,0,10,11,21
45083,0,0,5,11,16
45084,0,0,9,38,47
45086,0,0,4,29,33
45087,0,0,7,3,10
45088,0,0,4,1,5
45089,0,0,8,10,18
45090,0,0,6,12,18
45091,0,2,12,32,46
45092,0,1,2,12,15
45093,0,0,8,13,21
45094,0,0,6,2,8
45095,0,1,5,10,16
45096,0,0,2,17,19
45097,4,0,1,7,12
45098,0,0,1,4,5
45100,0,0,3,10,13
45101,0,0,4,13,17
45102,0,0,0,1,1
45103,0,0,7,36,43
45104,0,0,2,16,18
45105,0,0,1,7,8
45106,0,0,2,11,13
45107,0,1,3,6,10
45108,0,0,4,11,15
45109,0,1,8,11,20
45111,0,0,8,28,36
45112,1,0,10,39,50
45113,1,1,9,30,41
45114,0,1,8,41,50
45115,0,1,8,17,26
45116,0,1,12,37,50
45117,0,0,11,24,35
45118,0,1,13,23,37
45119,0,2,8,16,26
45120,0,1,9,9,19
45122,0,1,6,30,37
45123,0,1,1,10,12
45125,0,0,7,21,28
45126,0,1,1,10,12
45127,1,1,12,33,47
45129,0,0,0,5,5
45130,0,0,4,14,18
45131,0,0,10,16,26
45132,0,0,17,33,50
45133,0,0,9,5,14
45134,0,0,6,10,16
45135,0,0,18,31,49
45136,0,0,9,14,23
45138,0,1,14,26,41
45139,0,0,12,28,40
45140,0,3,10,21,34
45141,0,0,11,20,31
45142,0,0,5,16,21
45143,0,0,6,8,14
45144,1,0,8,29,38
45145,0,0,12,24,36
45146,3,1,9,33,46
45147,0,0,8,8,16
45148,0,0,1,5,6
45150,0,1,4,12,17
45151,0,0,3,17,20
45152,0,0,10,18,28
45153,0,0,15,30,45
45154,0,0,5,7,12
45155,1,1,13,35,50
45156,0,1,14,35,50
45157,0,0,6,9,15
45158,0,0,11,17,28
45159,1,1,4,5,11
45160,0,0,10,29,39
45161,0,0,5,20,25
45162,0,0,4,5,9
45163,1,1,5,10,17
45164,0,0,18,29,47
45165,0,1,7,38,46
45166,0,3,11,29,43
45167,0,0,9,22,31
45168,0,0,10,33,43
45169,0,0,0,2,2
45170,0,0,12,27,39
45171,1,0,7,17,25
45172,0,0,4,11,15
45173,0,0,1,10,11
45174,0,1,5,10,16
45175,0,0,2,17,19
45177,1,0,0,5,6
45178,6,0,0,8,14
45179,0,0,2,7,9
45180,1,1,12,33,47
45181,0,0,12,28,40
45182,0,0,15,30,45
45183,1,0,7,17,25
45184,0,0,1,5,6
45185,1,1,13,35,50
45186,0,0,5,16,21
45187,1,0,0,5,6
45188,0,0,11,20,31
45189,1,0,7,17,25
45190,0,0,2,17,19
45192,0,1,7,11,19
45193,1,0,6,5,12
45194,0,0,7,10,17
45195,0,0,3,6,9
45196,0,0,8,5,13
45197,0,0,7,15,22
45198,0,0,1,11,12
45200,0,1,3,6,10
45201,0,0,3,2,5
45202,0,0,2,4,6
45203,0,1,5,3,9
45205,0,0,9,35,44
45206,0,1,10,36,47
45207,0,0,0,25,25
45208,0,0,12,25,37
45209,1,1,5,16,23
45210,0,0,10,32,42
45211,0,0,13,36,49
45212,0,0,4,13,17
45213,0,0,0,7,7
45214,0,0,3,7,10
45215,0,0,5,7,12
45216,0,0,3,5,8
45217,0,0,4,11,15
45218,2,1,1,14,18
45219,0,0,3,8,11
45220,0,0,2,7,9
45221,0,0,5,7,12
45222,0,0,8,16,24
45223,0,0,1,11,12
45224,0,0,4,4,8
45225,0,0,4,17,21
45226,0,1,7,13,21
45227,0,0,1,10,11
45228,0,0,1,37,38
45229,0,1,10,23,34
45230,1,0,8,13,22
45231,0,0,9,9,18
45232,0,0,6,7,13
45233,0,0,6,15,21
45234,0,0,9,10,19
45235,0,0,9,24,33
45236,1,0,10,30,41
45237,0,1,2,17,20
45238,0,2,6,26,34
45239,0,0,2,4,6
45240,0,1,2,6,9
45241,0,0,3,21,24
45242,1,0,6,8,15
45243,0,1,6,28,35
45244,0,1,2,15,18
45246,0,0,1,8,9
45247,0,0,16,18,34
45248,0,0,3,3,6
45249,1,0,10,21,32
45250,0,0,0,8,8
45251,0,0,3,10,13
45252,1,0,2,11,14
45253,1,2,4,42,49
45254,0,1,3,19,23
45255,0,0,6,7,13
45256,1,0,13,26,40
45257,0,0,4,12,16
45258,0,1,2,10,13
45260,0,0,9,12,21
45262,0,1,0,7,8
45263,0,0,2,5,7
45264,0,0,4,9,13
45265,0,1,4,3,8
45267,0,1,3,0,4
45268,0,0,9,11,20
45270,0,0,3,7,10
45271,0,1,10,16,27
45272,0,0,2,13,15
45273,0,0,1,5,6
45274,0,0,0,15,15
45275,0,0,1,6,7
45276,0,0,2,7,9
45277,0,0,0,4,4
45278,0,0,4,13,17
45279,1,0,6,9,16
45280,0,0,3,15,18
45281,0,0,5,18,23
45282,0,0,2,8,10
45284,0,0,7,43,50
45285,0,1,3,8,12
45286,0,0,11,16,27
45287,0,0,8,19,27
45288,0,0,6,4,10
45289,0,0,14,34,48
45290,0,2,8,10,20
45291,0,0,7,9,16
45292,0,0,13,37,50
45293,0,1,6,4,11
45294,0,0,4,16,20
45295,0,0,9,20,29
45296,1,0,8,12,21
45297,0,0,7,10,17
45298,0,0,6,5,11
45299,0,0,6,11,17
45300,0,0,0,5,5
45302,0,0,0,7,7
45303,0,0,6,5,11
45304,0,0,1,3,4
45305,2,0,3,14,19
45306,0,0,5,15,20
45307,1,2,12,35,50
45308,0,1,14,24,39
45309,0,0,14,18,32
45310,0,0,17,26,43
45311,0,0,4,5,9
45312,0,0,5,18,23
45313,1,0,0,12,13
45316,0,0,5,9,14
45317,0,0,2,14,16
45318,2,0,7,29,38
45319,0,0,6,8,14
45320,1,0,5,22,28
45321,0,0,3,3,6
45322,0,0,1,5,6
45323,0,0,7,25,32
45325,0,0,6,13,19
45326,0,1,11,25,37
45327,0,0,16,34,50
45328,0,0,12,19,31
45329,0,1,16,33,50
45330,2,2,12,25,41
45331,0,0,6,10,16
45332,0,0,0,5,5
45333,0,0,5,2,7
45334,0,1,3,6,10
45335,0,2,3,27,32
45336,0,0,10,9,19
45337,0,0,4,4,8
45338,0,0,8,20,28
45339,0,0,2,21,23
45340,0,0,8,4,12
45341,1,0,9,21,31
45342,0,0,14,29,43
45345,0,0,18,29,47
45346,0,0,0,10,10
45347,0,0,2,9,11
45348,0,0,1,15,16
45349,0,0,4,4,8
45350,0,0,8,12,20
45351,0,0,4,12,16
45352,0,0,2,7,9
45353,0,0,13,13,26
45355,0,0,10,11,21
45356,2,0,14,20,36
45357,0,0,0,4,4
45358,0,0,4,5,9
45359,0,0,7,13,20
45360,0,0,7,3,10
45361,0,0,10,11,21
45362,0,0,7,18,25
45363,0,0,1,1,2
45364,0,0,5,14,19
45365,0,0,0,2,2
45366,0,0,4,6,10
45367,0,2,15,28,45
45368,0,0,3,16,19
45369,0,2,16,22,40
45370,0,0,6,22,28
45371,0,0,6,7,13
45372,0,0,4,9,13
45373,0,0,5,15,20
45374,0,0,2,5,7
45375,0,0,7,9,16
45376,0,0,2,3,5
45377,0,0,8,7,15
45378,0,0,6,2,8
45379,1,0,16,20,37
45381,1,0,2,7,10
45382,0,0,8,12,20
45385,0,0,5,10,15
45387,0,0,4,12,16
45388,1,0,3,28,32
45389,0,2,12,22,36
45390,0,1,13,23,37
45391,0,1,5,3,9
45392,3,1,2,32,38
45393,0,0,8,8,16
45394,0,0,9,11,20
45395,0,0,11,14,25
45396,0,0,16,34,50
45397,0,0,6,3,9
45398,3,1,5,32,41
45399,0,0,8,11,19
45400,0,0,4,19,23
45401,0,0,3,2,5
45402,0,1,12,37,50
45403,0,0,7,16,23
45405,0,0,0,14,14
45406,0,0,7,9,16
45407,0,1,2,18,21
45408,0,0,4,13,17
45409,0,0,12,26,38
45410,0,1,4,17,22
45411,0,0,4,6,10
45413,0,0,0,5,5
45414,0,0,7,3,10
45415,0,0,11,19,30
45416,0,0,9,12,21
45417,0,0,3,6,9
45418,0,1,10,27,38
45419,0,0,6,4,10
45420,0,0,2,4,6
45421,0,0,3,6,9
45422,0,0,3,13,16
45423,0,1,7,11,19
45424,0,1,4,12,17
45425,0,0,5,5,10
45426,1,0,4,35,40
45427,0,0,9,15,24
45428,0,0,3,5,8
45429,0,0,12,14,26
45430,0,0,3,3,6
45431,1,0,8,28,37
45432,0,1,12,34,47
45433,0,0,13,25,38
45434,0,0,10,19,29
45435,0,1,8,16,25
45436,1,0,6,5,12
45437,0,0,1,7,8
45438,0,0,1,4,5
45440,0,0,6,19,25
45441,0,0,10,19,29
45442,3,0,1,11,15
45443,0,0,3,7,10
45444,0,0,10,18,28
45445,1,1,2,6,10
45446,1,0,6,23,30
45447,0,0,0,4,4
45448,0,0,2,3,5
45449,0,1,8,16,25
45450,1,0,3,37,41
45452,0,0,6,9,15
45453,0,0,1,5,6
45454,0,1,4,9,14
45455,0,0,4,20,24
45456,0,0,4,4,8
45457,0,0,4,6,10
45458,0,0,0,1,1
45459,0,0,8,5,13
45460,0,0,3,9,12
45461,0,1,1,8,10
45462,1,0,5,4,10
45463,0,0,0,7,7
45464,0,0,12,33,45
45465,0,0,7,15,22
45466,0,2,9,11,22
45467,0,0,6,15,21
45468,0,0,6,18,24
45472,0,0,5,5,10
45473,0,0,7,17,24
45474,0,0,8,12,20
45475,0,0,9,30,39
45476,0,1,13,17,31
45478,0,1,10,18,29
45479,0,0,6,12,18
45480,0,0,7,11,18
45481,0,3,4,19,26
45482,0,0,8,25,33
45483,0,0,1,7,8
45484,0,1,6,7,14
45485,0,3,8,18,29
45486,0,0,5,13,18
45487,0,0,2,7,9
45488,0,0,1,5,6
45490,0,0,5,4,9
45492,0,1,1,11,13
45493,1,0,0,7,8
45495,0,0,3,2,5
45496,0,0,5,11,16
45497,2,0,0,24,26
45498,0,0,1,9,10
45499,0,1,5,34,40
45500,0,0,1,6,7
45501,0,0,1,3,4
45502,2,0,2,12,16
45503,0,0,5,13,18
45504,0,0,7,17,24
45506,0,0,4,11,15
45507,0,0,3,3,6
45508,0,0,0,9,9
45509,0,3,1,4,8
45511,0,0,8,17,25
45515,0,0,15,25,40
45516,0,0,2,3,5
45518,0,0,2,17,19
45519,0,0,8,3,11
45520,0,1,14,24,39
45521,0,1,5,39,45
45522,0,0,10,18,28
45525,0,0,1,11,12
45526,0,0,8,5,13
45527,0,0,14,33,47
45528,0,0,9,18,27
45529,3,1,3,23,30
45530,0,0,6,17,23
45531,1,0,11,22,34
45532,0,0,0,5,5
45533,0,3,7,27,37
45534,1,0,8,25,34
45535,0,0,1,4,5
45537,0,0,6,11,17
45538,0,0,8,27,35
45539,0,0,0,17,17
45540,2,0,12,35,49
45541,0,0,10,18,28
45542,1,0,4,18,23
45543,0,2,4,22,28
45544,0,0,4,4,8
45545,0,0,3,8,11
45546,0,1,10,36,47
45547,0,1,16,33,50
45548,0,0,6,3,9
45550,0,0,3,15,18
45551,0,0,6,6,12
45552,0,0,9,25,34
45553,0,0,1,5,6
45554,0,0,4,16,20
45555,0,1,10,23,34
45556,0,0,10,18,28
45557,0,0,9,9,18
45558,0,0,13,15,28
45559,0,2,1,47,50
45560,0,0,5,31,36
45561,0,1,15,34,50
45562,0,0,11,37,48
45563,0,0,12,38,50
45564,0,0,6,5,11
45565,0,0,12,19,31
45566,0,0,11,10,21
45567,0,0,0,9,9
45569,0,0,8,9,17
45570,0,0,5,9,14
45571,0,0,10,18,28
45572,0,0,7,11,18
45573,0,0,8,17,25
45575,0,0,5,2,7
45576,0,0,5,9,14
45577,0,0,9,24,33
45578,0,1,5,35,41
45579,0,0,9,24,33
45580,0,0,11,35,46
45581,0,0,3,15,18
45582,1,0,0,4,5
45583,0,1,8,38,47
45584,1,1,9,27,38
45585,0,0,11,16,27
45586,0,0,1,10,11
45587,0,0,1,12,13
45588,1,1,17,30,49
45589,0,0,2,9,11
45591,0,1,6,10,17
45592,0,1,14,24,39
45593,0,0,16,33,49
45594,0,0,11,18,29
45595,0,1,2,37,40
45596,0,0,14,36,50
45597,0,0,7,19,26
45598,0,0,4,11,15
45599,0,0,7,12,19
45600,1,0,14,24,39
45601,0,0,19,31,50
45602,0,0,13,23,36
45603,0,0,7,8,15
45604,0,0,1,9,10
45605,0,0,2,17,19
45606,0,0,11,29,40
45607,0,0,4,4,8
45608,0,0,7,15,22
45609,0,0,10,20,30
45610,0,0,9,11,20
45611,0,2,14,34,50
45612,0,2,6,10,18
45613,0,0,0,6,6
45614,0,0,1,7,8
45616,0,0,5,9,14
45617,0,0,7,24,31
45618,0,2,2,19,23
45620,1,0,2,12,15
45621,0,0,3,0,3
45622,0,0,5,11,16
45623,0,0,6,3,9
45624,0,2,15,19,36
45625,1,2,12,32,47
45626,0,0,1,10,11
45627,0,1,3,18,22
45628,1,0,12,31,44
45629,0,0,7,17,24
45630,4,1,3,25,33
45631,0,1,1,13,15
45632,0,0,12,35,47
45633,0,0,18,21,39
45634,0,0,1,4,5
45635,0,1,11,34,46
45636,0,0,12,17,29
45637,0,0,2,14,16
45638,0,0,8,20,28
45639,0,0,11,24,35
45640,0,0,9,10,19
45641,0,0,12,11,23
45642,0,1,16,29,46
45643,0,0,9,27,36
45644,0,0,14,33,47
45645,0,0,10,12,22
45646,2,0,4,9,15
45647,0,1,1,15,17
45648,1,0,1,21,23
45649,0,0,2,5,7
45650,0,1,10,39,50
45651,0,3,7,40,50
45652,0,1,3,11,15
45653,0,0,2,8,10
45654,0,0,1,9,10
45655,0,0,8,21,29
45656,0,2,5,12,19
45657,0,0,13,19,32
45658,0,0,5,5,10
45659,0,0,11,18,29
45660,0,3,0,12,15
45661,0,0,17,22,39
45662,1,0,4,8,13
45663,1,0,10,27,38
45664,0,0,13,8,21
45665,1,0,5,16,22
45666,0,0,0,7,7
45667,0,0,7,19,26
45669,2,0,10,36,48
45670,2,1,8,21,32
45671,0,0,1,8,9
45672,0,1,1,16,18
45673,0,0,0,7,7
45674,0,3,7,27,37
45675,0,0,5,16,21
45676,0,0,6,13,19
45677,0,0,5,5,10
45680,0,1,5,34,40
45681,0,0,16,22,38
45682,0,0,4,6,10
45683,1,0,0,5,6
45684,0,0,1,7,8
45685,0,1,6,1,8
45686,1,0,4,5,10
45687,0,0,0,7,7
45688,2,0,9,25,36
45689,0,1,6,11,18
45690,0,0,10,9,19
45691,2,0,7,29,38
45692,0,0,1,15,16
45693,0,0,9,19,28
45694,0,0,9,41,50
45695,0,0,8,3,11
45696,0,0,2,18,20
45698,0,0,2,3,5
45699,3,1,5,32,41
45700,0,1,12,37,50
45701,0,0,9,18,27
45702,0,0,0,5,5
45703,0,0,10,19,29
45704,1,0,11,22,34
45705,3,1,3,23,30
45706,0,0,8,5,13
45708,1,0,0,7,8
45709,0,0,1,14,15
45710,0,1,0,17,18
45711,0,0,0,16,16
45712,0,0,2,23,25
45713,0,0,1,37,38
45714,0,1,1,24,26
45715,1,0,1,28,30
45716,0,0,0,15,15
45717,0,0,2,14,16
45718,0,0,18,27,45
45719,1,0,7,17,25
45720,0,0,6,44,50
45721,0,0,19,31,50
45722,0,0,2,23,25
45723,0,0,4,16,20
45724,0,1,3,4,8
45725,0,0,0,11,11
45727,0,0,1,9,10
45728,0,1,14,24,39
45729,0,0,7,14,21
45731,0,0,9,20,29
45732,2,0,7,14,23
45733,0,1,10,39,50
45735,0,0,2,14,16
45736,0,0,16,33,49
45737,0,1,1,15,17
45739,0,0,0,6,6
45740,0,1,6,7,14
45741,0,0,0,7,7
45742,1,3,10,36,50
45743,0,0,14,36,50
45744,3,1,3,23,30
45745,2,0,14,34,50
45746,0,0,1,11,12
45747,0,1,6,11,18
45748,0,0,9,41,50
45749,2,0,2,12,16
45750,0,0,0,4,4
45751,1,0,1,5,7
45752,2,0,9,25,36
45754,1,0,6,5,12
45755,0,0,5,8,13
45756,0,0,9,18,27
45757,1,0,8,25,34
45758,0,0,9,19,28
45759,0,0,0,6,6
45760,1,1,3,39,44
45761,0,1,6,17,24
45762,0,0,0,5,5
45763,0,1,12,37,50
45764,1,0,11,22,34
45765,0,0,6,11,17
45766,0,0,0,5,5
45767,0,1,5,39,45
45768,2,0,0,24,26
45769,0,0,8,20,28
45770,2,0,12,35,49
45771,0,0,3,10,13
45772,0,0,11,19,30
45773,0,0,11,19,30
45774,0,0,4,5,9
45775,2,3,14,31,50
45776,0,0,5,8,13
45777,0,0,4,5,9
45778,0,0,2,6,8
45779,0,0,5,17,22
45780,0,0,0,2,2
45781,0,0,2,4,6
45782,0,0,3,8,11
45783,0,1,4,11,16
45784,0,0,8,15,23
45785,1,0,2,4,7
45786,0,0,5,7,12
45787,0,0,11,19,30
45788,0,0,1,5,6
45789,0,2,6,5,13
45790,0,0,2,4,6
45791,0,0,7,12,19
45792,0,0,4,4,8
45793,0,0,3,2,5
45794,0,0,2,5,7
45795,0,0,1,4,5
45796,1,1,1,9,12
45797,0,0,5,10,15
45798,0,0,7,14,21
45800,0,0,4,5,9
45801,0,1,4,11,16
45802,0,0,11,19,30
45803,2,3,14,31,50
45804,0,0,3,3,6
45805,0,0,3,9,12
45806,0,0,3,4,7
45808,0,1,4,11,16
45809,1,1,1,9,12
45810,0,0,5,10,15
45811,0,0,0,1,1
45812,0,0,4,5,9
45813,0,0,9,3,12
45814,0,0,3,15,18
45815,0,0,6,18,24
45816,0,1,8,15,24
45817,0,0,6,18,24
45818,0,0,5,10,15
45819,0,0,7,15,22
45820,0,0,4,5,9
45821,0,0,1,1,2
45822,1,2,3,8,14
45823,0,0,5,13,18
45824,0,1,0,8,9
45825,0,0,13,19,32
45826,0,1,3,28,32
45827,0,2,10,17,29
45828,0,0,3,7,10
45829,0,0,2,3,5
45830,1,0,8,18,27
45831,0,0,5,23,28
45832,0,1,4,9,14
45833,0,1,12,16,29
45834,0,0,0,1,1
45835,0,1,6,11,18
45836,0,0,0,3,3
45837,0,0,7,14,21
45838,0,0,5,13,18
45839,0,0,1,2,3
45840,0,0,9,7,16
45841,0,2,6,10,18
45842,0,1,4,7,12
45843,0,1,1,2,4
45844,0,0,2,3,5
45845,0,0,2,4,6
45846,0,0,0,5,5
45847,0,0,0,6,6
45848,0,0,1,4,5
45849,0,0,2,3,5
45850,0,0,4,6,10
45851,1,1,2,20,24
45852,0,0,2,4,6
45853,0,1,4,11,16
45854,0,0,2,14,16
45855,0,1,5,44,50
45856,0,0,0,1,1
45857,0,0,11,19,30
45858,0,0,0,6,6
45859,0,2,7,40,49
45860,0,0,11,19,30
45862,0,1,5,44,50
45863,0,0,2,3,5
45864,0,1,4,11,16
45865,0,1,5,44,50
45866,0,0,0,3,3
45867,0,1,5,44,50
45868,0,2,7,40,49
45869,0,1,4,11,16
45870,0,0,5,10,15
45871,0,0,12,15,27
45872,0,0,5,17,22
45873,1,1,4,3,9
45874,0,0,4,7,11
45875,0,0,8,5,13
45876,0,0,4,5,9
45877,0,0,12,20,32
45878,0,0,2,10,12
45879,0,0,7,12,19
45880,0,0,2,26,28
45881,0,0,5,11,16
45882,0,0,0,11,11
45883,0,2,2,14,18
45884,0,0,7,7,14
45885,0,1,4,20,25
45886,0,2,5,7,14
45887,0,0,4,17,21
45888,0,0,3,6,9
45889,0,0,5,10,15
45890,0,0,7,3,10
45892,1,0,6,7,14
45893,0,0,2,9,11
45894,0,0,3,26,29
45895,2,3,14,31,50
45896,0,1,6,20,27
45897,0,0,12,15,27
45898,0,0,2,4,6
45899,0,0,4,4,8
45900,0,0,5,2,7
45901,0,0,5,3,8
45902,0,0,2,3,5
45903,2,3,14,31,50
45904,0,0,4,4,8
45905,1,2,17,30,50
45906,0,0,2,9,11
45907,0,0,2,3,5
45908,1,0,6,7,14
45909,0,0,4,6,10
45910,0,0,4,11,15
45911,0,0,3,20,23
45912,0,0,9,26,35
45913,0,1,3,16,20
45914,0,0,6,18,24
45915,0,0,4,12,16
45916,1,0,10,30,41
45917,0,0,19,30,49
45918,0,0,6,10,16
45919,0,0,0,10,10
45920,0,0,2,15,17
45921,1,1,1,9,12
45922,0,5,5,24,34
45923,1,0,6,7,14
45924,0,0,2,3,5
45925,0,0,0,6,6
45926,1,2,5,27,35
45927,0,0,3,5,8
45928,0,1,1,9,11
45929,0,0,2,11,13
45930,0,0,0,10,10
45931,0,0,3,5,8
45932,0,0,8,28,36
45933,0,0,2,6,8
45934,1,0,6,7,14
45935,0,0,0,10,10
45936,0,0,0,10,10
45937,0,0,0,10,10
45938,0,0,0,10,10
45939,1,1,1,9,12
45940,0,0,12,38,50
45941,0,0,4,8,12
45943,0,0,3,10,13
45944,0,0,8,6,14
45945,0,1,5,24,30
45946,0,0,9,3,12
45947,0,0,3,21,24
45948,0,0,0,5,5
45949,0,0,0,5,5
45950,0,3,3,28,34
45951,0,0,0,10,10
45952,0,0,3,2,5
45953,0,0,12,38,50
45954,2,2,3,43,50
45955,0,0,0,10,10
45956,0,3,3,28,34
45957,0,0,0,10,10
45958,0,0,12,38,50
45959,0,0,0,10,10
45960,0,0,0,10,10
45961,0,0,0,10,10
45962,0,0,12,38,50
45963,0,0,5,16,21
45964,0,0,12,15,27
45965,0,0,2,1,3
45967,0,1,14,28,43
45968,0,0,6,22,28
45969,0,0,1,9,10
45970,0,0,11,12,23
45971,0,0,2,10,12
45972,0,0,1,1,2
45973,1,2,3,13,19
45975,0,0,6,14,20
45976,0,1,4,4,9
45977,0,0,9,17,26
45978,0,0,5,3,8
45979,0,0,7,11,18
45981,0,0,13,35,48
45982,0,0,2,9,11
45983,0,0,2,4,6
45984,0,2,7,27,36
45985,0,0,1,7,8
45986,0,0,1,4,5
45987,0,0,7,21,28
45988,0,1,9,14,24
45989,0,0,5,14,19
45990,0,0,3,8,11
45991,0,0,0,6,6
45992,0,1,16,31,48
45993,0,0,5,8,13
45994,0,0,7,12,19
45995,0,0,7,23,30
45996,0,0,2,6,8
45997,0,0,4,6,10
45998,0,1,0,7,8
45999,0,0,6,19,25
46000,0,0,3,11,14
46001,0,0,10,22,32
46002,0,0,5,5,10
46003,0,0,6,8,14
46004,0,0,2,14,16
46005,1,0,9,15,25
46006,0,0,2,5,7
46007,0,0,5,11,16
46008,0,0,2,3,5
46009,0,0,4,5,9
46010,0,0,5,10,15
46012,1,1,2,14,18
46015,0,0,10,16,26
46016,1,1,4,12,18
46017,0,0,12,15,27
46018,0,0,3,3,6
46021,0,0,1,7,8
46022,0,1,11,30,42
46023,0,1,2,27,30
46024,0,0,12,38,50
46025,0,0,11,12,23
46026,0,0,12,23,35
46027,0,0,12,38,50
46028,0,0,0,5,5
46030,0,0,2,9,11
46031,0,0,1,3,4
46032,0,0,0,11,11
46033,0,0,7,11,18
46034,0,0,5,6,11
46035,1,0,8,18,27
46036,0,1,3,11,15
46037,0,0,1,7,8
46038,0,0,6,19,25
46039,0,0,4,4,8
46040,0,1,3,20,24
46041,0,0,2,9,11
46042,0,0,4,4,8
46043,0,0,0,1,1
46044,0,0,5,4,9
46045,0,0,7,15,22
46046,1,2,8,17,28
46047,0,1,5,44,50
46048,0,0,4,9,13
46049,2,1,11,35,49
46050,0,0,11,10,21
46051,0,0,2,7,9
46052,0,0,3,2,5
46054,0,0,3,8,11
46055,0,0,14,36,50
46056,0,0,3,7,10
46057,0,2,2,22,26
46058,0,1,4,19,24
46059,0,0,6,12,18
46060,0,0,10,18,28
46061,0,0,4,5,9
46062,0,0,7,17,24
46064,0,0,9,20,29
46065,0,0,6,5,11
46066,0,1,2,5,8
46067,2,3,14,31,50
46068,0,0,0,10,10
46069,0,0,6,11,17
46070,0,0,8,19,27
46071,0,0,0,1,1
46072,0,0,4,8,12
46073,0,0,9,23,32
46074,0,0,6,4,10
46075,2,3,14,31,50
46076,0,2,7,40,49
46077,2,2,3,43,50
46078,0,1,5,44,50
46079,0,0,0,10,10
46080,0,1,5,44,50
46081,0,0,0,10,10
46082,0,0,0,10,10
46083,0,0,0,10,10
46084,0,1,5,44,50
46085,0,2,7,40,49
46086,0,0,0,10,10
46087,0,0,0,5,5
46088,0,0,2,9,11
46089,0,2,0,23,25
46090,0,0,2,13,15
46091,0,0,3,3,6
46092,0,0,9,24,33
46093,0,0,1,4,5
46094,0,0,1,7,8
46095,0,0,1,14,15
46096,1,1,7,16,25
46097,0,1,2,12,15
46098,0,2,0,23,25
46099,0,0,2,9,11
46100,0,1,2,12,15
46101,0,0,2,9,11
46102,0,0,3,3,6
46104,0,0,10,7,17
46105,1,2,13,24,40
46106,0,1,2,35,38
46107,0,0,6,8,14
46108,0,0,3,15,18
46109,0,0,4,18,22
46110,0,0,11,27,38
46111,0,0,5,10,15
46112,0,0,7,12,19
46113,0,0,4,13,17
46114,0,0,10,7,17
46115,0,0,1,7,8
46116,0,1,4,10,15
46117,0,0,6,2,8
46118,0,1,0,7,8
46119,0,0,1,5,6
46120,0,0,2,6,8
46121,1,2,13,24,40
46122,0,0,3,9,12
46123,0,2,9,12,23
46124,0,0,2,5,7
46125,0,0,4,11,15
46126,0,0,2,24,26
46127,0,0,6,10,16
46129,1,0,13,27,41
46130,0,0,11,17,28
46131,0,0,3,12,15
46133,0,1,10,18,29
46135,1,1,4,31,37
46136,0,0,4,7,11
46137,0,0,1,1,2
46138,0,2,2,16,20
46139,0,2,3,15,20
46140,0,0,10,10,20
46141,0,0,10,8,18
46142,0,1,2,12,15
46143,0,0,5,11,16
46144,0,0,1,4,5
46145,0,0,1,4,5
46146,0,1,4,10,15
46147,0,0,5,9,14
46148,0,0,3,8,11
46149,0,1,5,10,16
46150,0,0,2,9,11
46151,0,0,2,9,11
46152,0,3,5,14,22
46153,1,2,3,6,12
46154,0,1,5,11,17
46155,0,0,2,8,10
46156,0,0,2,4,6
46157,7,1,5,19,32
46158,1,3,5,14,23
46159,5,0,0,20,25
46160,0,0,3,10,13
46161,1,6,6,34,47
46162,1,0,0,4,5
46163,1,0,1,3,5
46164,0,0,0,2,2
46167,2,1,4,17,24
46168,0,1,0,11,12
46169,0,2,11,22,35
46170,0,0,0,1,1
46171,0,1,16,31,48
46172,1,6,6,34,47
46173,0,1,4,19,24
46174,0,0,3,7,10
46175,0,1,0,10,11
46176,2,1,4,17,24
46177,5,0,0,20,25
46178,0,1,2,35,38
46179,1,3,5,14,23
46180,1,0,10,30,41
46181,0,0,2,9,11
46182,0,0,2,9,11
46183,0,0,4,11,15
46184,0,1,0,11,12
46185,1,3,5,14,23
46186,0,0,12,15,27
46187,5,0,0,20,25
46188,0,2,2,16,20
46189,0,1,0,11,12
46190,0,0,2,24,26
46191,1,0,13,27,41
46192,0,0,2,9,11
46193,0,0,3,7,10
46194,0,0,3,10,13
46195,1,0,10,30,41
46196,0,0,11,27,38
46197,7,1,5,19,32
46198,5,0,0,20,25
46199,0,0,5,18,23
46200,0,0,2,15,17
46201,0,1,7,12,20
46203,0,0,7,10,17
46204,1,2,9,12,24
46205,0,0,1,6,7
46206,0,0,9,31,40
46207,0,0,11,19,30
46208,0,0,6,7,13
46209,0,1,10,26,37
46210,1,0,5,9,15
46211,0,0,0,9,9
46212,0,1,11,24,36
46213,0,3,5,11,19
46214,0,0,2,5,7
46215,0,0,5,16,21
46216,1,0,11,18,30
46217,0,0,16,34,50
46218,0,4,1,13,18
46219,0,0,1,6,7
46220,0,0,7,10,17
46221,0,0,3,24,27
46222,0,0,1,20,21
46223,0,1,4,34,39
46224,0,0,3,3,6
46225,0,2,15,21,38
46226,0,0,5,4,9
46227,0,0,0,12,12
46228,0,0,3,9,12
46229,0,0,1,7,8
46230,0,0,0,1,1
46232,0,0,5,16,21
46233,0,0,5,2,7
46234,0,0,7,4,11
46236,0,0,5,11,16
46237,0,0,6,8,14
46238,0,1,11,16,28
46239,1,0,10,12,23
46240,0,0,8,16,24
46241,0,1,11,29,41
46242,0,0,3,3,6
46243,0,0,3,10,13
46244,0,0,3,5,8
46245,0,0,2,6,8
46246,0,0,4,2,6
46247,0,0,2,4,6
46248,0,0,3,2,5
46249,0,0,7,3,10
46250,0,3,11,17,31
46251,0,0,3,24,27
46252,0,0,0,2,2
46253,0,0,2,0,2
46254,0,0,4,4,8
46255,0,0,4,12,16
46256,0,1,5,6,12
46257,0,0,0,3,3
46258,0,0,6,10,16
46259,0,0,4,6,10
46260,0,2,1,10,13
46261,0,0,8,17,25
46262,0,0,7,8,15
46263,0,1,1,8,10
46264,0,0,0,7,7
46265,0,0,4,13,17
46266,7,1,5,19,32
46268,0,1,8,3,12
46269,0,0,3,4,7
46270,0,0,5,16,21
46271,0,0,1,4,5
46272,0,0,1,2,3
46273,0,0,2,10,12
46274,0,0,1,4,5
46275,0,0,0,5,5
46276,0,0,2,8,10
46277,0,1,3,8,12
46278,0,0,4,2,6
46279,0,0,8,11,19
46280,0,0,3,10,13
46281,0,1,4,9,14
46282,0,0,3,3,6
46284,0,0,9,24,33
46285,0,2,0,5,7
46286,0,1,12,34,47
46287,0,0,7,10,17
46289,0,0,0,7,7
46290,5,0,0,20,25
46291,0,0,2,15,17
46292,0,0,0,6,6
46293,0,0,3,5,8
46294,0,2,0,23,25
46295,0,1,7,12,20
46296,0,0,13,16,29
46297,0,0,9,24,33
46298,5,0,0,20,25
46299,0,1,7,12,20
46300,0,0,9,21,30
46301,0,1,12,34,47
46302,0,1,10,26,37
46303,0,0,1,4,5
46304,1,0,2,7,10
46305,0,0,1,6,7
46306,0,0,2,8,10
46307,0,2,0,23,25
46308,0,0,0,7,7
46309,5,0,0,20,25
46310,1,0,2,7,10
46311,0,0,1,4,5
46312,0,2,0,5,7
46313,0,0,2,15,17
46314,0,0,9,31,40
46315,0,0,3,3,6
46316,7,1,5,19,32
46317,5,0,0,20,25
46318,0,0,1,6,7
46319,0,0,10,7,17
46320,1,0,10,24,35
46321,0,0,0,9,9
46322,0,0,0,7,7
46323,0,0,9,17,26
46324,1,0,1,4,6
46325,0,0,2,11,13
46326,0,0,10,23,33
46327,0,0,1,13,14
46328,0,0,7,7,14
46329,0,0,3,15,18
46330,0,0,6,7,13
46331,0,0,3,9,12
46332,0,0,8,15,23
46333,0,0,9,17,26
46334,0,1,3,8,12
46335,0,0,0,5,5
46337,0,0,9,21,30
46338,1,0,10,24,35
46339,0,0,0,6,6
46340,0,0,3,11,14
46342,0,0,2,11,13
46343,0,0,2,9,11
46344,0,0,4,23,27
46345,1,1,7,16,25
46346,0,0,3,10,13
46347,0,0,2,1,3
46348,0,1,2,10,13
46349,0,0,3,12,15
46350,0,0,0,7,7
46351,0,0,6,9,15
46352,0,0,6,8,14
46353,0,0,2,10,12
46354,0,0,9,8,17
46355,0,0,12,32,44
46357,0,0,6,9,15
46358,0,0,1,11,12
46359,0,1,4,10,15
46360,0,0,9,11,20
46361,0,1,3,15,19
46362,0,0,1,5,6
46363,0,2,12,36,50
46364,0,0,3,4,7
46365,0,0,14,13,27
46366,1,0,9,11,21
46367,0,0,1,4,5
46368,0,0,3,3,6
46369,0,0,12,17,29
46370,0,0,2,5,7
46371,0,0,0,6,6
46372,0,0,5,11,16
46373,0,2,0,20,22
46374,0,0,4,9,13
46375,0,1,13,13,27
46376,0,0,2,10,12
46377,1,0,4,15,20
46378,1,0,9,17,27
46379,0,0,5,13,18
46380,0,0,5,9,14
46381,0,0,3,4,7
46382,0,0,0,22,22
46383,0,0,1,5,6
46385,0,0,1,13,14
46386,0,0,0,5,5
46387,0,0,2,6,8
46388,0,0,11,16,27
46389,0,0,2,13,15
46391,0,1,12,34,47
46392,0,0,10,7,17
46393,0,0,7,13,20
46394,0,0,1,6,7
46396,0,0,0,7,7
46397,0,4,12,30,46
46398,0,0,5,4,9
46399,0,0,3,36,39
46400,0,2,11,37,50
46401,0,0,7,40,47
46402,0,0,1,7,8
46403,0,0,5,15,20
46404,0,0,5,3,8
46405,0,0,10,13,23
46406,0,0,9,13,22
46407,0,0,0,5,5
46408,0,0,7,14,21
46409,0,1,9,40,50
46410,1,1,1,6,9
46411,0,1,12,34,47
46412,0,0,1,6,7
46413,0,0,0,5,5
46414,0,0,0,7,7
46415,0,0,0,8,8
46416,0,0,1,6,7
46417,0,1,7,12,20
46418,0,1,5,17,23
46419,0,0,3,16,19
46420,0,0,6,13,19
46421,0,0,2,7,9
46422,0,0,3,10,13
46423,0,0,4,7,11
46424,0,0,4,6,10
46425,1,0,2,9,12
46426,0,0,12,21,33
46427,0,1,4,34,39
46428,0,0,2,4,6
46429,0,0,2,3,5
46431,0,0,4,5,9
46432,0,0,10,26,36
46433,0,1,0,13,14
46435,0,1,3,14,18
46436,0,0,9,24,33
46437,0,0,8,11,19
46438,0,0,1,7,8
46439,0,1,0,5,6
46440,0,1,5,15,21
46441,2,0,11,30,43
46442,1,0,2,22,25
46443,0,0,4,6,10
46444,1,0,4,8,13
46445,0,1,6,13,20
46446,0,0,9,18,27
46447,0,0,0,13,13
46448,1,1,5,27,34
46449,2,0,6,16,24
46450,0,0,3,14,17
46451,0,1,18,27,46
46452,0,1,12,19,32
46453,0,0,0,7,7
46454,0,3,7,35,45
46455,0,1,7,12,20
46456,0,0,6,9,15
46457,1,0,5,26,32
46458,1,1,5,27,34
46459,0,0,0,1,1
46460,0,0,7,10,17
46461,0,1,7,12,20
46463,0,0,0,7,7
46464,0,1,7,21,29
46465,0,0,3,10,13
46466,0,0,2,15,17
46467,0,1,7,13,21
46468,0,2,6,18,26
46469,0,0,7,17,24
46470,0,0,13,36,49
46471,0,0,3,9,12
46472,0,0,4,9,13
46473,2,0,2,23,27
46474,0,0,1,16,17
46475,0,1,8,21,30
46476,1,0,5,9,15
46478,0,0,4,2,6
46479,0,0,8,18,26
46480,0,0,5,6,11
46481,1,0,10,13,24
46482,0,1,0,6,7
46484,1,0,6,4,11
46485,0,0,2,6,8
46486,0,0,5,8,13
46487,0,0,3,10,13
46488,0,3,5,14,22
46489,0,1,7,13,21
46491,0,0,2,15,17
46494,0,0,6,8,14
46495,2,1,2,24,29
46496,0,0,2,9,11
46497,1,0,10,30,41
46498,2,1,2,24,29
46500,0,0,2,15,17
46501,1,0,10,30,41
46502,0,0,10,7,17
46503,0,0,1,2,3
46504,0,0,9,11,20
46505,1,0,3,21,25
46506,0,0,5,16,21
46507,0,0,4,17,21
46508,3,1,8,37,49
46509,0,0,10,7,17
46510,0,0,5,13,18
46511,0,0,6,7,13
46512,0,0,1,2,3
46513,0,0,1,14,15
46514,0,0,3,10,13
46515,0,0,11,17,28
46516,0,2,12,36,50
46517,0,0,9,16,25
46518,0,0,6,19,25
46519,0,0,2,8,10
46520,0,1,11,21,33
46521,0,1,11,23,35
46522,0,0,5,26,31
46523,0,0,0,5,5
46524,0,0,3,0,3
46525,0,0,9,16,25
46526,0,0,2,3,5
46527,0,0,3,4,7
46528,0,0,1,4,5
46529,0,0,3,14,17
46530,0,1,3,20,24
46531,0,1,5,23,29
46532,0,0,5,24,29
46533,0,0,4,10,14
46534,0,0,1,7,8
46535,0,0,0,8,8
46536,1,0,2,11,14
46537,0,1,5,4,10
46538,0,0,7,16,23
46539,0,0,6,3,9
46540,1,6,6,34,47
46541,0,0,10,6,16
46542,0,1,9,40,50
46543,1,6,6,34,47
46544,0,1,6,25,32
46545,0,2,4,5,11
46546,1,0,2,11,14
46547,0,0,5,15,20
46548,0,0,5,12,17
46549,0,0,5,24,29
46550,0,0,1,7,8
46551,0,1,5,20,26
46552,2,2,5,36,45
46553,0,0,0,5,5
46554,0,0,2,15,17
46555,0,0,2,4,6
46556,1,2,13,24,40
46557,0,1,24,25,50
46558,0,0,9,3,12
46559,0,1,1,8,10
46560,0,0,15,32,47
46561,0,1,3,17,21
46562,2,1,2,23,28
46563,0,0,0,17,17
46564,0,0,4,2,6
46567,0,0,2,15,17
46568,0,0,5,24,29
46569,1,2,13,24,40
46570,0,0,0,5,5
46571,0,0,3,32,35
46572,0,0,5,24,29
46573,1,3,3,37,44
46574,0,0,2,15,17
46575,0,1,2,35,38
46576,0,0,3,18,21
46577,0,0,2,32,34
46578,0,0,0,5,5
46579,0,0,7,17,24
46580,0,0,16,11,27
46581,1,0,1,12,14
46582,0,0,4,25,29
46583,0,0,9,22,31
46584,0,0,10,18,28
46585,0,0,9,24,33
46586,1,1,15,27,44
46589,0,0,3,2,5
46590,0,0,1,4,5
46591,0,0,5,13,18
46592,0,1,7,9,17
46593,0,0,2,15,17
46596,0,0,2,15,17
46597,0,0,0,5,5
46598,0,0,0,7,7
46599,0,0,0,4,4
46600,0,0,4,11,15
46601,0,0,2,4,6
46602,0,2,2,12,16
46603,0,0,6,6,12
46604,0,0,3,11,14
46605,0,0,4,11,15
46606,0,0,5,11,16
46607,0,0,17,25,42
46608,0,0,12,30,42
46609,1,1,8,37,47
46610,0,0,0,3,3
46611,0,0,3,21,24
46612,0,0,1,4,5
46613,0,0,2,12,14
46614,0,1,2,35,38
46615,0,0,9,24,33
46616,0,0,0,7,7
46617,0,0,0,4,4
46618,0,0,0,5,5
46619,0,0,5,11,16
46620,0,0,5,5,10
46621,0,4,18,28,50
46622,2,3,7,38,50
46623,0,0,1,10,11
46624,1,1,13,33,48
46625,0,3,2,32,37
46626,0,1,9,21,31
46627,0,1,6,12,19
46628,0,0,2,5,7
46629,0,2,4,10,16
46630,0,0,1,10,11
46631,0,4,18,28,50
46632,1,0,8,23,32
46634,0,1,5,9,15
46635,0,0,3,4,7
46636,0,0,5,7,12
46637,0,1,5,30,36
46638,0,0,3,2,5
46639,1,0,4,9,14
46640,0,1,11,18,30
46641,0,1,4,18,23
46642,0,0,9,21,30
46643,0,0,5,12,17
46644,0,0,0,15,15
46645,0,0,0,10,10
46646,0,0,2,1,3
46647,0,0,5,12,17
46648,0,0,4,9,13
46649,1,1,4,16,22
46650,0,0,8,5,13
46651,2,0,4,32,38
46652,0,0,8,17,25
46653,0,2,4,40,46
46654,0,0,4,9,13
46655,0,1,1,1,3
46656,0,1,6,12,19
46657,0,0,3,2,5
46658,0,0,2,3,5
46659,0,2,7,12,21
46660,0,0,6,1,7
46661,0,1,9,24,34
46662,0,0,3,11,14
46663,0,0,6,7,13
46664,0,1,12,26,39
46665,0,0,0,5,5
46666,0,1,5,30,36
46667,0,0,6,0,6
46668,0,0,2,9,11
46670,0,0,2,5,7
46671,0,0,10,15,25
46672,0,0,4,6,10
46673,0,0,4,9,13
46674,0,0,4,6,10
46675,0,0,5,16,21
46676,0,0,3,1,4
46679,0,0,1,13,14
46680,0,0,6,5,11
46681,0,2,15,33,50
46682,0,0,8,24,32
46683,0,0,7,11,18
46684,0,1,2,10,13
46685,2,0,1,11,14
46686,0,0,2,17,19
46687,0,0,2,9,11
46688,0,0,1,0,1
46689,0,1,3,12,16
46690,0,0,3,5,8
46691,0,0,3,8,11
46692,0,1,8,16,25
46693,0,0,1,19,20
46694,0,1,11,35,47
46695,0,0,3,10,13
46696,0,0,3,16,19
46697,0,0,2,7,9
46698,0,0,6,4,10
46699,0,0,4,10,14
46701,1,2,5,42,50
46702,0,0,0,8,8
46703,0,0,13,36,49
46704,0,0,7,7,14
46706,0,1,3,14,18
46707,0,0,5,7,12
46708,0,0,3,6,9
46709,0,0,7,7,14
46710,0,0,3,15,18
46711,0,0,4,10,14
46712,0,0,3,8,11
46713,0,0,3,8,11
46714,0,1,8,17,26
46715,2,0,0,11,13
46716,0,0,1,1,2
46719,1,0,1,11,13
46720,0,0,0,9,9
46721,1,1,0,12,14
46722,0,2,2,8,12
46723,0,0,4,7,11
46724,0,0,8,14,22
46725,0,0,3,16,19
46726,0,0,1,7,8
46727,0,0,5,3,8
46729,0,0,6,12,18
46730,0,0,1,2,3
46731,0,0,7,12,19
46732,1,1,0,23,25
46733,0,0,5,7,12
46734,0,0,1,4,5
46735,0,0,1,15,16
46736,0,0,0,5,5
46737,0,1,5,9,15
46738,0,1,5,9,15
46739,1,1,17,22,41
46740,0,0,1,5,6
46741,0,3,0,3,6
46742,0,0,1,11,12
46743,0,2,2,18,22
46745,0,0,22,28,50
46746,0,0,11,15,26
46747,1,0,8,16,25
46748,0,0,15,35,50
46749,0,0,13,28,41
46750,1,0,9,9,19
46751,0,1,20,29,50
46752,2,0,14,31,47
46753,0,0,1,4,5
46754,0,1,8,18,27
46755,0,8,2,40,50
46756,0,0,7,14,21
46757,0,0,4,6,10
46758,5,2,5,23,35
46759,1,0,3,35,39
46760,0,0,8,26,34
46761,1,1,0,23,25
46762,0,0,9,25,34
46763,0,2,3,8,13
46764,0,0,8,22,30
46765,0,1,9,20,30
46766,0,0,10,16,26
46767,1,2,5,42,50
46768,0,2,2,18,22
46769,0,2,15,33,50
46770,0,0,3,1,4
46771,0,0,1,5,6
46772,0,1,5,30,36
46773,0,0,1,2,3
46774,0,2,7,12,21
46775,0,2,0,11,13
46776,0,0,5,7,12
46777,0,3,3,42,48
46778,0,0,1,5,6
46779,0,0,13,28,41
46780,0,2,0,11,13
46781,0,1,9,20,30
46782,0,1,6,41,48
46783,0,0,6,12,18
46784,0,3,0,3,6
46785,0,8,2,40,50
46786,0,3,0,3,6
46787,0,8,2,40,50
46788,1,1,17,22,41
46789,0,0,1,2,3
46790,0,2,15,33,50
46791,0,1,6,8,15
46792,0,3,3,42,48
46793,0,0,15,35,50
46794,1,0,1,11,13
46795,0,1,9,20,30
46796,0,0,15,35,50
46797,0,0,7,3,10
46798,0,1,20,29,50
46800,0,0,0,5,5
46801,0,3,3,42,48
46802,0,0,7,14,21
46803,1,0,3,35,39
46804,0,0,10,16,26
46805,0,1,6,8,15
46806,1,2,5,42,50
46807,0,0,8,26,34
46808,0,0,11,15,26
46809,0,0,5,7,12
46810,0,8,2,40,50
46811,0,0,1,15,16
46812,0,0,1,13,14
46813,0,1,5,9,15
46814,0,0,8,14,22
46815,0,3,0,3,6
46816,1,1,17,22,41
46817,0,0,5,7,12
46819,0,0,12,14,26
46820,0,1,5,7,13
46821,0,0,4,6,10
46822,0,0,7,15,22
46823,0,1,4,17,22
46824,0,1,11,13,25
46826,0,1,5,30,36
46827,0,0,3,11,14
46828,0,2,4,14,20
46829,0,0,3,4,7
46830,0,1,5,9,15
46831,0,0,5,0,5
46832,0,0,0,5,5
46833,0,0,3,4,7
46834,0,0,9,16,25
46835,0,0,5,10,15
46836,0,0,7,16,23
46837,0,1,7,11,19
46838,0,0,18,14,32
46839,0,1,4,17,22
46840,0,0,0,4,4
46841,0,0,8,14,22
46842,0,0,1,6,7
46843,0,0,8,20,28
46844,0,0,3,11,14
46845,0,0,4,8,12
46846,1,1,5,21,28
46847,0,1,7,22,30
46848,0,8,2,19,29
46850,0,1,8,8,17
46851,1,0,1,20,22
46852,0,1,2,22,25
46853,0,4,18,28,50
46854,0,1,5,12,18
46855,0,0,3,23,26
46856,0,0,5,12,17
46857,0,0,10,25,35
46858,1,0,7,22,30
46859,0,0,2,11,13
46860,0,0,7,9,16
46861,0,0,4,2,6
46863,0,0,11,24,35
46864,0,0,7,11,18
46865,0,0,5,19,24
46866,0,0,1,10,11
46867,0,0,9,6,15
46868,0,0,1,9,10
46869,0,0,4,6,10
46870,0,1,10,8,19
46871,0,1,7,8,16
46872,0,0,4,9,13
46873,0,0,7,14,21
46874,0,0,7,13,20
46875,2,0,2,7,11
46876,0,1,18,26,45
46877,0,0,6,14,20
46878,0,0,5,7,12
46879,0,0,3,9,12
46880,0,2,9,35,46
46881,0,0,6,11,17
46882,0,0,2,9,11
46883,0,0,3,21,24
46884,0,0,5,5,10
46885,0,0,12,29,41
46886,0,0,5,4,9
46887,0,0,6,5,11
46888,0,0,3,13,16
46889,0,0,5,20,25
46891,0,1,3,21,25
46892,0,1,10,6,17
46893,0,0,2,21,23
46894,0,3,0,14,17
46895,0,0,2,6,8
46896,0,1,7,31,39
46897,0,0,6,10,16
46898,1,0,6,19,26
46899,0,0,0,10,10
46901,0,0,5,12,17
46902,0,0,2,5,7
46903,0,0,9,17,26
46904,0,0,6,9,15
46905,0,0,5,13,18
46906,0,1,12,10,23
46907,0,2,15,24,41
46908,0,0,4,4,8
46909,0,0,6,8,14
46910,0,0,9,22,31
46912,0,0,4,6,10
46913,0,0,10,18,28
46914,1,1,8,40,50
46915,0,0,0,5,5
46917,0,0,5,9,14
46918,0,0,15,25,40
46919,0,0,12,36,48
46920,0,3,1,9,13
46922,0,0,4,9,13
46923,0,1,9,19,29
46924,0,0,6,8,14
46925,0,0,4,12,16
46926,0,1,1,28,30
46927,0,0,5,8,13
46928,0,0,5,5,10
46929,0,0,5,7,12
46930,0,0,3,7,10
46931,0,0,9,6,15
46932,0,0,6,12,18
46933,0,0,2,12,14
46934,0,2,12,36,50
46935,0,0,1,11,12
46936,0,0,9,6,15
46937,0,0,5,13,18
46938,0,0,1,5,6
46939,0,0,4,5,9
46940,0,0,2,10,12
46941,0,0,2,7,9
46942,0,1,12,36,49
46943,0,1,13,25,39
46944,0,0,6,19,25
46945,0,0,4,19,23
46946,0,1,11,14,26
46947,0,0,7,6,13
46948,0,0,4,7,11
46949,0,1,4,9,14
46950,0,0,2,9,11
46951,0,2,6,13,21
46952,0,0,6,4,10
46953,0,1,2,8,11
46954,0,0,2,11,13
46955,0,0,1,7,8
46956,0,1,8,18,27
46957,0,1,5,27,33
46959,0,0,3,8,11
46960,0,1,5,7,13
46961,0,0,2,14,16
46962,0,0,8,22,30
46963,0,0,8,14,22
46964,0,0,7,11,18
46966,0,0,5,1,6
46967,1,0,6,2,9
46968,0,0,8,16,24
46969,0,1,4,6,11
46970,0,1,13,30,44
46971,0,0,4,13,17
46972,0,0,4,2,6
46973,0,0,0,2,2
46974,0,0,15,35,50
46975,0,0,5,3,8
46976,0,0,2,17,19
46977,0,0,4,14,18
46978,0,0,3,12,15
46979,0,0,4,6,10
46980,0,0,3,5,8
46981,0,0,5,8,13
46982,0,0,6,7,13
46983,0,0,7,18,25
46984,0,0,4,9,13
46985,0,1,1,14,16
46986,4,0,7,27,38
46987,0,0,0,6,6
46988,0,1,5,9,15
46989,0,0,3,5,8
46990,0,0,1,4,5
46991,0,1,5,17,23
46993,0,0,3,9,12
46994,0,0,4,18,22
46996,0,0,6,9,15
46997,0,0,2,7,9
46998,0,0,0,1,1
46999,0,0,3,19,22
47000,0,0,4,8,12
47001,0,0,3,8,11
47002,0,2,3,11,16
47003,0,0,6,4,10
47004,0,3,0,5,8
47005,0,0,7,6,13
47006,0,1,9,7,17
47007,0,0,3,9,12
47008,0,0,1,20,21
47009,0,0,2,4,6
47010,0,0,7,8,15
47011,0,2,12,28,42
47012,0,1,3,7,11
47013,0,2,2,11,15
47014,0,0,2,3,5
47015,0,0,1,20,21
47016,0,0,2,42,44
47017,0,0,6,13,19
47018,0,1,7,17,25
47019,0,0,7,4,11
47020,0,0,11,13,24
47021,0,3,0,18,21
47023,1,0,2,7,10
47024,0,0,3,4,7
47025,0,0,4,9,13
47026,0,2,5,38,45
47027,1,1,17,22,41
47028,0,0,6,2,8
47029,0,4,0,3,7
47030,0,0,8,11,19
47033,0,0,8,6,14
47034,0,1,5,6,12
47035,0,0,7,5,12
47036,0,0,2,6,8
47037,0,0,7,27,34
47038,0,0,3,10,13
47039,0,1,4,9,14
47040,0,0,0,1,1
47041,1,0,8,33,42
47042,0,0,3,7,10
47043,0,0,3,11,14
47044,0,0,8,18,26
47045,0,0,0,9,9
47047,1,0,10,39,50
47048,0,0,4,4,8
47049,0,0,1,4,5
47050,0,1,0,10,11
47051,1,3,12,27,43
47052,0,0,2,4,6
47053,0,0,12,14,26
47054,0,0,16,21,37
47055,0,0,5,9,14
47057,0,0,1,4,5
47058,0,1,5,43,49
47059,0,0,6,1,7
47060,0,1,5,30,36
47061,0,1,10,32,43
47062,1,0,10,33,44
47063,0,1,1,23,25
47064,0,0,4,25,29
47065,1,0,4,10,15
47066,0,0,1,19,20
47067,0,0,3,11,14
47068,0,0,1,12,13
47069,0,0,3,12,15
47070,0,1,12,8,21
47071,0,0,8,25,33
47072,0,2,14,33,49
47073,2,0,1,4,7
47074,0,2,4,14,20
47076,1,0,1,2,4
47077,1,1,1,19,22
47079,0,0,14,36,50
47080,0,1,3,7,11
47081,0,0,5,10,15
47082,0,0,8,20,28
47083,1,0,8,33,42
47084,0,0,11,23,34
47085,0,0,2,7,9
47086,0,0,9,35,44
47087,0,0,17,24,41
47088,1,1,7,34,43
47089,0,0,12,22,34
47090,0,0,8,18,26
47091,0,0,4,9,13
47092,0,0,11,27,38
47093,0,0,15,23,38
47094,0,0,12,20,32
47095,1,0,7,22,30
47096,0,1,5,22,28
47097,0,0,3,11,14
47098,0,0,5,18,23
47099,0,0,12,38,50
47100,0,0,6,10,16
47101,0,0,15,34,49
47102,0,0,12,27,39
47103,0,0,11,13,24
47104,4,0,11,31,46
47105,0,0,8,16,24
47106,0,1,0,22,23
47107,0,0,3,11,14
47108,3,0,5,8,16
47109,0,0,1,6,7
47110,0,1,5,30,36
47111,0,0,14,26,40
47112,0,0,0,5,5
47113,0,3,0,14,17
47114,1,0,3,17,21
47115,1,3,12,27,43
47116,0,0,5,3,8
47117,0,0,11,24,35
47119,0,0,9,10,19
47120,1,0,12,21,34
47121,0,0,14,35,49
47122,0,0,10,33,43
47123,0,0,13,33,46
47124,0,0,10,13,23
47125,0,1,5,15,21
47126,0,0,5,17,22
47127,0,0,6,11,17
47128,0,0,4,5,9
47129,3,0,3,24,30
47130,0,0,10,19,29
47131,0,0,11,31,42
47132,0,1,12,19,32
47133,0,0,13,21,34
47134,0,0,4,5,9
47135,0,0,1,12,13
47136,0,0,10,16,26
47137,0,0,9,17,26
47138,0,1,5,12,18
47139,0,0,2,3,5
47140,0,1,5,26,32
47141,0,1,12,8,21
47142,2,0,1,4,7
47143,0,1,4,7,12
47144,0,0,3,15,18
47146,0,0,10,17,27
47147,0,2,1,15,18
47148,0,1,14,35,50
47149,0,1,2,22,25
47150,0,0,7,8,15
47151,0,0,1,4,5
47152,0,4,18,28,50
47153,0,0,13,28,41
47154,0,2,1,5,8
47155,0,0,5,9,14
47156,1,0,3,35,39
47157,0,1,8,18,27
47158,2,0,4,21,27
47159,0,0,12,14,26
47160,1,0,19,30,50
47161,0,0,6,14,20
47162,0,1,1,23,25
47163,0,0,9,22,31
47164,1,1,2,10,14
47165,0,0,11,15,26
47166,0,1,5,43,49
47167,1,0,4,20,25
47168,0,0,16,34,50
47169,0,1,7,17,25
47170,0,0,4,25,29
47171,0,1,9,20,30
47172,0,0,8,25,33
47173,0,0,1,20,21
47174,1,0,1,2,4
47175,1,0,11,19,31
47176,2,0,4,21,27
47178,0,2,1,15,18
47179,0,0,13,28,41
47180,0,0,7,10,17
47181,0,0,2,4,6
47183,0,0,12,12,24
47184,0,1,8,18,27
47185,1,0,19,30,50
47186,1,0,1,2,4
47187,0,1,9,20,30
47188,0,1,14,35,50
47189,0,1,2,22,25
47191,1,0,1,2,4
47192,0,1,4,9,14
47193,0,0,1,20,21
47194,1,1,17,22,41
47195,0,0,7,23,30
47196,0,1,6,8,15
47197,1,2,10,37,50
47198,0,0,7,23,30
47199,0,0,2,4,6
47200,1,2,10,37,50
47201,0,1,6,8,15
47202,0,1,4,9,14
47203,0,0,11,15,26
47204,1,0,3,35,39
47205,0,1,9,20,30
47206,0,0,10,16,26
47207,0,0,9,22,31
47208,1,1,17,22,41
47209,3,0,3,24,30
47210,0,0,16,34,50
47211,1,0,4,10,15
47212,1,0,19,30,50
47213,0,0,7,4,11
47214,0,1,6,14,21
47215,0,0,5,7,12
47216,0,0,2,5,7
47217,0,0,7,21,28
47218,1,4,14,31,50
47219,0,0,5,12,17
47220,0,0,11,11,22
47221,0,0,3,15,18
47222,0,2,3,17,22
47223,0,0,3,12,15
47224,0,1,2,17,20
47225,0,1,13,33,47
47226,0,0,2,4,6
47227,0,0,4,13,17
47229,0,0,8,11,19
47230,0,0,4,8,12
47231,0,0,8,18,26
47232,0,5,11,26,42
47233,0,0,0,2,2
47234,0,0,7,12,19
47235,0,0,2,3,5
47236,0,0,16,20,36
47237,0,1,4,24,29
47238,0,1,4,12,17
47239,0,1,17,32,50
47240,0,1,5,12,18
47241,0,0,3,14,17
47242,0,0,5,5,10
47243,0,0,8,16,24
47244,1,0,3,11,15
47245,1,0,1,9,11
47246,0,0,4,21,25
47247,0,0,3,11,14
47248,0,0,13,22,35
47249,0,1,2,6,9
47250,0,0,7,22,29
47251,0,0,7,8,15
47252,0,0,1,20,21
47253,0,0,8,22,30
47254,0,0,2,7,9
47255,0,0,1,3,4
47256,0,0,5,18,23
47257,0,0,2,6,8
47258,0,0,2,11,13
47259,0,0,2,7,9
47260,0,1,8,16,25
47261,0,0,8,11,19
47262,0,0,6,11,17
47263,0,0,0,22,22
47264,0,0,11,30,41
47265,0,0,7,18,25
47266,0,0,7,19,26
47267,0,1,0,11,12
47268,0,1,8,15,24
47269,0,1,3,18,22
47270,0,0,14,32,46
47271,0,0,7,16,23
47272,0,0,2,3,5
47273,0,0,4,14,18
47274,1,0,1,16,18
47276,0,1,1,17,19
47277,0,0,5,2,7
47278,0,1,7,13,21
47279,0,0,5,16,21
47280,0,1,2,8,11
47281,0,0,2,3,5
47282,0,0,4,3,7
47283,0,0,2,10,12
47284,1,0,11,38,50
47285,0,0,4,4,8
47286,0,0,1,16,17
47287,0,0,4,13,17
47288,0,0,8,21,29
47289,1,2,9,36,48
47290,0,0,11,19,30
47291,0,0,9,19,28
47292,0,1,10,21,32
47294,0,0,3,2,5
47295,0,0,4,10,14
47296,0,0,10,11,21
47297,0,0,0,2,2
47298,0,0,3,8,11
47300,0,0,5,4,9
47301,0,0,3,5,8
47302,0,0,8,19,27
47303,0,0,7,14,21
47304,0,1,5,9,15
47305,0,0,3,0,3
47307,1,1,2,37,41
47308,1,1,9,31,42
47309,0,0,7,12,19
47310,0,0,4,26,30
47311,0,0,6,6,12
47312,0,0,5,6,11
47313,0,0,6,17,23
47314,0,0,3,6,9
47315,0,0,2,3,5
47316,0,0,5,17,22
47317,0,0,1,11,12
47318,0,4,0,7,11
47319,0,1,4,7,12
47320,0,1,12,30,43
47321,0,0,3,20,23
47322,0,0,4,3,7
47323,0,3,2,7,12
47324,0,0,1,6,7
47325,0,1,5,43,49
47326,0,0,8,15,23
47327,0,0,5,13,18
47328,0,0,6,19,25
47329,0,0,4,5,9
47330,0,0,14,26,40
47331,0,1,13,18,32
47332,0,0,9,14,23
47333,0,2,0,4,6
47334,0,0,8,16,24
47335,0,0,2,17,19
47336,0,0,3,7,10
47337,0,0,2,2,4
47338,0,0,13,28,41
47339,0,1,5,25,31
47340,0,1,6,14,21
47341,0,0,3,12,15
47343,0,0,6,14,20
47344,0,0,1,4,5
47345,0,1,14,26,41
47346,0,0,0,7,7
47347,0,0,6,14,20
47348,0,0,0,1,1
47349,0,2,1,15,18
47350,0,0,4,2,6
47351,2,0,2,15,19
47352,0,2,3,17,22
47353,0,0,7,3,10
47354,0,1,4,14,19
47355,0,1,1,10,12
47356,0,0,0,5,5
47358,0,0,6,9,15
47359,0,0,9,41,50
47360,0,0,9,25,34
47361,0,0,2,9,11
47362,0,0,3,12,15
47363,0,2,2,6,10
47364,1,0,5,14,20
47365,0,0,1,6,7
47366,1,0,10,16,27
47367,0,0,1,7,8
47368,0,0,3,24,27
47369,0,4,3,21,28
47370,0,1,5,7,13
47371,0,0,4,27,31
47372,0,0,1,11,12
47373,0,0,4,2,6
47375,0,0,15,35,50
47376,0,0,5,9,14
47378,0,0,4,4,8
47379,0,0,2,5,7
47380,0,0,2,8,10
47381,0,0,9,21,30
47382,0,0,3,24,27
47383,0,0,5,32,37
47384,0,0,10,7,17
47385,1,2,4,6,13
47386,0,1,5,3,9
47387,0,0,3,10,13
47388,0,2,2,18,22
47391,0,0,9,15,24
47392,0,0,0,1,1
47393,0,0,1,4,5
47394,1,1,6,13,21
47395,0,1,12,8,21
47396,0,0,2,3,5
47398,0,4,0,6,10
47399,0,0,3,6,9
47400,0,0,4,6,10
47401,0,0,10,26,36
47402,0,0,9,15,24
47403,0,0,1,4,5
47406,0,0,4,16,20
47407,0,0,5,12,17
47408,0,0,2,3,5
47410,0,0,1,9,10
47411,0,0,1,12,13
47412,0,0,9,35,44
47413,0,0,9,5,14
47414,0,1,12,12,25
47415,0,0,4,10,14
47416,0,0,4,11,15
47419,0,0,11,30,41
47421,0,0,7,15,22
47423,0,0,5,5,10
47424,0,0,1,4,5
47425,0,0,1,5,6
47426,0,0,2,3,5
47427,0,0,8,10,18
47428,1,0,1,48,50
47429,0,0,2,7,9
47430,0,1,5,22,28
47431,0,0,8,37,45
47432,0,1,4,9,14
47433,0,0,3,4,7
47434,0,0,1,2,3
47435,0,0,1,8,9
47436,0,0,2,5,7
47437,0,0,10,19,29
47438,1,2,5,42,50
47439,0,0,0,6,6
47440,0,0,6,22,28
47441,0,2,15,33,50
47442,0,0,13,37,50
47443,0,0,2,3,5
47444,0,0,1,8,9
47445,0,0,5,7,12
47446,0,0,1,4,5
47447,0,2,8,36,46
47448,0,3,0,7,10
47449,0,1,2,22,25
47450,0,2,11,31,44
47451,1,1,11,37,50
47452,0,0,1,9,10
47453,0,0,14,26,40
47454,0,0,3,8,11
47455,0,0,11,11,22
47456,0,0,10,12,22
47457,0,1,10,14,25
47458,0,2,6,32,40
47459,0,0,10,27,37
47460,0,0,5,16,21
47461,1,3,12,34,50
47462,0,0,8,16,24
47463,2,0,18,30,50
47464,1,1,7,21,30
47465,0,1,20,29,50
47466,0,0,2,7,9
47467,0,0,17,18,35
47468,0,0,5,31,36
47469,0,2,1,15,18
47470,0,0,7,8,15
47471,0,1,2,16,19
47472,0,0,20,28,48
47473,0,1,5,22,28
47474,0,1,14,35,50
47475,0,2,12,20,34
47476,0,0,9,15,24
47477,0,0,9,23,32
47478,0,4,5,11,20
47479,0,0,13,16,29
47480,0,0,7,15,22
47481,1,0,3,17,21
47482,0,0,8,20,28
47483,0,0,12,38,50
47484,1,1,2,10,14
47485,0,0,8,13,21
47486,0,0,4,18,22
47487,0,0,4,11,15
47488,0,0,2,10,12
47489,0,0,8,10,18
47490,0,0,0,17,17
47491,1,0,13,29,43
47492,0,0,7,5,12
47493,0,0,6,14,20
47494,0,0,13,28,41
47496,2,0,11,19,32
47497,0,0,2,14,16
47498,0,0,9,22,31
47499,0,0,9,16,25
47500,0,1,13,36,50
47501,0,0,4,4,8
47502,0,0,5,3,8
47503,0,0,8,23,31
47504,2,1,4,37,44
47505,0,0,2,3,5
47506,0,0,2,3,5
47507,0,0,6,36,42
47509,0,1,8,24,33
47510,0,0,0,8,8
47511,0,0,4,12,16
47514,0,0,6,17,23
47515,0,1,10,39,50
47516,0,0,1,8,9
47517,0,0,12,19,31
47518,0,0,9,13,22
47519,0,0,2,11,13
47520,0,0,1,2,3
47521,0,0,1,8,9
47522,0,0,8,12,20
47523,0,0,8,18,26
47524,0,2,15,33,50
47525,1,1,9,31,42
47526,0,1,5,43,49
47527,0,0,10,19,29
47528,3,1,6,22,32
47529,1,2,5,42,50
47530,0,0,13,37,50
47531,0,4,0,6,10
47532,0,0,1,11,12
47533,0,2,2,18,22
47534,0,0,4,27,31
47535,0,1,12,8,21
47536,0,0,6,36,42
47537,0,0,7,7,14
47538,0,2,1,15,18
47539,0,0,1,9,10
47540,0,0,5,7,12
47541,0,0,8,37,45
47543,0,2,6,32,40
47544,1,0,8,15,24
47545,0,0,13,37,50
47546,0,0,2,5,7
47547,0,0,5,12,17
47548,0,0,6,43,49
47549,0,0,4,5,9
47550,0,0,5,12,17
47551,0,0,2,3,5
47552,0,1,4,9,14
47553,0,0,1,2,3
47554,0,2,15,33,50
47555,1,0,1,48,50
47556,0,1,4,9,14
47557,0,1,20,29,50
47558,1,2,5,42,50
47559,0,0,6,36,42
47560,2,0,2,15,19
47561,0,1,13,33,47
47562,0,0,5,7,12
47564,0,2,2,21,25
47565,0,0,0,5,5
47566,1,0,5,9,15
47567,0,4,1,18,23
47568,0,0,3,4,7
47569,0,0,7,18,25
47570,0,0,4,12,16
47571,0,0,1,19,20
47572,0,1,3,6,10
47573,0,0,1,2,3
47574,0,0,1,5,6
47575,0,0,3,2,5
47576,0,0,5,15,20
47577,0,0,2,18,20
47578,0,0,3,6,9
47579,0,0,8,15,23
47580,0,0,4,10,14
47581,0,0,1,11,12
47582,0,0,0,7,7
47583,0,0,1,23,24
47584,0,0,8,20,28
47585,0,0,2,17,19
47586,0,0,1,7,8
47587,0,0,8,18,26
47588,0,0,14,29,43
47589,0,0,0,2,2
47590,0,0,12,25,37
47591,0,0,2,29,31
47592,0,0,8,10,18
47593,0,0,9,35,44
47594,0,0,4,5,9
47595,0,0,3,6,9
47596,0,3,3,15,21
47597,0,2,6,17,25
47598,0,0,3,10,13
47599,0,0,11,19,30
47600,0,0,10,5,15
47601,0,0,14,31,45
47603,0,0,4,14,18
47604,0,0,2,11,13
47605,0,1,6,8,15
47606,0,0,8,27,35
47607,0,0,10,20,30
47608,0,0,5,22,27
47609,0,0,6,7,13
47610,0,0,5,12,17
47611,0,1,2,20,23
47612,0,0,6,16,22
47613,0,0,6,5,11
47614,0,0,5,2,7
47615,0,0,12,28,40
47616,0,0,4,18,22
47617,0,2,8,9,19
47618,0,0,1,23,24
47619,0,0,2,10,12
47620,0,0,4,14,18
47621,0,0,2,18,20
47623,0,1,1,2,4
47624,0,0,7,8,15
47625,1,0,3,12,16
47626,0,0,7,29,36
47627,0,0,14,33,47
47628,0,0,1,11,12
47629,3,1,6,26,36
47630,0,3,7,19,29
47631,0,0,2,9,11
47633,0,1,8,6,15
47634,0,0,4,4,8
47636,0,0,5,1,6
47637,0,0,7,24,31
47638,0,0,0,5,5
47639,0,1,6,21,28
47640,0,0,7,8,15
47641,0,0,1,4,5
47642,1,1,5,20,27
47643,1,0,1,6,8
47644,0,0,6,19,25
47645,0,0,5,18,23
47646,0,1,3,20,24
47647,0,1,4,7,12
47648,0,0,3,3,6
47650,0,0,7,12,19
47651,0,0,18,32,50
47652,0,0,17,33,50
47653,0,0,5,15,20
47654,0,0,7,5,12
47655,0,1,4,11,16
47656,0,2,7,16,25
47658,0,2,5,8,15
47660,0,0,5,10,15
47661,0,0,1,3,4
47662,0,0,5,11,16
47663,0,0,2,6,8
47665,0,1,5,8,14
47666,0,0,4,11,15
47667,0,0,1,7,8
47668,0,0,6,22,28
47670,0,0,0,5,5
47671,0,0,2,3,5
47672,0,0,3,7,10
47673,0,0,5,8,13
47674,1,0,1,5,7
47675,0,0,5,0,5
47676,0,0,0,7,7
47677,0,1,12,19,32
47678,0,0,1,4,5
47679,0,0,4,9,13
47680,0,0,10,22,32
47681,0,0,8,11,19
47682,0,0,4,22,26
47683,0,0,6,3,9
47684,0,0,0,5,5
47685,0,0,6,32,38
47686,0,0,9,21,30
47687,1,2,5,42,50
47688,0,2,14,33,49
47689,0,0,11,19,30
47690,0,0,8,15,23
47691,0,0,9,29,38
47692,0,0,1,6,7
47693,0,0,4,10,14
47694,0,0,9,26,35
47695,0,0,1,1,2
47696,1,0,2,8,11
47697,0,0,8,21,29
47698,0,0,4,8,12
47699,0,0,8,10,18
47700,0,2,10,27,39
47701,0,0,11,26,37
47702,0,0,6,5,11
47703,0,1,11,23,35
47705,0,0,1,15,16
47706,1,1,9,31,42
47707,0,1,3,11,15
47708,0,1,5,22,28
47709,0,0,1,8,9
47710,1,0,0,3,4
47712,0,0,2,12,14
47713,0,1,11,38,50
47714,0,3,3,13,19
47715,0,0,7,15,22
47716,0,0,1,20,21
47717,0,2,0,4,6
47718,0,0,5,7,12
47719,1,0,1,2,4
47720,1,0,5,16,22
47721,0,0,10,30,40
47722,0,0,0,5,5
47723,0,2,11,31,44
47724,0,3,5,31,39
47725,0,0,12,38,50
47726,1,0,14,35,50
47727,0,0,5,6,11
47728,0,0,14,31,45
47729,0,0,7,15,22
47730,0,0,13,35,48
47731,0,0,8,26,34
47732,0,0,6,4,10
47733,0,0,3,9,12
47734,0,0,8,42,50
47735,0,0,14,29,43
47736,0,0,3,22,25
47737,0,0,6,8,14
47738,0,0,1,42,43
47739,0,1,11,23,35
47740,0,0,4,5,9
47741,0,0,12,22,34
47742,1,0,1,18,20
47743,0,1,9,20,30
47744,0,0,10,15,25
47745,0,0,13,31,44
47746,0,3,6,17,26
47747,0,0,11,25,36
47748,0,0,6,5,11
47749,0,0,10,14,24
47750,0,1,4,19,24
47751,0,0,4,11,15
47752,0,0,3,24,27
47754,0,1,12,29,42
47755,0,0,14,24,38
47756,0,0,15,35,50
47757,0,0,7,19,26
47758,0,2,8,19,29
47759,0,0,1,8,9
47760,0,0,2,9,11
47761,0,1,7,42,50
47762,0,2,8,13,23
47763,0,0,1,15,16
47764,1,0,19,30,50
47765,0,0,7,17,24
47766,1,0,9,30,40
47767,0,0,1,5,6
47769,0,0,16,34,50
47770,1,1,6,36,44
47771,0,0,3,1,4
47773,0,0,10,27,37
47774,0,1,12,37,50
47775,0,2,2,21,25
47776,3,1,3,27,34
47777,0,0,6,10,16
47778,3,0,2,9,14
47779,0,1,5,22,28
47780,0,0,8,19,27
47781,0,3,3,13,19
47782,1,0,5,16,22
47783,3,1,6,22,32
47784,1,0,1,2,4
47785,1,2,5,42,50
47786,0,0,14,31,45
47787,0,1,11,38,50
47788,0,0,2,3,5
47789,1,1,9,31,42
47790,0,2,10,27,39
47791,0,0,7,9,16
47792,0,0,4,41,45
47793,1,0,14,35,50
47794,0,1,12,29,42
47795,0,1,11,23,35
47796,0,0,1,3,4
47797,0,0,7,18,25
47798,0,2,8,19,29
47799,0,1,5,31,37
47800,0,4,1,18,23
47801,1,0,1,2,4
47802,1,0,19,30,50
47803,0,0,5,7,12
47804,1,0,1,2,4
47805,0,2,14,34,50
47806,0,0,5,23,28
47807,0,0,1,20,21
47808,1,2,5,42,50
47809,0,0,16,34,50
47810,0,0,7,15,22
47811,1,0,19,30,50
47812,0,0,3,11,14
47813,0,0,12,14,26
47814,0,1,5,30,36
47815,0,0,9,10,19
47816,0,0,6,10,16
47817,0,0,5,20,25
47818,0,2,9,18,29
47819,0,0,2,9,11
47820,0,0,0,15,15
47821,1,2,10,28,41
47822,0,0,3,10,13
47823,0,1,2,9,12
47824,0,1,0,4,5
47825,0,1,5,19,25
47826,0,0,1,15,16
47827,0,0,6,10,16
47828,0,1,9,15,25
47829,0,1,6,27,34
47830,0,0,0,11,11
47831,0,0,5,12,17
47832,0,0,7,11,18
47833,0,0,14,25,39
47834,0,0,2,1,3
47835,1,0,10,23,34
47836,1,0,5,33,39
47837,0,0,1,18,19
47838,0,2,0,20,22
47839,0,1,4,9,14
47840,0,0,2,13,15
47841,0,0,10,11,21
47842,0,0,6,12,18
47844,0,1,13,11,25
47845,0,0,1,4,5
47846,0,0,0,5,5
47847,1,1,11,26,39
47848,0,0,1,6,7
47849,0,0,9,30,39
47850,0,1,7,18,26
47851,0,0,9,22,31
47852,0,0,9,8,17
47853,0,1,5,30,36
47854,0,1,6,21,28
47855,0,0,1,8,9
47856,0,0,2,12,14
47857,2,0,5,27,34
47858,1,0,3,12,16
47859,0,0,6,13,19
47860,0,0,1,7,8
47861,1,1,16,29,47
47862,0,0,3,13,16
47863,0,0,11,18,29
47864,1,0,3,14,18
47865,1,2,8,33,44
47866,1,1,3,45,50
47867,0,0,9,8,17
47868,1,0,4,31,36
47869,0,0,4,10,14
47870,0,0,2,9,11
47871,0,0,0,7,7
47872,0,0,1,0,1
47873,0,0,0,2,2
47874,0,0,10,18,28
47875,0,0,1,4,5
47876,0,4,2,10,16
47877,0,1,7,13,21
47879,0,0,1,4,5
47882,0,0,5,25,30
47883,0,0,1,12,13
47885,0,1,9,37,47
47886,0,0,4,19,23
47887,0,1,6,14,21
47888,0,0,3,11,14
47890,0,0,1,2,3
47891,0,1,11,23,35
47892,0,0,2,12,14
47893,0,0,12,14,26
47894,0,0,1,12,13
47895,0,0,2,4,6
47896,0,0,6,14,20
47897,2,0,1,29,32
47898,0,0,13,37,50
47900,1,1,3,32,37
47901,0,0,8,37,45
47902,0,1,10,39,50
47903,0,0,3,4,7
47904,0,1,0,6,7
47905,0,0,0,5,5
47906,0,0,2,18,20
47907,0,1,14,35,50
47908,0,1,13,31,45
47909,0,0,12,38,50
47910,0,0,16,32,48
47911,0,1,9,12,22
47912,0,1,7,40,48
47913,0,0,0,28,28
47914,0,1,7,16,24
47915,0,0,7,31,38
47916,0,0,10,38,48
47917,0,1,9,14,24
47918,0,0,8,25,33
47919,0,0,19,31,50
47920,0,2,9,20,31
47921,0,1,2,4,7
47922,0,0,12,14,26
47923,0,1,13,29,43
47924,0,1,8,41,50
47926,0,1,4,9,14
47927,0,0,6,11,17
47928,0,0,1,4,5
47929,0,0,9,6,15
47930,0,1,0,29,30
47931,0,0,12,34,46
47932,3,0,5,19,27
47933,0,0,12,13,25
47934,0,0,10,20,30
47935,0,0,10,20,30
47936,0,1,9,11,21
47937,0,1,6,14,21
47938,0,0,2,8,10
47940,0,0,6,13,19
47941,0,0,12,15,27
47942,0,0,13,37,50
47943,0,1,11,23,35
47944,0,1,10,15,26
47945,2,0,1,29,32
47946,1,1,3,13,18
47947,0,0,12,26,38
47948,0,0,5,12,17
47949,0,0,6,14,20
47950,0,1,9,37,47
47951,0,0,1,2,3
47952,0,0,1,12,13
47953,0,1,5,30,36
47954,0,0,7,20,27
47955,0,1,9,15,25
47956,0,0,9,8,17
47957,1,1,16,29,47
47958,0,0,9,22,31
47959,0,0,0,7,7
47960,0,0,2,4,6
47961,0,0,8,26,34
47962,0,0,13,37,50
47963,0,1,7,40,48
47964,0,1,11,23,35
47965,0,0,0,6,6
47966,0,0,12,34,46
47967,1,2,10,28,41
47968,0,0,2,5,7
47969,0,1,11,23,35
47970,0,0,2,11,13
47971,0,0,0,2,2
47972,0,0,1,2,3
47973,0,0,8,26,34
47974,0,0,9,22,31
47975,1,1,11,11,24
47976,0,0,3,4,7
47977,0,0,5,14,19
47978,0,1,0,4,5
47979,0,0,2,4,6
47980,0,0,12,14,26
47981,0,0,3,2,5
47982,0,0,3,11,14
47983,0,1,5,9,15
47984,0,1,5,7,13
47985,0,0,3,5,8
47986,0,0,3,4,7
47987,0,0,1,4,5
47988,0,1,5,15,21
47989,0,0,5,11,16
47990,0,0,7,24,31
47991,0,1,17,32,50
47992,0,1,5,16,22
47993,0,0,11,33,44
47994,0,0,4,10,14
47995,0,0,4,25,29
47996,2,0,8,17,27
47997,0,0,3,7,10
47998,0,1,5,7,13
47999,0,0,5,3,8
48000,0,0,11,11,22
48001,0,0,2,3,5
48003,0,0,2,8,10
48004,0,1,7,5,13
48005,0,0,4,15,19
48006,0,1,7,18,26
48007,1,0,5,32,38
48008,0,0,3,12,15
48009,0,0,7,40,47
48011,0,0,16,27,43
48012,0,0,11,39,50
48013,0,0,1,22,23
48014,1,0,3,15,19
48015,0,1,2,6,9
48016,0,1,2,15,18
48017,0,2,6,16,24
48018,0,1,7,30,38
48020,0,1,1,3,5
48021,0,1,0,4,5
48022,0,0,4,1,5
48023,0,1,7,18,26
48024,0,0,4,19,23
48025,1,2,6,16,25
48026,0,1,4,11,16
48027,0,0,2,10,12
48028,0,1,8,34,43
48029,0,0,3,1,4
48030,1,1,9,11,22
48031,0,0,3,5,8
48032,0,0,5,17,22
48033,0,1,20,25,46
48034,0,1,11,38,50
48035,0,0,0,14,14
48036,0,0,2,3,5
48037,0,0,10,22,32
48038,0,2,6,36,44
48039,0,1,7,17,25
48040,0,0,3,9,12
48042,0,0,2,5,7
48043,0,0,10,8,18
48044,0,1,5,17,23
48045,2,0,9,24,35
48046,0,0,14,27,41
48048,0,0,2,6,8
48049,0,1,3,9,13
48050,0,3,10,37,50
48051,1,0,5,12,18
48052,0,0,0,12,12
48053,0,0,2,8,10
48054,0,0,5,11,16
48055,0,0,3,17,20
48056,0,1,9,40,50
48057,0,0,2,8,10
48058,0,0,3,13,16
48059,0,0,8,16,24
48060,0,0,7,10,17
48061,1,0,8,9,18
48062,0,1,3,14,18
48063,0,0,8,13,21
48064,0,0,11,39,50
48065,0,0,7,28,35
48066,0,0,3,2,5
48067,0,0,7,14,21
48068,0,1,2,12,15
48069,0,0,1,3,4
48070,0,0,15,15,30
48071,0,0,7,6,13
48072,0,0,5,7,12
48073,0,0,2,21,23
48074,0,0,2,7,9
48075,0,0,2,6,8
48076,0,0,7,7,14
48077,0,0,2,9,11
48078,0,0,3,7,10
48079,0,0,4,6,10
48080,0,0,3,13,16
48081,0,0,14,30,44
48082,0,0,12,34,46
48083,0,0,4,14,18
48084,0,0,0,4,4
48085,0,0,0,6,6
48088,0,0,7,2,9
48089,0,0,11,9,20
48090,0,0,1,7,8
48091,0,0,4,8,12
48092,0,0,5,10,15
48093,0,0,4,11,15
48094,0,0,10,13,23
48095,0,0,8,12,20
48096,0,0,1,12,13
48097,0,0,6,17,23
48098,0,0,9,16,25
48099,0,0,5,14,19
48100,0,1,12,25,38
48101,0,0,9,16,25
48102,0,1,12,12,25
48103,0,0,6,14,20
48104,0,0,7,25,32
48105,0,0,4,16,20
48106,0,0,4,13,17
48107,0,0,3,9,12
48108,0,0,2,9,11
48109,0,0,7,9,16
48110,0,0,5,16,21
48111,0,1,2,15,18
48112,0,0,0,7,7
48113,0,0,5,16,21
48114,0,0,5,12,17
48115,0,1,3,12,16
48117,0,0,8,8,16
48118,0,0,6,14,20
48119,0,0,1,0,1
48120,0,0,8,10,18
48121,0,0,9,17,26
48122,0,0,3,12,15
48123,0,0,6,13,19
48124,0,0,4,5,9
48125,0,0,6,31,37
48126,0,0,2,3,5
48128,1,0,0,16,17
48129,0,0,6,16,22
48130,0,0,4,8,12
48131,0,0,3,24,27
48132,0,0,7,10,17
48133,0,0,1,6,7
48134,0,0,3,25,28
48135,0,1,10,38,49
48136,0,0,0,14,14
48137,0,0,1,6,7
48138,0,3,7,21,31
48139,0,0,1,15,16
48140,0,0,7,12,19
48141,0,2,1,6,9
48142,0,0,5,10,15
48143,0,1,4,25,30
48144,0,0,2,9,11
48145,0,0,14,19,33
48146,0,0,11,24,35
48147,0,0,4,4,8
48148,0,3,12,26,41
48149,0,1,0,7,8
48150,0,0,9,17,26
48151,0,0,8,3,11
48152,0,0,6,15,21
48153,0,0,5,6,11
48154,1,0,10,23,34
48155,0,0,5,9,14
48156,0,0,7,11,18
48157,0,0,8,5,13
48158,0,0,12,30,42
48159,0,0,9,12,21
48160,0,0,5,14,19
48161,0,2,4,11,17
48164,0,0,3,5,8
48167,0,0,4,10,14
48168,0,0,4,4,8
48169,0,1,15,10,26
48170,0,1,7,36,44
48171,0,0,10,14,24
48172,0,0,1,6,7
48173,0,0,5,6,11
48174,0,0,5,2,7
48175,0,0,2,0,2
48176,0,0,2,7,9
48177,0,0,3,17,20
48178,0,0,2,17,19
48179,0,4,7,13,24
48180,0,0,7,23,30
48181,0,1,7,17,25
48182,0,1,7,12,20
48184,0,0,2,3,5
48185,0,0,2,1,3
48186,0,1,10,20,31
48188,0,1,7,17,25
48189,0,0,13,31,44
48190,0,1,5,34,40
48191,0,1,7,30,38
48192,0,1,10,31,42
48193,0,0,0,8,8
48194,0,0,7,16,23
48197,0,0,1,6,7
48198,0,0,10,17,27
48199,0,0,4,13,17
48200,0,0,3,5,8
48201,0,0,5,20,25
48202,0,0,2,21,23
48203,0,0,1,4,5
48204,0,0,10,12,22
48205,0,0,9,20,29
48206,0,0,2,4,6
48207,0,0,1,4,5
48208,0,1,7,20,28
48209,0,0,11,36,47
48210,0,0,4,4,8
48211,0,0,6,7,13
48212,3,4,0,13,20
48213,0,0,7,19,26
48214,1,0,5,6,12
48215,0,0,3,4,7
48217,0,0,1,4,5
48218,0,0,3,9,12
48219,0,0,9,32,41
48220,0,0,8,15,23
48221,0,2,14,33,49
48222,0,0,7,15,22
48223,0,1,6,13,20
48224,1,1,3,17,22
48225,0,0,6,9,15
48226,0,1,3,4,8
48227,0,0,4,7,11
48228,1,0,8,19,28
48229,0,1,9,12,22
48230,0,0,9,17,26
48231,0,1,7,32,40
48232,0,0,5,15,20
48233,0,0,11,16,27
48235,0,0,6,6,12
48236,1,1,4,4,10
48239,0,0,2,3,5
48240,0,0,0,4,4
48241,0,1,10,35,46
48242,0,0,3,21,24
48243,0,0,7,13,20
48245,0,0,2,6,8
48247,0,0,1,4,5
48248,0,0,2,12,14
48249,0,0,1,4,5
48250,0,0,1,4,5
48251,0,2,2,21,25
48252,0,0,6,11,17
48256,1,0,1,11,13
48258,4,1,2,27,34
48259,0,1,9,37,47
48260,0,0,1,3,4
48261,0,0,3,2,5
48262,0,0,12,14,26
48263,1,0,5,16,22
48264,0,0,1,2,3
48265,0,0,5,13,18
48266,0,0,3,8,11
48267,0,1,3,20,24
48268,0,0,4,5,9
48269,0,1,3,5,9
48270,0,0,0,2,2
48271,0,1,5,7,13
48272,1,1,11,11,24
48273,0,0,4,6,10
48274,0,1,5,9,15
48275,0,0,3,11,14
48276,0,0,1,11,12
48277,0,0,5,14,19
48278,0,0,8,25,33
48279,0,1,7,29,37
48280,0,0,1,0,1
48281,1,2,5,42,50
48283,0,0,3,4,7
48285,0,0,13,24,37
48286,0,1,4,21,26
48287,0,0,1,20,21
48288,0,0,11,23,34
48289,0,0,17,33,50
48290,0,0,14,31,45
48291,0,0,12,38,50
48292,0,2,2,21,25
48293,0,0,4,16,20
48294,0,0,1,9,10
48295,0,1,6,24,31
48296,0,3,13,24,40
48297,1,0,10,37,48
48298,0,0,7,40,47
48299,0,0,2,38,40
48300,0,0,7,11,18
48301,1,0,15,34,50
48302,0,0,8,23,31
48303,0,1,4,7,12
48304,0,0,6,21,27
48305,0,0,12,28,40
48306,0,0,8,7,15
48307,0,2,8,37,47
48308,0,1,9,23,33
48309,0,0,10,27,37
48310,0,0,3,13,16
48311,0,0,8,18,26
48312,0,1,14,35,50
48313,0,0,13,23,36
48314,0,0,6,26,32
48315,0,0,13,30,43
48316,1,1,10,30,42
48317,0,0,1,17,18
48318,0,1,11,20,32
48319,0,0,1,39,40
48320,0,0,8,9,17
48321,0,2,2,38,42
48322,0,0,11,21,32
48323,0,0,6,13,19
48324,0,1,8,17,26
48325,0,0,19,23,42
48326,0,0,4,9,13
48327,0,0,11,35,46
48328,0,0,5,12,17
48329,0,8,2,40,50
48330,0,1,7,21,29
48331,0,3,7,14,24
48332,1,0,3,35,39
48333,0,0,7,11,18
48334,0,0,13,24,37
48335,0,0,9,11,20
48336,0,0,0,6,6
48337,0,1,9,37,47
48338,1,0,5,16,22
48339,0,0,4,15,19
48340,0,1,6,16,23
48341,0,0,7,20,27
48342,0,1,12,37,50
48343,0,0,3,2,5
48344,1,0,2,12,15
48345,0,0,1,15,16
48346,1,0,4,11,16
48347,0,0,1,4,5
48348,0,0,15,30,45
48349,0,0,8,19,27
48350,0,2,3,14,19
48351,0,0,10,39,49
48352,0,1,13,36,50
48353,0,0,4,17,21
48354,0,0,1,12,13
48355,0,0,2,18,20
48356,0,1,10,29,40
48357,0,0,0,17,17
48358,0,0,4,11,15
48359,0,0,1,6,7
48360,0,0,10,15,25
48361,0,0,7,12,19
48362,2,1,2,16,21
48363,0,0,0,3,3
48365,0,0,6,17,23
48366,0,0,1,16,17
48367,0,0,4,20,24
48368,0,0,6,9,15
48369,0,1,17,30,48
48370,0,0,5,7,12
48371,2,1,7,34,44
48372,1,0,6,20,27
48373,0,0,1,24,25
48374,0,0,2,6,8
48375,0,0,1,3,4
48376,0,1,4,23,28
48377,0,0,4,7,11
48378,0,0,1,18,19
48379,0,0,9,21,30
48380,0,0,9,9,18
48381,0,0,2,13,15
48382,0,0,2,3,5
48383,0,2,13,31,46
48384,0,0,1,10,11
48385,0,0,10,40,50
48386,0,0,3,6,9
48387,0,0,3,9,12
48388,0,0,4,6,10
48389,1,0,4,20,25
48390,0,0,15,35,50
48391,0,1,13,29,43
48392,0,0,14,27,41
48393,1,0,15,17,33
48394,0,0,5,18,23
48395,0,0,3,4,7
48397,0,0,12,14,26
48398,0,0,16,27,43
48399,0,0,8,25,33
48400,0,0,11,39,50
48401,0,0,3,10,13
48402,0,0,4,6,10
48403,4,1,2,27,34
48404,0,0,1,2,3
48405,1,2,5,42,50
48406,0,4,10,36,50
48407,0,0,1,17,18
48408,1,1,11,11,24
48409,0,1,7,29,37
48410,3,4,0,13,20
48411,3,1,6,22,32
48413,0,0,1,11,12
48414,0,1,3,5,9
48415,1,0,4,10,15
48417,1,0,2,12,15
48418,0,1,13,29,43
48419,0,0,2,7,9
48421,0,0,9,26,35
48422,1,2,2,27,32
48425,0,0,1,16,17
48426,0,1,4,23,28
48427,1,0,11,20,32
48428,0,0,1,3,4
48429,0,0,3,4,7
48430,0,0,10,12,22
48431,0,8,2,40,50
48432,0,0,0,2,2
48433,2,0,12,36,50
48434,0,0,9,18,27
48436,2,1,7,34,44
48437,0,8,2,40,50
48438,0,0,1,2,3
48439,1,2,5,42,50
48440,1,0,1,11,13
48441,0,8,2,40,50
48442,0,1,5,34,40
48443,0,0,10,15,25
48444,1,0,3,35,39
48445,0,0,5,7,12
48446,1,1,11,11,24
48447,0,0,3,3,6
48448,0,0,3,4,7
48449,0,1,5,9,15
48450,0,1,6,14,21
48451,0,0,1,4,5
48452,0,1,6,23,30
48453,0,0,5,14,19
48456,0,0,4,11,15
48457,0,1,3,10,14
48458,0,0,1,16,17
48459,0,0,4,29,33
48460,0,1,0,14,15
48461,0,0,12,38,50
48462,1,1,13,33,48
48463,0,2,0,18,20
48464,0,0,1,4,5
48465,0,1,7,25,33
48466,0,0,3,9,12
48467,0,0,1,9,10
48468,4,1,2,27,34
48469,0,0,0,17,17
48470,0,0,3,12,15
48471,0,1,0,6,7
48472,0,0,4,20,24
48473,0,0,2,17,19
48474,0,0,1,11,12
48475,0,0,4,1,5
48476,0,1,9,13,23
48478,0,1,10,17,28
48479,0,0,2,16,18
48481,0,0,1,14,15
48482,0,0,2,7,9
48483,0,0,16,21,37
48484,0,0,2,1,3
48485,0,0,7,13,20
48486,0,0,1,4,5
48490,0,0,0,6,6
48491,0,4,2,32,38
48492,0,0,0,8,8
48494,0,0,2,2,4
48496,0,0,6,12,18
48497,0,0,1,2,3
48498,0,0,5,9,14
48499,0,0,13,22,35
48500,0,0,0,5,5
48501,0,1,4,20,25
48502,0,0,3,4,7
48503,0,1,8,29,38
48505,0,0,0,10,10
48506,0,0,7,9,16
48507,0,0,1,7,8
48508,0,1,2,11,14
48509,0,3,2,36,41
48510,0,0,9,41,50
48511,1,0,10,25,36
48512,0,0,2,17,19
48513,0,0,3,8,11
48514,0,0,3,8,11
48516,0,1,2,15,18
48517,0,0,7,8,15
48518,0,0,0,11,11
48519,0,0,5,4,9
48520,0,0,11,18,29
48522,0,0,4,15,19
48523,0,1,6,10,17
48524,0,0,2,3,5
48527,0,0,2,15,17
48529,0,0,5,9,14
48530,0,0,5,17,22
48531,0,0,1,17,18
48532,0,0,3,17,20
48533,0,0,1,6,7
48534,0,0,7,26,33
48535,0,0,4,10,14
48536,0,0,9,19,28
48537,0,1,4,37,42
48538,0,0,6,7,13
48539,0,0,3,13,16
48540,0,0,2,5,7
48541,0,0,1,20,21
48542,0,0,6,3,9
48543,0,0,2,3,5
48544,0,0,21,29,50
48545,0,0,2,15,17
48546,0,0,7,17,24
48547,0,0,10,19,29
48548,0,1,0,6,7
48549,0,0,6,3,9
48550,0,0,12,15,27
48551,0,0,4,8,12
48552,0,0,8,12,20
48553,1,3,9,21,34
48554,0,0,4,7,11
48555,0,0,8,21,29
48556,0,1,6,14,21
48557,0,0,5,12,17
48558,0,1,5,10,16
48559,0,0,1,6,7
48560,0,1,2,7,10
48561,0,0,4,4,8
48562,0,1,4,4,9
48563,0,0,3,9,12
48564,0,0,5,4,9
48565,0,0,3,19,22
48566,0,0,2,4,6
48567,0,0,13,37,50
48568,0,2,3,14,19
48569,0,0,5,7,12
48570,0,0,1,6,7
48571,0,3,0,6,9
48572,0,0,10,21,31
48573,0,1,3,12,16
48576,0,2,2,18,22
48577,0,0,7,4,11
48578,0,0,1,7,8
48580,0,2,7,39,48
48581,0,0,1,4,5
48582,0,0,2,3,5
48583,0,0,5,6,11
48584,0,0,7,5,12
48585,0,0,0,12,12
48586,0,0,3,3,6
48587,0,0,14,18,32
48588,0,0,1,5,6
48589,0,1,1,4,6
48590,0,0,6,12,18
48591,0,0,17,16,33
48593,0,1,5,5,11
48594,0,1,6,10,17
48595,0,1,6,30,37
48596,0,0,6,7,13
48597,0,0,4,7,11
48598,0,0,1,9,10
48599,0,0,6,17,23
48600,0,0,3,9,12
48601,0,0,0,7,7
48602,0,1,5,17,23
48603,0,0,0,7,7
48604,0,0,3,18,21
48605,0,0,10,40,50
48606,0,0,4,11,15
48607,0,0,0,1,1
48608,0,0,5,4,9
48609,0,1,1,11,13
48610,0,2,5,28,35
48611,0,0,3,15,18
48612,0,0,6,17,23
48614,0,0,0,15,15
48615,0,0,9,11,20
48616,0,0,1,13,14
48617,0,0,5,10,15
48618,0,0,5,12,17
48619,0,0,6,11,17
48620,0,0,1,5,6
48621,0,1,4,19,24
48622,0,0,6,7,13
48623,0,0,5,8,13
48624,0,0,7,10,17
48625,0,2,5,19,26
48626,0,0,11,17,28
48627,0,2,9,35,46
48628,0,0,2,8,10
48629,0,0,3,1,4
48630,0,2,7,3,12
48631,0,1,10,24,35
48632,0,0,4,13,17
48633,0,0,12,27,39
48634,0,0,7,14,21
48635,0,1,5,10,16
48636,0,0,5,9,14
48637,0,0,1,3,4
48638,0,2,14,23,39
48639,1,0,5,37,43
48640,0,0,13,11,24
48641,0,0,5,12,17
48642,0,0,8,26,34
48643,0,1,4,21,26
48644,0,1,2,12,15
48645,0,0,0,11,11
48646,0,0,0,8,8
48647,0,0,3,2,5
48648,0,1,4,4,9
48649,0,0,14,20,34
48650,0,0,8,9,17
48651,0,0,3,8,11
48652,0,1,3,1,5
48653,0,0,5,3,8
48656,0,0,4,8,12
48657,0,0,5,11,16
48659,0,0,5,14,19
48661,0,0,3,17,20
48662,0,0,4,1,5
48663,0,1,5,17,23
48664,0,1,2,3,6
48665,0,0,2,1,3
48666,0,0,3,2,5
48667,0,0,4,5,9
48668,0,0,15,27,42
48669,1,2,9,22,34
48670,0,0,1,9,10
48671,0,0,3,2,5
48672,0,1,5,10,16
48673,1,0,1,12,14
48674,0,0,3,3,6
48675,0,0,2,2,4
48676,0,0,3,2,5
48677,0,0,3,6,9
48678,0,0,5,6,11
48679,0,0,11,3,14
48680,0,2,6,13,21
48681,0,0,1,4,5
48682,0,0,3,12,15
48683,0,0,2,5,7
48684,0,0,8,23,31
48685,0,0,1,6,7
48686,0,0,8,3,11
48687,0,0,0,6,6
48688,0,0,2,5,7
48689,0,0,4,4,8
48690,0,1,11,17,29
48691,0,0,4,7,11
48692,0,0,3,12,15
48693,0,0,1,17,18
48694,0,0,1,11,12
48695,0,1,4,7,12
48696,0,0,7,11,18
48697,0,3,16,31,50
48698,0,0,0,10,10
48699,0,1,3,3,7
48700,0,0,2,4,6
48702,0,0,1,5,6
48703,0,0,1,7,8
48704,0,0,2,3,5
48705,0,0,0,1,1
48706,0,0,2,7,9
48712,0,0,0,5,5
48713,0,0,3,4,7
48716,0,3,7,25,35
48718,0,1,6,14,21
48719,1,2,10,28,41
48720,1,0,11,22,34
48721,0,0,3,3,6
48722,0,0,2,1,3
48725,0,2,7,12,21
48726,1,0,13,31,45
48727,0,1,1,7,9
48728,0,1,5,9,15
48729,1,1,11,11,24
48730,0,0,3,4,7
48732,0,0,11,19,30
48733,0,0,16,32,48
48734,0,0,3,7,10
48735,0,1,4,8,13
48736,0,2,0,10,12
48737,0,0,1,5,6
48738,0,0,1,4,5
48739,0,1,2,29,32
48740,1,0,11,22,34
48741,0,1,2,14,17
48742,0,1,3,16,20
48743,0,0,6,10,16
48744,0,0,8,10,18
48745,0,1,5,4,10
48746,0,0,1,4,5
48747,0,1,13,23,37
48748,0,0,3,4,7
48750,1,3,0,6,10
48751,0,0,2,22,24
48752,0,0,0,4,4
48753,0,0,16,28,44
48754,0,0,9,41,50
48755,0,0,2,26,28
48756,0,1,11,28,40
48757,0,3,5,11,19
48758,0,0,7,7,14
48759,0,0,10,29,39
48760,1,1,5,38,45
48761,0,0,2,3,5
48762,0,0,0,5,5
48763,1,1,15,33,50
48764,1,0,11,30,42
48765,0,2,3,13,18
48766,0,0,13,11,24
48767,0,0,2,6,8
48768,0,1,7,12,20
48769,0,1,8,28,37
48770,0,2,4,17,23
48771,0,0,7,7,14
48772,0,1,10,22,33
48773,0,1,2,17,20
48774,0,0,9,17,26
48775,0,3,7,25,35
48777,0,2,4,40,46
48778,3,0,5,12,20
48779,0,1,6,12,19
48780,0,0,10,2,12
48781,0,0,6,12,18
48782,0,0,2,13,15
48784,0,0,16,34,50
48785,0,0,1,9,10
48786,0,2,5,19,26
48787,0,0,2,4,6
48788,0,0,8,9,17
48789,0,1,10,24,35
48791,0,0,3,24,27
48792,1,0,3,8,12
48793,1,1,6,25,33
48794,0,1,6,23,30
48795,0,2,8,31,41
48796,0,0,1,5,6
48797,0,1,13,28,42
48798,0,0,2,8,10
48800,0,0,3,6,9
48802,0,0,3,2,5
48803,0,2,7,12,21
48804,0,0,2,7,9
48805,0,0,2,3,5
48807,0,0,3,1,4
48808,1,1,11,11,24
48809,4,1,2,27,34
48810,0,0,5,9,14
48811,0,0,1,17,18
48812,1,0,13,31,45
48813,2,2,2,33,39
48814,0,1,3,34,38
48815,0,1,14,35,50
48816,0,0,2,26,28
48817,1,2,10,28,41
48818,0,1,3,21,25
48819,0,0,4,18,22
48820,1,0,0,7,8
48821,0,0,1,9,10
48822,0,0,0,3,3
48823,1,3,0,6,10
48824,1,1,15,33,50
48825,0,2,4,43,49
48826,0,0,2,4,6
48827,0,0,2,26,28
48828,0,1,6,23,30
48829,0,0,2,16,18
48830,0,0,2,3,5
48831,1,3,0,6,10
48832,1,1,11,11,24
48833,0,0,3,3,6
48834,0,0,5,5,10
48835,1,0,4,28,33
48836,0,0,11,39,50
48837,0,0,8,19,27
48838,0,0,7,21,28
48839,0,1,18,26,45
48840,0,0,1,0,1
48841,0,0,8,10,18
48842,0,0,6,13,19
48843,0,0,4,13,17
48844,0,0,10,11,21
48845,0,0,0,9,9
48846,0,0,0,7,7
48847,1,0,7,5,13
48848,0,0,2,5,7
48849,0,0,4,8,12
48850,0,0,11,16,27
48851,2,0,4,15,21
48852,0,1,12,16,29
48853,0,0,13,22,35
48854,0,0,10,21,31
48856,0,0,4,13,17
48857,0,0,8,10,18
48858,0,0,4,10,14
48859,0,1,4,41,46
48860,0,0,1,12,13
48861,0,0,4,19,23
48862,0,0,5,17,22
48863,0,0,2,7,9
48864,0,0,13,22,35
48865,0,0,0,6,6
48866,1,0,1,48,50
48867,0,0,1,6,7
48868,0,0,3,6,9
48869,0,0,5,4,9
48870,0,0,2,2,4
48871,0,2,17,16,35
48872,0,0,9,15,24
48873,0,0,1,6,7
48874,0,0,8,10,18
48875,0,0,3,3,6
48876,1,0,7,16,24
48877,0,0,1,7,8
48878,0,2,6,30,38
48879,0,0,13,9,22
48880,1,0,11,22,34
48882,0,0,1,8,9
48883,0,2,17,31,50
48884,1,1,8,26,36
48885,0,3,12,30,45
48886,0,2,2,19,23
48887,0,1,17,32,50
48889,0,1,4,33,38
48890,0,0,6,6,12
48891,1,0,10,17,28
48892,0,0,7,2,9
48893,1,0,3,13,17
48894,0,0,5,15,20
48895,0,0,7,11,18
48896,0,0,6,18,24
48897,0,0,13,7,20
48898,0,0,5,17,22
48899,0,0,5,20,25
48900,0,0,5,23,28
48902,0,0,4,8,12
48903,0,0,12,23,35
48904,0,0,2,11,13
48905,0,0,3,3,6
48906,1,0,8,18,27
48907,0,1,14,16,31
48908,0,0,14,27,41
48909,0,0,3,3,6
48910,0,1,9,29,39
48911,0,0,2,3,5
48912,0,0,3,12,15
48913,0,0,2,6,8
48914,0,0,10,25,35
48915,1,0,2,14,17
48916,0,3,9,24,36
48917,0,0,5,13,18
48918,0,0,5,8,13
48919,0,1,6,20,27
48920,0,0,1,5,6
48921,0,0,13,22,35
48922,1,0,6,17,24
48923,0,1,12,35,48
48924,0,0,1,25,26
48925,0,0,1,6,7
48926,0,0,6,7,13
48927,0,0,4,5,9
48928,0,0,6,12,18
48929,0,0,2,0,2
48930,0,1,10,8,19
48931,0,1,9,3,13
48932,0,0,4,8,12
48933,0,0,5,13,18
48934,0,4,4,18,26
48935,0,0,4,21,25
48936,0,0,0,7,7
48937,0,0,5,10,15
48938,0,0,4,13,17
48939,0,0,5,0,5
48940,1,0,11,34,46
48942,0,0,1,3,4
48943,0,0,7,15,22
48944,0,0,4,6,10
48945,1,0,15,31,47
48946,1,0,5,10,16
48947,0,0,1,3,4
48948,0,0,3,2,5
48949,0,0,5,32,37
48950,0,0,2,7,9
48951,0,0,0,15,15
48952,0,0,1,8,9
48955,0,0,0,7,7
48956,0,1,8,24,33
48957,0,0,1,6,7
48958,0,1,9,17,27
48959,0,0,2,5,7
48961,0,0,14,36,50
48962,0,0,4,25,29
48963,0,1,1,7,9
48964,0,0,0,9,9
48965,0,0,8,15,23
48966,1,0,2,7,10
48967,0,1,5,9,15
48968,1,2,0,19,22
48969,0,1,7,9,17
48970,0,0,2,13,15
48971,0,0,5,15,20
48972,0,0,0,3,3
48973,0,0,2,17,19
48975,0,0,0,5,5
48976,0,1,4,16,21
48977,0,2,8,24,34
48980,0,0,3,12,15
48981,0,0,11,24,35
48982,3,0,2,5,10
48983,0,2,3,8,13
48984,0,1,1,1,3
48985,0,0,1,10,11
48986,0,4,18,28,50
48987,0,0,2,3,5
48988,0,0,9,8,17
48989,0,1,4,5,10
48990,0,0,14,31,45
48991,0,1,6,14,21
48992,1,3,12,27,43
48993,1,1,11,11,24
48994,1,2,5,42,50
48995,0,0,2,5,7
48996,0,0,0,8,8
48997,0,2,10,27,39
48998,1,0,1,2,4
48999,0,0,3,10,13
49000,0,0,6,14,20
49001,0,0,7,43,50
49002,1,0,3,18,22
49003,1,0,4,28,33
49004,0,0,5,12,17
49005,0,0,9,19,28
49006,0,0,4,16,20
49007,0,0,8,19,27
49009,0,0,6,12,18
49010,0,0,1,18,19
49011,0,0,9,17,26
49012,0,0,9,24,33
49013,0,0,10,30,40
49014,0,0,10,32,42
49015,0,1,4,24,29
49016,0,0,8,7,15
49017,0,2,7,41,50
49018,0,1,11,38,50
49019,0,1,9,40,50
49020,0,0,11,20,31
49021,0,0,1,10,11
49022,0,4,18,28,50
49023,0,0,16,18,34
49024,0,0,11,17,28
49025,0,1,12,16,29
49026,0,0,9,23,32
49027,1,0,4,42,47
49028,0,0,20,30,50
49029,0,0,7,14,21
49030,1,1,3,9,14
49031,0,0,6,36,42
49032,0,1,6,35,42
49033,0,0,10,38,48
49034,0,0,5,16,21
49035,0,0,8,28,36
49036,0,1,10,10,21
49037,0,0,17,33,50
49038,0,1,6,10,17
49039,0,1,9,36,46
49040,0,0,7,26,33
49041,1,1,6,38,46
49042,0,0,1,17,18
49043,1,2,1,9,13
49044,0,0,9,19,28
49045,2,0,1,6,9
49046,1,0,1,9,11
49047,0,0,1,12,13
49048,0,0,5,9,14
49050,0,0,2,12,14
49051,0,0,13,26,39
49052,0,0,7,9,16
49053,0,0,5,11,16
49054,0,0,1,12,13
49055,0,0,8,13,21
49056,1,0,2,12,15
49057,0,0,3,4,7
49058,0,0,4,11,15
49059,0,0,2,8,10
49060,0,0,3,9,12
49061,0,0,2,19,21
49062,0,0,18,27,45
49063,1,0,11,34,46
49064,0,0,5,16,21
49065,0,0,1,10,11
49066,2,1,4,19,26
49067,1,1,4,44,50
49068,0,1,5,14,20
49070,0,0,1,3,4
49071,0,0,4,6,10
49072,0,0,2,5,7
49073,1,0,4,45,50
49074,0,0,0,8,8
49076,0,0,5,15,20
49077,0,0,1,12,13
49078,0,1,5,14,20
49079,0,0,1,16,17
49080,1,0,11,27,39
49081,0,0,3,7,10
49082,0,2,1,15,18
49083,0,0,7,21,28
49084,0,1,14,35,50
49085,0,0,14,31,45
49086,0,0,2,3,5
49087,1,3,12,27,43
49088,0,0,4,15,19
49089,3,1,6,22,32
49090,1,0,1,12,14
49091,0,1,1,11,13
49092,0,1,6,14,21
49093,0,0,4,12,16
49094,0,0,5,23,28
49095,0,0,5,6,11
49096,0,0,3,3,6
49097,1,1,11,11,24
49098,0,0,9,8,17
49099,0,0,1,17,18
49100,1,2,5,42,50
49101,0,0,5,10,15
49102,0,2,10,27,39
49103,0,0,0,15,15
49104,0,0,4,25,29
49105,0,0,1,8,9
49106,1,0,1,2,4
49107,0,1,1,1,3
49109,1,0,8,23,32
49110,0,2,1,15,18
49111,0,0,2,11,13
49112,1,1,6,38,46
49113,0,0,0,15,15
49114,0,0,1,14,15
49115,1,0,2,12,15
49116,1,0,4,15,20
49117,0,0,2,8,10
49118,1,0,1,2,4
49119,0,0,1,10,11
49120,0,0,4,10,14
49121,0,0,3,4,7
49122,1,0,4,45,50
49123,0,0,2,5,7
49124,0,0,5,23,28
49125,0,1,14,35,50
49126,0,0,6,12,18
49127,0,0,2,3,5
49128,0,2,7,41,50
49129,1,0,1,2,4
49130,0,1,1,11,13
49131,0,0,5,6,11
49132,0,0,1,12,13
49133,1,0,1,48,50
49134,1,2,5,42,50
49135,0,0,3,6,9
49136,0,0,7,14,21
49137,1,0,4,45,50
49138,0,0,1,6,7
49139,0,0,4,4,8
49141,1,0,2,19,22
49142,0,0,2,13,15
49143,0,1,13,15,29
49144,0,0,8,26,34
49146,0,0,2,13,15
49147,0,0,6,6,12
49148,0,1,3,13,17
49149,0,0,23,27,50
49150,10,3,3,32,48
49151,0,3,13,32,48
49152,10,3,3,32,48
49153,0,0,23,27,50
49154,0,3,13,32,48
49155,0,1,7,20,28
49156,0,3,13,32,48
49157,0,3,13,32,48
49158,1,5,6,22,34
49159,0,0,4,16,20
49160,0,0,2,8,10
49161,0,0,3,13,16
49162,0,0,2,12,14
49163,0,0,3,2,5
49164,0,0,3,9,12
49165,0,1,4,10,15
49166,0,0,4,9,13
49167,0,0,2,4,6
49168,0,1,3,5,9
49169,0,3,0,4,7
49170,0,5,10,18,33
49171,0,2,8,16,26
49172,0,0,7,20,27
49173,0,0,5,9,14
49174,0,0,2,12,14
49175,0,3,6,16,25
49176,0,0,0,10,10
49177,0,0,1,4,5
49178,0,2,7,19,28
49180,0,3,2,5,10
49181,0,0,6,8,14
49182,0,0,3,9,12
49183,0,0,3,4,7
49184,0,0,2,1,3
49185,0,0,1,4,5
49186,0,0,6,14,20
49187,0,0,4,10,14
49188,0,1,6,20,27
49189,0,0,8,20,28
49190,0,1,1,43,45
49191,0,0,3,27,30
49192,0,0,6,6,12
49193,0,1,15,30,46
49194,0,0,2,4,6
49195,0,0,3,24,27
49196,0,0,15,32,47
49197,0,0,8,4,12
49198,0,0,14,20,34
49199,0,0,8,19,27
49200,0,2,8,24,34
49201,0,3,4,34,41
49202,0,0,9,17,26
49203,1,0,5,13,19
49204,0,0,6,7,13
49205,0,0,3,9,12
49206,0,0,13,22,35
49207,0,0,5,5,10
49208,0,1,1,4,6
49209,0,0,8,5,13
49210,1,1,3,23,28
49211,0,1,10,27,38
49212,0,0,5,3,8
49213,0,0,3,9,12
49214,0,0,5,4,9
49215,0,0,9,5,14
49216,0,0,5,3,8
49217,0,7,0,10,17
49218,0,0,4,7,11
49219,0,0,5,6,11
49220,0,1,5,13,19
49221,0,0,0,5,5
49222,0,0,13,17,30
49223,0,0,7,17,24
49224,0,0,4,11,15
49225,0,0,5,10,15
49227,0,0,10,29,39
49228,0,0,6,13,19
49229,0,0,5,1,6
49231,0,3,4,14,21
49232,0,0,13,35,48
49233,0,2,10,37,49
49234,0,3,3,14,20
49235,0,0,7,22,29
49236,1,0,15,20,36
49237,0,0,3,2,5
49238,0,0,9,8,17
49240,0,0,10,35,45
49241,1,0,11,21,33
49242,0,0,2,11,13
49243,0,4,4,7,15
49244,0,0,3,2,5
49245,0,1,3,1,5
49246,0,1,5,7,13
49247,0,0,2,11,13
49248,0,6,8,23,37
49249,1,2,3,14,20
49250,0,0,13,21,34
49251,3,1,2,24,30
49252,2,2,0,9,13
49253,0,0,5,8,13
49254,0,0,5,5,10
49255,0,2,6,6,14
49256,0,2,7,8,17
49258,0,0,14,18,32
49259,0,1,13,35,49
49260,0,1,4,9,14
49261,0,0,3,4,7
49263,0,0,0,10,10
49264,0,0,2,8,10
49265,0,0,0,3,3
49267,0,3,13,32,48
49268,0,0,8,20,28
49269,0,0,0,5,5
49270,0,0,4,9,13
49271,0,0,2,12,14
49272,0,0,3,1,4
49273,0,0,3,9,12
49274,0,1,3,8,12
49275,0,0,11,23,34
49276,0,1,4,10,15
49277,0,0,2,9,11
49278,0,1,0,5,6
49279,0,0,3,13,16
49281,0,0,7,12,19
49282,0,0,1,17,18
49283,0,0,4,16,20
49284,0,0,10,31,41
49285,2,0,13,30,45
49286,0,0,5,15,20
49287,0,2,7,40,49
49288,0,0,18,21,39
49289,1,1,8,17,27
49290,0,0,6,5,11
49291,0,0,5,6,11
49292,0,0,13,34,47
49293,0,0,8,19,27
49294,0,0,3,11,14
49295,0,0,7,15,22
49296,2,0,2,14,18
49297,0,0,4,14,18
49298,0,0,3,15,18
49299,0,0,19,30,49
49300,0,5,9,12,26
49301,0,0,6,10,16
49302,0,0,3,13,16
49303,0,0,5,11,16
49304,3,2,5,40,50
49305,0,1,13,35,49
49306,0,0,13,37,50
49307,0,3,13,32,48
49308,0,0,2,8,10
49309,0,0,4,10,14
49310,1,0,3,35,39
49311,0,1,3,5,9
49312,0,0,5,3,8
49313,1,0,6,5,12
49314,0,2,4,21,27
49315,0,1,0,5,6
49316,0,1,9,20,30
49317,0,0,8,20,28
49318,0,0,7,12,19
49319,0,0,13,35,48
49320,0,0,0,5,5
49321,0,0,13,30,43
49322,1,0,10,14,25
49323,0,1,5,25,31
49324,0,0,6,18,24
49325,0,0,3,1,4
49326,0,2,7,40,49
49327,0,5,9,12,26
49328,0,1,9,20,30
49329,3,2,5,40,50
49330,0,0,3,15,18
49331,0,1,0,5,6
49332,1,0,10,14,25
49333,0,3,13,32,48
49334,0,4,4,7,15
49335,0,0,13,30,43
49336,0,0,5,3,8
49337,0,1,1,4,6
49338,0,3,13,32,48
49339,0,0,4,10,14
49340,0,0,1,4,5
49341,0,0,1,10,11
49342,0,0,14,25,39
49343,0,0,13,37,50
49344,0,0,7,14,21
49345,0,0,8,20,28
49346,0,2,4,11,17
49347,1,2,10,25,38
49348,0,0,3,7,10
49349,0,0,6,4,10
49350,0,2,7,40,49
49351,0,0,2,9,11
49352,0,0,8,19,27
49353,0,1,1,43,45
49354,0,1,8,22,31
49355,0,0,6,10,16
49356,0,1,9,20,30
49357,0,2,8,16,26
49358,0,1,3,5,9
49359,1,0,3,35,39
49360,0,0,11,23,34
49361,0,1,4,10,15
49362,0,0,5,11,16
49363,0,2,4,21,27
49364,0,3,3,14,20
49365,1,0,6,5,12
49366,0,0,5,4,9
49367,0,0,2,3,5
49368,0,0,8,22,30
49369,0,2,10,38,50
49370,0,0,1,3,4
49371,0,0,2,12,14
49372,0,0,3,17,20
49373,0,0,3,2,5
49374,0,1,1,15,17
49375,0,0,0,5,5
49376,0,0,0,8,8
49377,0,0,3,13,16
49378,0,0,10,18,28
49379,0,0,3,10,13
49380,0,0,11,22,33
49381,0,2,10,12,24
49382,0,0,4,7,11
49383,0,0,11,24,35
49384,0,1,7,6,14
49385,0,0,7,7,14
49386,0,9,6,18,33
49387,0,0,5,23,28
49388,0,1,3,4,8
49389,0,0,5,14,19
49390,0,3,16,31,50
49391,0,0,2,10,12
49392,0,2,4,19,25
49393,0,0,0,5,5
49394,1,0,0,15,16
49395,0,0,0,6,6
49396,0,0,4,16,20
49397,0,2,12,20,34
49398,0,0,6,7,13
49399,0,0,7,12,19
49400,0,3,3,13,19
49401,0,0,9,17,26
49402,0,3,5,34,42
49403,0,0,20,29,49
49404,0,0,7,12,19
49405,0,0,0,13,13
49406,0,0,5,12,17
49407,0,0,9,13,22
49408,0,0,7,8,15
49410,0,2,6,27,35
49411,0,0,5,6,11
49412,0,0,1,6,7
49413,0,0,11,16,27
49414,0,0,15,21,36
49415,0,0,10,14,24
49416,0,1,7,19,27
49417,0,0,4,22,26
49418,0,0,8,18,26
49419,0,1,11,26,38
49420,0,1,12,15,28
49421,0,1,5,11,17
49423,0,0,8,26,34
49424,0,0,2,9,11
49425,0,0,4,2,6
49426,0,0,3,8,11
49427,0,0,4,14,18
49428,0,1,3,9,13
49429,0,0,9,18,27
49430,1,2,10,35,48
49432,0,0,0,4,4
49433,0,0,10,6,16
49434,0,0,1,8,9
49435,0,1,6,17,24
49436,0,0,5,2,7
49437,0,0,1,12,13
49438,0,0,2,6,8
49439,0,0,5,9,14
49440,0,0,20,24,44
49441,0,0,4,10,14
49442,0,0,2,9,11
49443,0,0,9,16,25
49444,0,0,9,10,19
49445,0,0,2,8,10
49446,0,0,3,11,14
49447,0,0,1,8,9
49448,0,0,5,28,33
49449,0,8,0,14,22
49450,0,0,10,12,22
49451,0,0,8,9,17
49452,2,1,15,31,49
49453,0,0,2,9,11
49454,0,0,10,19,29
49455,0,0,11,14,25
49456,0,0,2,10,12
49457,0,0,4,10,14
49458,0,0,4,19,23
49459,0,0,5,18,23
49460,0,0,6,7,13
49461,0,0,4,4,8
49462,0,0,2,9,11
49463,0,1,1,20,22
49464,0,0,0,5,5
49465,0,1,3,8,12
49466,0,0,2,14,16
49467,0,0,4,6,10
49468,0,1,7,31,39
49469,0,0,1,4,5
49470,0,0,6,2,8
49471,1,0,5,5,11
49472,0,0,7,12,19
49473,0,0,7,26,33
49474,0,0,5,6,11
49475,0,0,2,5,7
49476,0,0,11,7,18
49477,0,0,2,4,6
49478,0,0,5,5,10
49479,0,0,3,5,8
49480,0,0,8,16,24
49481,0,2,13,21,36
49482,0,0,11,9,20
49484,0,1,12,24,37
49486,0,0,4,1,5
49487,0,0,3,12,15
49488,0,0,9,12,21
49489,0,1,0,5,6
49490,0,0,2,4,6
49491,1,0,4,14,19
49492,0,0,6,9,15
49493,0,0,7,9,16
49494,1,0,7,13,21
49495,0,0,2,6,8
49496,0,0,6,11,17
49497,0,0,10,28,38
49498,0,0,7,4,11
49499,0,0,6,3,9
49500,0,0,9,21,30
49501,0,1,5,4,10
49502,0,0,4,8,12
49503,0,0,9,18,27
49504,0,1,1,3,5
49505,0,0,3,5,8
49506,0,0,8,17,25
49507,0,0,11,31,42
49508,0,1,1,28,30
49509,0,0,7,17,24
49510,0,0,6,8,14
49511,0,0,7,13,20
49512,0,0,5,11,16
49513,0,0,0,14,14
49514,0,0,9,3,12
49515,0,0,4,4,8
49516,0,0,3,3,6
49517,0,0,6,6,12
49518,0,0,8,22,30
49519,0,1,5,9,15
49520,0,0,4,10,14
49521,0,2,10,38,50
49522,0,0,7,13,20
49523,0,0,9,26,35
49524,0,0,2,4,6
49525,0,0,4,1,5
49526,0,0,3,12,15
49527,0,0,8,9,17
49528,0,0,6,12,18
49529,0,0,1,4,5
49530,0,0,18,14,32
49531,0,0,9,24,33
49532,0,0,12,21,33
49533,1,0,10,20,31
49534,0,0,4,9,13
49536,1,1,3,20,25
49537,0,0,6,17,23
49538,0,0,1,7,8
49540,0,2,2,6,10
49541,0,0,3,8,11
49542,1,0,1,21,23
49543,0,0,3,5,8
49544,0,0,3,7,10
49545,0,0,6,11,17
49546,0,1,0,8,9
49547,0,0,2,9,11
49548,0,4,6,17,27
49549,0,0,5,11,16
49550,0,1,4,11,16
49551,0,0,8,14,22
49552,0,0,1,9,10
49553,0,0,7,14,21
49554,0,0,2,3,5
49555,0,0,2,14,16
49556,0,0,7,6,13
49557,0,0,2,6,8
49558,0,1,12,37,50
49559,0,2,13,30,45
49560,0,1,6,5,12
49561,0,2,7,20,29
49562,0,0,3,7,10
49563,0,0,4,15,19
49564,0,1,4,16,21
49565,0,0,6,7,13
49566,0,0,5,10,15
49567,0,0,4,9,13
49568,0,1,4,13,18
49569,0,0,8,6,14
49570,0,0,7,11,18
49571,0,0,2,6,8
49572,0,0,3,2,5
49573,0,0,2,12,14
49574,0,0,2,8,10
49575,0,1,16,25,42
49576,0,5,16,29,50
49577,0,0,4,9,13
49578,0,0,3,6,9
49579,0,0,5,10,15
49580,0,0,8,20,28
49581,0,0,3,13,16
49582,0,0,2,5,7
49583,1,0,11,17,29
49585,0,1,8,6,15
49586,0,0,12,29,41
49587,0,0,11,34,45
49588,0,0,9,26,35
49589,0,0,6,4,10
49590,0,0,5,8,13
49591,0,0,9,15,24
49592,0,0,3,15,18
49594,0,0,3,2,5
49595,0,1,5,14,20
49596,0,0,6,13,19
49598,0,0,6,5,11
49599,0,0,8,15,23
49600,0,1,18,24,43
49601,2,2,0,9,13
49602,0,0,4,4,8
49603,0,0,9,5,14
49604,1,0,12,35,48
49605,0,0,7,15,22
49607,0,0,1,12,13
49608,1,0,3,4,8
49609,2,1,4,8,15
49610,0,0,2,8,10
49611,4,0,8,36,48
49612,0,0,2,3,5
49614,0,0,4,4,8
49616,0,0,5,12,17
49617,0,0,5,12,17
49618,0,1,8,18,27
49619,0,0,3,9,12
49620,0,1,8,18,27
49621,0,0,15,30,45
49622,1,0,10,30,41
49623,1,0,10,30,41
49624,0,1,8,18,27
49626,0,0,2,3,5
49627,0,2,10,8,20
49628,0,0,5,3,8
49629,0,0,3,11,14
49630,0,0,6,12,18
49631,0,0,8,5,13
49632,0,0,7,11,18
49633,0,0,2,6,8
49634,0,0,9,16,25
49635,0,0,7,18,25
49636,0,0,4,10,14
49637,0,0,0,11,11
49638,0,0,7,21,28
49639,0,0,3,16,19
49640,0,1,8,9,18
49642,0,1,9,16,26
49643,0,0,5,8,13
49644,0,0,3,5,8
49645,0,0,4,4,8
49646,0,0,3,8,11
49647,0,0,14,18,32
49648,0,0,4,5,9
49650,0,0,6,13,19
49652,0,0,19,30,49
49653,0,0,3,27,30
49654,0,0,14,28,42
49655,0,0,15,30,45
49656,7,1,4,38,50
49657,0,1,9,19,29
49658,0,0,14,18,32
49659,1,0,5,11,17
49660,0,0,6,17,23
49661,0,0,3,3,6
49662,0,0,7,21,28
49663,1,1,1,16,19
49664,0,0,3,4,7
49666,1,0,10,30,41
49667,1,0,10,30,41
49668,0,0,0,3,3
49669,7,1,4,38,50
49670,0,0,3,5,8
49671,0,0,3,4,7
49672,0,0,7,21,28
49673,0,0,14,18,32
49674,0,2,10,8,20
49675,0,0,7,18,25
49676,0,0,14,28,42
49677,0,0,7,21,28
49678,0,1,9,19,29
49679,1,1,1,16,19
49680,0,0,7,18,25
49681,0,0,3,8,11
49682,0,0,14,18,32
49683,0,1,3,2,6
49684,0,0,5,10,15
49685,0,0,6,10,16
49686,0,0,2,0,2
49687,0,0,5,12,17
49688,0,0,6,8,14
49689,0,0,6,15,21
49690,0,0,12,13,25
49691,0,1,8,18,27
49692,0,0,8,10,18
49693,0,0,13,26,39
49694,0,0,11,18,29
49696,0,0,4,4,8
49697,0,0,8,15,23
49698,0,0,8,11,19
49699,0,0,10,6,16
49700,0,0,16,33,49
49701,2,2,13,25,42
49702,0,1,8,22,31
49703,0,1,10,8,19
49704,0,0,7,17,24
49705,3,1,12,32,48
49706,0,0,6,14,20
49707,0,0,7,10,17
49708,0,0,5,9,14
49709,0,5,9,14,28
49710,0,0,10,21,31
49711,0,1,2,5,8
49712,0,0,4,10,14
49713,0,0,5,11,16
49714,0,0,1,4,5
49715,4,0,11,34,49
49716,0,0,7,24,31
49717,0,1,4,6,11
49718,0,0,6,22,28
49720,0,0,4,2,6
49721,0,0,12,9,21
49722,0,1,12,28,41
49723,0,0,5,8,13
49724,0,0,8,5,13
49725,0,0,13,15,28
49726,0,0,7,7,14
49727,0,0,5,6,11
49728,0,0,11,10,21
49729,0,0,9,7,16
49730,0,0,6,16,22
49731,0,0,5,6,11
49732,0,1,10,12,23
49733,0,0,3,3,6
49734,1,0,14,23,38
49735,0,0,1,6,7
49736,0,0,3,8,11
49737,0,0,4,3,7
49738,0,0,12,20,32
49739,0,1,2,4,7
49740,0,0,8,6,14
49741,0,0,14,15,29
49742,0,0,8,21,29
49743,0,0,6,4,10
49744,0,0,3,2,5
49745,0,0,6,6,12
49747,0,0,0,7,7
49748,0,0,10,9,19
49749,0,0,2,9,11
49750,0,1,6,5,12
49751,0,3,4,13,20
49752,0,0,8,8,16
49753,0,0,1,7,8
49754,0,0,6,3,9
49755,0,0,4,7,11
49756,0,0,2,0,2
49757,0,0,10,8,18
49758,0,0,3,7,10
49759,0,1,16,25,42
49760,0,0,5,10,15
49761,0,0,8,8,16
49762,0,1,9,10,20
49763,0,1,2,5,8
49764,0,0,10,27,37
49765,0,0,18,15,33
49766,0,0,9,10,19
49767,0,0,1,2,3
49768,0,0,4,3,7
49769,0,1,11,15,27
49770,0,1,4,9,14
49771,0,0,2,7,9
49772,0,0,6,11,17
49773,4,0,9,18,31
49775,0,0,4,22,26
49776,0,0,6,6,12
49777,0,0,5,1,6
49778,2,0,4,23,29
49779,0,0,3,3,6
49780,0,0,14,18,32
49781,1,0,4,12,17
49782,0,1,5,15,21
49784,0,0,2,9,11
49785,0,0,2,7,9
49786,0,0,6,13,19
49787,0,0,3,1,4
49789,0,0,12,28,40
49790,0,0,7,21,28
49791,0,0,2,2,4
49792,0,1,16,31,48
49793,2,0,9,17,28
49794,0,1,3,17,21
49795,0,1,16,30,47
49796,0,0,8,24,32
49797,0,0,10,29,39
49798,0,0,5,5,10
49799,0,0,8,14,22
49800,0,1,10,19,30
49801,0,0,7,9,16
49802,3,0,6,14,23
49803,0,0,8,5,13
49804,0,0,4,6,10
49805,0,0,12,17,29
49806,0,0,7,21,28
49807,0,0,20,27,47
49808,0,0,3,10,13
49809,0,1,9,19,29
49810,1,0,3,16,20
49811,1,1,1,16,19
49812,0,0,3,4,7
49813,0,0,9,6,15
49814,1,1,9,30,41
49815,0,0,19,31,50
49816,0,1,8,18,27
49817,1,0,4,12,17
49818,0,1,16,31,48
49819,0,0,12,28,40
49820,0,0,0,6,6
49821,0,0,14,18,32
49822,0,0,0,6,6
49823,1,0,3,16,20
49824,0,0,5,9,14
49825,2,0,4,23,29
49826,0,0,20,30,50
49827,0,0,6,21,27
49828,0,0,6,18,24
49829,0,0,3,4,7
49830,0,0,7,21,28
49831,3,0,6,14,23
49832,0,0,14,18,32
49833,0,0,6,10,16
49834,0,0,7,21,28
49835,0,0,10,29,39
49836,0,1,9,19,29
49837,0,0,19,31,50
49838,1,1,1,16,19
49840,0,0,14,18,32
49841,0,1,8,18,27
49842,0,0,4,12,16
49843,0,0,7,10,17
49844,0,0,3,3,6
49845,0,0,11,23,34
49846,0,0,2,9,11
49847,0,0,4,11,15
49848,0,1,10,10,21
49849,2,0,4,23,29
49850,0,1,7,42,50
49851,0,0,9,36,45
49852,0,0,14,18,32
49853,0,9,6,26,41
49854,0,0,3,6,9
49856,1,1,0,11,13
49857,0,0,8,22,30
49858,0,3,5,30,38
49859,0,0,8,8,16
49860,0,1,8,22,31
49861,0,0,13,18,31
49862,0,0,18,13,31
49863,0,0,5,7,12
49864,0,0,3,4,7
49865,0,0,5,8,13
49866,0,0,13,13,26
49867,0,0,4,9,13
49868,0,0,9,21,30
49869,1,1,10,28,40
49870,0,1,10,17,28
49871,0,0,8,17,25
49872,0,0,6,5,11
49874,0,0,3,8,11
49875,0,1,2,5,8
49876,0,0,3,7,10
49877,0,0,7,7,14
49878,0,0,8,18,26
49879,0,0,12,10,22
49880,0,0,2,3,5
49881,0,0,4,4,8
49882,0,5,11,20,36
49883,1,0,2,6,9
49884,0,0,13,10,23
49885,1,0,3,23,27
49886,0,0,8,23,31
49887,0,0,9,3,12
49888,0,2,10,12,24
49889,1,1,11,37,50
49890,0,0,3,3,6
49891,0,0,5,11,16
49893,0,0,5,12,17
49894,1,0,1,18,20
49896,0,0,2,16,18
49897,0,0,8,4,12
49898,1,0,8,13,22
49899,4,1,6,23,34
49900,0,0,3,8,11
49901,0,0,3,10,13
49902,0,1,7,5,13
49903,0,0,2,7,9
49904,0,0,5,12,17
49905,0,1,4,39,44
49906,0,0,7,21,28
49907,0,2,9,39,50
49908,1,0,16,30,47
49909,0,0,3,5,8
49910,0,0,11,26,37
49911,0,1,2,12,15
49912,0,0,9,41,50
49913,0,2,8,32,42
49914,1,1,9,30,41
49915,3,0,6,23,32
49916,0,0,13,18,31
49917,5,0,1,13,19
49918,0,4,7,31,42
49919,0,0,14,18,32
49920,4,2,10,33,49
49922,2,0,0,16,18
49923,0,0,6,12,18
49924,0,0,4,16,20
49925,0,0,3,13,16
49926,1,0,13,27,41
49927,0,0,3,4,7
49928,1,0,1,13,15
49930,0,0,7,21,28
49931,0,2,9,39,50
49932,1,0,16,30,47
49933,0,0,2,28,30
49934,0,1,11,33,45
49935,1,0,10,30,41
49936,4,0,9,37,50
49937,2,0,4,23,29
49938,0,0,2,28,30
49939,0,0,13,30,43
49940,1,0,10,30,41
49941,0,4,5,10,19
49942,0,0,3,5,8
49943,0,0,7,21,28
49944,0,0,14,18,32
49945,4,0,9,37,50
49946,0,0,7,10,17
49947,0,0,7,21,28
49948,0,0,14,18,32
49949,0,0,3,8,11
49950,0,0,6,10,16
49951,0,0,2,3,5
49952,1,0,7,9,17
49953,0,0,2,7,9
49954,0,2,5,14,21
49955,2,0,11,10,23
49956,2,0,2,6,10
49957,0,0,17,26,43
49958,0,0,4,2,6
49959,0,0,9,35,44
49960,0,0,20,21,41
49961,0,0,12,28,40
49962,0,0,4,7,11
49963,0,0,8,8,16
49964,0,0,2,5,7
49965,1,0,8,14,23
49966,2,1,3,13,19
49967,0,0,1,3,4
49968,0,0,6,7,13
49969,0,2,19,29,50
49970,0,0,4,4,8
49971,0,0,2,7,9
49972,0,0,4,2,6
49973,0,0,5,5,10
49974,1,1,0,4,6
49975,0,1,9,18,28
49976,0,0,3,7,10
49977,1,0,1,9,11
49978,0,0,9,12,21
49979,0,0,7,5,12
49980,0,0,2,2,4
49981,0,0,11,28,39
49982,0,0,2,3,5
49983,1,0,16,30,47
49985,0,0,5,10,15
49986,0,0,1,4,5
49987,0,0,13,4,17
49988,0,0,5,4,9
49989,0,0,8,4,12
49990,0,0,4,5,9
49991,0,0,7,19,26
49992,0,1,2,6,9
49993,0,0,6,11,17
49994,0,0,8,10,18
49995,0,0,8,29,37
49997,0,0,8,4,12
49998,0,0,8,11,19
49999,0,2,5,14,21
50001,1,0,1,7,9
50002,0,0,14,8,22
50003,0,0,13,37,50
50004,0,0,13,4,17
50005,3,1,1,25,30
50006,2,0,11,17,30
50007,0,1,2,17,20
50008,0,0,10,11,21
50009,0,0,4,6,10
50010,0,0,4,12,16
50011,0,0,8,16,24
50012,2,0,10,31,43
50013,1,0,13,31,45
50014,0,0,6,11,17
50015,0,0,12,28,40
50016,1,1,7,17,26
50017,0,1,9,9,19
50019,0,0,6,11,17
50020,1,0,16,30,47
50021,0,0,0,6,6
50022,0,1,4,23,28
50023,7,0,6,14,27
50024,0,0,6,16,22
50025,0,0,5,10,15
50026,0,0,0,6,6
50027,7,1,3,30,41
50028,0,1,9,9,19
50029,0,0,6,10,16
50030,0,0,8,11,19
50031,0,1,6,6,13
50032,1,0,5,8,14
50033,2,0,2,6,10
50034,0,0,5,10,15
50035,0,0,11,11,22
50036,0,0,6,10,16
50037,0,0,4,12,16
50038,0,0,5,12,17
50039,0,2,5,14,21
50040,0,0,2,3,5
50041,0,0,13,4,17
50042,0,0,10,25,35
50043,0,2,9,39,50
50044,0,1,10,13,24
50045,0,2,12,22,36
50046,0,0,10,17,27
50047,0,10,9,17,36
50048,0,0,6,10,16
50049,0,0,6,13,19
50050,0,0,9,9,18
50051,1,0,3,5,9
50052,0,0,4,6,10
50054,0,0,11,11,22
50055,0,0,11,38,49
50056,1,0,17,27,45
50057,1,2,16,27,46
50058,0,0,10,19,29
50059,0,0,0,14,14
50060,0,0,5,16,21
50062,0,0,0,5,5
50063,0,0,12,24,36
50064,0,0,5,12,17
50065,0,0,7,7,14
50066,0,0,2,3,5
50068,0,0,6,11,17
50069,0,0,5,7,12
50070,0,0,6,13,19
50071,0,0,14,32,46
50072,0,0,10,7,17
50073,0,0,5,10,15
50074,0,0,8,8,16
50075,0,0,3,8,11
50076,0,0,5,10,15
50077,0,0,3,5,8
50078,0,0,5,1,6
50079,1,0,1,9,11
50080,0,1,6,6,13
50081,0,2,5,14,21
50082,0,0,2,9,11
50083,1,0,5,8,14
50084,0,0,2,7,9
50085,0,0,4,10,14
50086,0,0,15,27,42
50087,0,4,11,33,48
50088,1,0,18,31,50
50089,1,0,8,18,27
50090,0,0,9,8,17
50091,0,0,10,25,35
50092,1,1,9,39,50
50093,0,0,14,28,42
50094,0,0,3,13,16
50095,0,0,10,7,17
50096,0,0,7,18,25
50097,0,0,6,10,16
50098,0,0,9,12,21
50099,1,0,1,7,9
50100,0,2,9,39,50
50101,1,0,3,16,20
50102,0,0,15,27,42
50103,0,0,6,11,17
50104,0,0,13,4,17
50105,0,0,7,7,14
50106,1,0,3,16,20
50107,0,0,5,10,15
50108,6,0,0,25,31
50109,0,0,3,5,8
50110,0,0,14,28,42
50111,0,0,2,0,2
50112,0,0,7,10,17
50113,0,0,11,10,21
50114,0,0,5,10,15
50115,1,0,4,5,10
50116,0,0,6,10,16
50117,0,0,1,5,6
50118,0,2,3,7,12
50119,0,1,3,21,25
50120,1,0,9,7,17
50121,0,0,3,3,6
50122,1,0,6,9,16
50123,0,2,10,15,27
50124,0,0,1,22,23
50125,0,0,1,7,8
50126,0,0,8,11,19
50127,0,1,6,12,19
50128,0,0,0,7,7
50129,0,0,18,19,37
50130,0,1,11,25,37
50131,0,0,1,2,3
50132,0,1,4,26,31
50133,0,0,7,5,12
50134,0,0,6,15,21
50135,0,0,9,28,37
50136,0,1,5,15,21
50137,0,0,14,26,40
50138,0,1,11,19,31
50139,0,3,20,27,50
50140,0,1,7,15,23
50141,0,0,6,14,20
50142,0,0,14,36,50
50143,1,0,8,9,18
50144,0,0,2,12,14
50145,0,1,8,9,18
50146,0,0,4,5,9
50147,0,0,6,5,11
50148,0,0,15,33,48
50149,0,0,2,4,6
50150,0,0,11,25,36
50151,0,0,12,18,30
50152,0,0,7,4,11
50153,0,0,5,17,22
50154,0,0,5,13,18
50155,0,0,3,2,5
50156,0,0,7,21,28
50157,0,0,8,8,16
50158,0,0,16,22,38
50159,0,0,10,14,24
50160,0,1,9,12,22
50161,2,0,3,18,23
50162,1,0,3,10,14
50163,0,0,14,15,29
50164,0,1,12,14,27
50165,0,0,3,2,5
50166,0,0,6,10,16
50168,0,0,4,2,6
50169,0,0,9,12,21
50170,0,0,5,7,12
50171,0,0,6,8,14
50172,0,0,3,9,12
50173,1,2,14,23,40
50174,0,1,4,9,14
50176,0,0,13,36,49
50177,0,0,5,10,15
50179,0,0,10,25,35
50180,0,0,2,0,2
50181,1,0,9,37,47
50182,2,0,5,20,27
50183,0,0,2,3,5
50184,0,0,11,16,27
50185,0,0,2,10,12
50186,0,0,10,39,49
50187,0,0,7,14,21
50188,0,0,10,25,35
50189,0,0,5,10,15
50190,0,1,16,25,42
50191,0,0,7,24,31
50192,0,1,12,13,26
50193,1,5,2,41,49
50195,0,0,7,4,11
50196,0,0,9,12,21
50197,0,0,5,11,16
50198,0,0,11,38,49
50199,5,0,4,13,22
50200,0,0,12,22,34
50201,0,0,12,38,50
50202,4,0,8,26,38
50203,0,0,7,22,29
50204,0,0,5,12,17
50205,1,0,0,16,17
50206,0,0,3,1,4
50207,0,0,6,10,16
50208,3,0,1,9,13
50209,0,0,8,33,41
50210,0,1,14,35,50
50211,0,0,9,12,21
50212,1,0,3,12,16
50213,0,0,0,1,1
50214,0,1,9,12,22
50215,0,0,16,32,48
50216,0,2,3,7,12
50217,0,0,3,5,8
50218,0,0,6,16,22
50219,0,1,2,16,19
50220,4,0,9,37,50
50221,1,0,0,16,17
50222,0,0,7,24,31
50223,3,0,1,9,13
50224,2,0,6,15,23
50225,0,0,4,36,40
50226,0,0,10,39,49
50227,2,1,7,24,34
50228,0,0,7,10,17
50229,4,0,9,37,50
50230,0,0,6,14,20
50231,0,1,6,6,13
50232,1,0,0,4,5
50233,0,0,4,14,18
50234,0,0,3,15,18
50235,3,0,6,40,49
50236,1,0,1,7,9
50237,0,1,6,21,28
50238,0,0,1,27,28
50239,0,0,6,15,21
50240,0,0,7,11,18
50241,0,0,1,9,10
50242,0,1,7,24,32
50243,0,1,6,9,16
50244,0,0,2,14,16
50245,2,1,2,23,28
50246,0,0,2,8,10
50247,0,1,6,6,13
50248,0,0,2,6,8
50249,1,1,8,31,41
50251,0,0,5,7,12
50253,3,1,6,37,47
50254,0,0,15,29,44
50255,0,0,5,18,23
50256,1,1,9,30,41
50257,0,0,13,37,50
50258,0,2,3,19,24
50259,0,0,11,21,32
50260,1,0,1,13,15
50261,0,0,15,21,36
50262,5,0,1,13,19
50263,0,1,5,22,28
50264,0,0,2,0,2
50265,0,0,12,24,36
50266,0,0,9,22,31
50267,0,1,9,34,44
50268,1,0,9,40,50
50269,2,0,3,26,31
50270,0,0,2,14,16
50271,0,0,10,14,24
50272,0,0,6,7,13
50273,1,0,9,40,50
50274,0,1,5,22,28
50275,0,0,11,13,24
50276,0,0,1,7,8
50277,0,0,9,27,36
50278,0,0,5,6,11
50279,0,0,9,11,20
50280,1,0,5,8,14
50281,0,0,2,6,8
50282,1,0,6,22,29
50283,0,0,2,5,7
50284,0,0,9,36,45
50285,0,1,5,19,25
50286,0,3,6,20,29
50287,0,2,9,37,48
50288,0,0,15,22,37
50289,0,0,6,17,23
50290,0,0,6,11,17
50292,0,0,6,18,24
50293,0,1,11,23,35
50294,0,0,8,29,37
50295,0,0,4,9,13
50296,0,1,3,7,11
50297,0,0,8,10,18
50298,0,0,2,10,12
50299,0,0,13,13,26
50300,1,0,6,13,20
50301,0,0,2,3,5
50302,0,1,7,20,28
50303,0,0,2,4,6
50304,0,0,8,14,22
50305,0,0,9,31,40
50306,0,1,16,31,48
50307,0,1,1,7,9
50308,1,0,3,34,38
50309,0,1,20,29,50
50311,0,0,17,11,28
50312,0,0,7,7,14
50314,0,0,10,18,28
50316,0,1,9,16,26
50318,0,0,3,2,5
50319,0,0,5,6,11
50320,0,1,15,22,38
50321,0,2,4,20,26
50322,0,1,5,13,19
50323,0,0,3,2,5
50324,0,0,4,17,21
50325,0,0,5,7,12
50327,0,0,6,7,13
50328,0,1,4,9,14
50329,0,0,3,8,11
50330,0,0,10,5,15
50331,0,1,10,13,24
50333,0,0,4,6,10
50334,0,0,5,37,42
50335,0,1,5,15,21
50336,0,1,5,16,22
50337,2,0,7,33,42
50338,0,0,8,7,15
50339,0,0,5,4,9
50340,0,0,3,0,3
50341,0,1,10,13,24
50342,0,0,9,26,35
50343,0,1,0,6,7
50344,0,0,9,14,23
50345,0,0,7,3,10
50346,0,1,9,8,18
50347,0,0,3,6,9
50349,0,0,6,13,19
50350,0,0,4,16,20
50352,0,0,1,9,10
50353,0,0,4,2,6
50354,0,1,7,10,18
50355,3,0,7,38,48
50356,0,0,14,32,46
50357,0,0,2,6,8
50358,0,2,3,22,27
50359,0,0,8,19,27
50360,1,1,10,23,35
50361,1,2,1,13,17
50362,1,0,6,18,25
50364,1,0,10,14,25
50365,0,0,14,18,32
50366,1,0,5,8,14
50367,0,0,3,5,8
50368,0,0,4,6,10
50369,0,0,8,5,13
50370,0,0,13,14,27
50371,0,0,16,28,44
50372,4,0,8,34,46
50373,0,0,6,12,18
50374,1,0,9,39,49
50375,0,0,5,11,16
50376,0,0,9,24,33
50377,2,0,2,21,25
50378,1,0,6,11,18
50379,1,1,2,19,23
50381,0,1,7,9,17
50382,0,1,0,7,8
50383,3,2,9,36,50
50384,1,0,12,28,41
50385,0,0,6,14,20
50386,0,0,5,5,10
50387,0,0,2,3,5
50388,0,0,7,12,19
50389,0,0,5,34,39
50390,1,2,8,28,39
50391,8,1,6,35,50
50392,0,0,10,12,22
50393,0,1,14,23,38
50394,1,0,14,34,49
50395,0,0,11,25,36
50396,4,0,3,19,26
50397,0,0,7,14,21
50398,1,0,14,24,39
50399,0,1,2,12,15
50400,0,0,6,5,11
50401,0,2,3,13,18
50402,0,1,3,13,17
50403,0,0,3,6,9
50404,4,1,3,39,47
50405,1,1,5,39,46
50406,4,1,5,40,50
50407,2,0,4,18,24
50408,0,1,8,27,36
50409,0,0,6,19,25
50410,0,0,0,7,7
50411,0,0,6,10,16
50412,0,1,7,7,15
50413,0,0,3,9,12
50414,1,1,7,23,32
50415,0,1,8,13,22
50416,0,1,9,38,48
50417,0,1,1,5,7
50418,1,0,4,16,21
50419,0,1,5,20,26
50420,7,0,0,16,23
50421,1,0,6,8,15
50422,0,0,14,18,32
50423,0,1,3,15,19
50424,0,0,5,4,9
50425,0,2,3,22,27
50426,0,1,16,31,48
50427,1,1,3,45,50
50428,0,0,11,31,42
50429,8,1,6,35,50
50430,0,1,3,13,17
50431,0,0,13,34,47
50432,1,0,9,32,42
50433,0,0,2,6,8
50434,0,0,14,18,32
50435,0,1,5,15,21
50436,0,0,14,18,32
50437,1,0,6,18,25
50438,0,3,1,13,17
50439,0,3,14,25,42
50440,0,0,15,29,44
50441,0,0,11,39,50
50442,0,1,9,20,30
50443,0,0,2,4,6
50444,0,3,1,13,17
50445,0,0,3,16,19
50446,0,1,5,21,27
50447,0,0,5,16,21
50448,0,0,2,14,16
50449,0,0,0,5,5
50450,0,0,6,27,33
50451,0,3,6,28,37
50452,2,2,4,17,25
50453,0,1,10,33,44
50455,2,2,4,17,25
50456,0,0,3,16,19
50457,0,1,9,20,30
50458,0,0,6,27,33
50459,0,0,0,5,5
50460,0,0,2,4,6
50461,0,0,2,10,12
50462,2,2,4,17,25
50463,0,0,0,14,14
50464,2,2,4,17,25
50465,0,1,10,33,44
50466,0,0,11,39,50
50467,0,0,6,27,33
50468,0,0,0,14,14
50469,0,3,6,28,37
50470,0,0,1,14,15
50471,0,0,5,7,12
50472,0,0,4,11,15
50473,0,0,5,11,16
50474,2,0,7,27,36
50475,0,0,2,2,4
50476,0,0,1,1,2
50477,0,0,3,5,8
50478,0,0,6,22,28
50479,0,3,10,9,22
50480,0,0,3,3,6
50481,0,0,8,4,12
50482,0,0,4,5,9
50483,1,0,3,18,22
50484,0,0,4,15,19
50485,0,0,4,16,20
50486,0,0,1,4,5
50487,0,0,4,15,19
50488,0,0,8,15,23
50489,0,2,13,27,42
50490,0,0,7,25,32
50491,0,0,2,7,9
50492,0,2,14,22,38
50493,3,1,3,12,19
50494,0,0,1,7,8
50495,0,0,17,22,39
50496,0,0,6,6,12
50497,0,0,4,42,46
50498,0,0,1,8,9
50499,0,0,9,11,20
50500,0,0,1,4,5
50501,0,0,10,33,43
50502,0,0,7,22,29
50503,0,0,4,19,23
50504,0,0,1,14,15
50505,0,1,4,6,11
50506,0,0,9,5,14
50507,0,0,8,12,20
50508,0,6,7,32,45
50510,0,0,10,27,37
50511,0,0,2,6,8
50512,0,0,5,17,22
50513,0,0,11,17,28
50514,0,0,6,31,37
50515,0,0,2,2,4
50516,0,0,2,8,10
50517,0,0,8,3,11
50518,0,1,7,9,17
50519,2,0,12,29,43
50520,0,0,6,15,21
50521,0,0,2,6,8
50522,0,0,5,5,10
50523,0,1,4,4,9
50524,0,2,10,23,35
50525,0,0,1,7,8
50526,0,0,7,12,19
50527,0,0,9,13,22
50528,0,0,1,8,9
50529,0,1,5,19,25
50530,0,0,5,12,17
50531,0,0,7,3,10
50532,0,0,5,9,14
50533,0,0,2,4,6
50534,0,0,2,3,5
50535,0,1,8,20,29
50536,1,1,3,18,23
50537,0,1,5,10,16
50538,0,0,2,5,7
50539,0,1,8,16,25
50540,0,0,5,15,20
50541,0,0,10,11,21
50542,0,0,6,13,19
50543,0,1,3,17,21
50544,0,0,5,6,11
50545,0,0,1,10,11
50546,0,0,10,12,22
50547,0,0,5,3,8
50548,0,0,2,8,10
50549,0,0,2,10,12
50550,0,0,2,5,7
50551,0,0,1,14,15
50552,0,0,1,2,3
50553,0,0,12,22,34
50554,1,0,4,8,13
50555,0,1,0,4,5
50556,0,0,8,7,15
50557,0,0,1,6,7
50558,0,0,6,3,9
50559,0,1,4,10,15
50560,0,1,4,6,11
50562,0,0,7,1,8
50563,0,0,6,9,15
50564,0,2,7,9,18
50565,0,0,5,7,12
50566,0,1,15,14,30
50567,0,0,8,14,22
50569,1,1,6,11,19
50570,0,0,8,10,18
50571,0,1,8,17,26
50572,0,0,4,9,13
50573,0,0,12,17,29
50575,0,1,1,4,6
50576,0,0,0,5,5
50577,0,0,5,10,15
50578,1,0,6,18,25
50579,0,1,14,18,33
50580,0,0,3,13,16
50581,0,0,8,41,49
50582,0,1,3,3,7
50583,0,3,6,28,37
50584,0,0,7,10,17
50585,0,0,2,3,5
50586,0,0,1,4,5
50587,1,0,6,7,14
50588,0,0,2,5,7
50589,0,0,5,4,9
50590,0,0,3,5,8
50591,0,0,6,7,13
50592,0,1,9,17,27
50593,0,1,7,18,26
50594,0,0,2,5,7
50595,0,0,2,14,16
50596,0,0,6,6,12
50597,0,0,5,10,15
50598,0,2,5,18,25
50599,1,0,4,9,14
50600,0,0,10,15,25
50601,0,0,8,19,27
50602,3,1,3,11,18
50603,0,0,1,9,10
50604,1,1,6,5,13
50605,1,2,5,30,38
50606,0,0,12,10,22
50607,0,0,4,1,5
50608,5,1,5,28,39
50609,2,5,6,23,36
50610,0,0,14,32,46
50611,0,0,6,18,24
50613,0,0,7,12,19
50614,0,0,15,32,47
50615,0,0,0,4,4
50616,1,2,17,23,43
50617,0,1,2,4,7
50618,0,0,2,5,7
50619,0,0,16,24,40
50620,0,0,2,11,13
50621,0,0,7,11,18
50622,0,2,6,10,18
50623,0,2,7,19,28
50624,0,0,3,0,3
50625,0,0,5,20,25
50626,0,0,4,11,15
50627,2,1,9,23,35
50628,0,5,2,14,21
50629,0,0,0,1,1
50630,2,0,1,7,10
50631,1,6,1,9,17
50632,2,6,1,14,23
50633,0,0,4,6,10
50635,0,3,3,44,50
50636,1,0,12,36,49
50637,1,2,3,10,16
50638,0,0,4,7,11
50639,5,1,5,28,39
50640,0,0,9,15,24
50641,0,0,6,18,24
50642,0,0,4,42,46
50643,0,0,4,34,38
50644,0,0,1,2,3
50645,0,0,7,11,18
50646,5,1,7,24,37
50647,0,0,13,29,42
50648,0,0,6,19,25
50649,0,1,6,9,16
50650,0,1,9,22,32
50651,0,0,6,28,34
50652,0,0,6,4,10
50653,1,1,2,6,10
50654,0,0,10,37,47
50655,0,1,7,17,25
50656,2,3,3,23,31
50657,1,3,6,39,49
50658,0,1,16,31,48
50659,0,0,0,4,4
50660,0,0,13,6,19
50661,0,0,11,25,36
50662,4,1,1,5,11
50664,2,0,1,7,10
50665,0,0,1,4,5
50666,0,0,5,16,21
50667,1,0,20,29,50
50668,0,0,3,0,3
50669,0,0,8,12,20
50670,0,0,13,30,43
50671,3,1,3,12,19
50672,2,5,6,23,36
50673,0,0,1,15,16
50674,0,1,4,4,9
50676,0,0,10,11,21
50677,1,1,5,34,41
50678,0,1,0,4,5
50679,0,0,1,9,10
50680,0,0,16,34,50
50681,0,5,2,14,21
50682,1,1,6,5,13
50683,0,0,5,16,21
50684,0,0,7,43,50
50685,0,0,10,27,37
50686,0,0,4,6,10
50687,0,0,1,4,5
50688,0,0,12,15,27
50689,0,5,2,14,21
50690,0,0,1,12,13
50691,2,6,1,14,23
50692,1,1,6,5,13
50693,1,3,6,39,49
50694,0,0,0,6,6
50695,3,1,3,12,19
50696,2,6,1,14,23
50697,0,0,2,11,13
50698,2,6,1,14,23
50699,0,0,13,6,19
50700,1,0,20,29,50
50701,0,1,0,4,5
50702,0,1,0,4,5
50703,0,0,5,4,9
50704,0,0,5,16,21
50705,0,0,8,9,17
50706,0,0,4,2,6
50707,5,1,7,24,37
50708,0,0,14,32,46
50709,0,0,15,32,47
50710,0,0,6,18,24
50711,0,3,3,44,50
50712,0,1,1,8,10
50713,0,0,0,6,6
50714,1,3,6,39,49
50715,0,0,7,43,50
50716,0,0,16,34,50
50717,1,1,5,34,41
50718,0,0,16,24,40
50719,0,0,1,15,16
50720,0,0,5,20,25
50721,3,1,3,12,19
50722,2,1,9,23,35
50723,0,0,13,30,43
50724,2,5,6,23,36
50725,0,2,6,10,18
50726,2,6,1,14,23
50727,1,6,1,9,17
50728,0,0,1,14,15
50729,0,2,2,19,23
50730,3,1,3,11,18
50731,0,3,6,28,37
50733,0,0,9,18,27
50734,0,0,6,9,15
50735,0,0,2,4,6
50736,0,1,1,12,14
50737,2,1,9,30,42
50738,0,0,0,3,3
50739,0,0,1,12,13
50740,0,0,0,16,16
50741,0,0,7,11,18
50742,0,0,8,17,25
50744,0,1,15,16,32
50745,1,0,9,32,42
50746,0,1,6,11,18
50747,0,0,6,4,10
50748,0,0,8,21,29
50749,0,0,8,17,25
50750,0,0,7,4,11
50751,0,1,13,35,49
50752,0,0,4,4,8
50753,0,0,5,7,12
50754,0,0,2,14,16
50755,0,0,9,10,19
50756,0,2,11,12,25
50757,0,0,3,13,16
50758,0,0,10,11,21
50759,0,0,6,0,6
50760,0,1,3,23,27
50761,1,1,11,37,50
50762,1,0,3,32,36
50763,0,0,2,8,10
50764,0,0,1,11,12
50765,0,0,15,32,47
50766,0,0,7,12,19
50767,0,0,6,6,12
50768,0,1,8,20,29
50770,0,0,9,30,39
50771,0,0,6,14,20
50772,0,0,8,17,25
50773,0,0,0,5,5
50774,0,0,3,15,18
50775,0,0,6,8,14
50776,0,0,5,7,12
50777,0,0,8,10,18
50778,0,0,0,9,9
50779,0,0,6,5,11
50780,0,1,2,21,24
50781,0,0,8,15,23
50782,0,0,8,26,34
50783,0,0,2,0,2
50784,0,0,10,12,22
50785,5,1,5,28,39
50786,0,0,9,5,14
50787,0,0,2,7,9
50789,0,0,7,9,16
50790,0,0,6,14,20
50791,0,0,3,17,20
50792,0,0,0,7,7
50793,0,0,0,7,7
50794,0,0,10,12,22
50795,0,2,8,25,35
50796,1,1,6,21,29
50797,0,0,4,4,8
50798,0,0,1,4,5
50799,0,1,8,10,19
50800,1,0,0,8,9
50801,0,0,8,12,20
50802,0,0,20,24,44
50803,0,0,6,11,17
50804,0,0,10,16,26
50805,0,1,11,12,24
50806,0,0,10,16,26
50807,0,0,3,2,5
50808,0,0,6,9,15
50809,0,0,8,14,22
50810,0,0,2,6,8
50812,0,0,5,7,12
50813,0,0,5,9,14
50814,0,0,3,18,21
50815,0,0,0,5,5
50816,0,0,11,25,36
50817,0,0,1,4,5
50818,0,0,2,17,19
50819,0,0,12,27,39
50820,0,0,1,15,16
50821,0,0,3,2,5
50822,0,2,10,31,43
50823,0,0,2,2,4
50824,0,0,7,11,18
50825,0,0,8,39,47
50826,0,0,0,6,6
50827,0,1,3,2,6
50828,0,0,7,9,16
50829,0,0,10,18,28
50830,0,2,3,12,17
50831,0,0,6,22,28
50832,0,0,8,14,22
50833,0,1,7,25,33
50834,0,1,12,21,34
50835,0,0,4,12,16
50836,0,0,5,17,22
50837,0,2,0,13,15
50838,0,0,5,17,22
50839,2,1,6,41,50
50840,0,0,9,18,27
50841,1,0,2,22,25
50842,0,0,6,14,20
50843,0,0,5,9,14
50844,0,0,7,15,22
50845,0,0,4,12,16
50846,0,0,1,2,3
50847,0,0,6,7,13
50848,1,0,4,7,12
50849,0,2,9,38,49
50850,0,1,10,11,22
50851,0,0,4,9,13
50852,1,1,19,28,49
50853,0,0,3,7,10
50854,0,0,1,6,7
50855,0,0,6,14,20
50856,0,0,1,22,23
50857,0,1,7,15,23
50858,0,0,3,0,3
50859,0,0,10,29,39
50860,0,0,6,7,13
50861,2,0,3,12,17
50862,0,1,12,30,43
50863,0,0,5,9,14
50864,0,0,0,7,7
50865,0,0,6,3,9
50866,0,0,3,12,15
50867,0,0,5,18,23
50868,0,0,2,10,12
50869,0,0,2,8,10
50870,0,0,1,10,11
50871,0,0,5,15,20
50872,0,0,4,7,11
50873,0,0,5,7,12
50874,0,0,1,4,5
50875,0,1,15,17,33
50876,0,0,7,7,14
50877,0,0,7,9,16
50878,0,0,7,7,14
50879,0,0,12,5,17
50880,0,0,7,21,28
50881,0,0,2,13,15
50882,0,0,13,14,27
50883,0,0,3,5,8
50884,0,2,9,12,23
50885,0,0,0,7,7
50886,0,0,5,8,13
50887,0,0,10,17,27
50888,0,0,1,4,5
50889,0,0,9,18,27
50890,0,0,12,30,42
50891,0,0,5,8,13
50892,1,0,11,24,36
50893,0,0,1,1,2
50894,0,0,5,15,20
50895,0,0,7,8,15
50896,0,0,7,5,12
50897,0,0,5,20,25
50898,0,0,2,8,10
50899,0,0,2,14,16
50900,0,2,7,21,30
50901,0,0,5,8,13
50902,0,0,6,12,18
50903,0,0,1,8,9
50904,0,0,3,6,9
50905,0,3,8,17,28
50906,0,0,11,15,26
50907,0,0,8,12,20
50908,0,0,9,6,15
50909,0,0,8,12,20
50910,0,0,6,4,10
50911,0,0,10,19,29
50912,0,1,8,22,31
50913,0,0,9,18,27
50914,0,1,10,17,28
50915,0,0,3,9,12
50916,0,0,7,13,20
50917,0,0,1,12,13
50918,0,0,4,10,14
50919,0,1,13,14,28
50920,0,2,6,18,26
50921,0,0,0,7,7
50922,0,0,9,16,25
50923,0,0,11,10,21
50924,0,0,4,18,22
50925,1,0,9,32,42
50926,0,0,3,2,5
50929,0,1,2,12,15
50930,0,0,7,23,30
50931,0,1,9,14,24
50932,0,1,10,22,33
50933,0,0,5,5,10
50934,0,0,2,1,3
50935,0,0,18,29,47
50936,0,0,7,10,17
50937,0,0,8,17,25
50938,0,0,6,19,25
50939,0,0,11,15,26
50940,0,0,5,12,17
50941,0,1,3,8,12
50942,0,0,6,5,11
50943,0,0,8,21,29
50944,0,0,4,17,21
50945,0,0,7,24,31
50946,0,0,8,10,18
50947,0,0,4,2,6
50949,0,3,0,6,9
50950,0,0,4,1,5
50951,0,0,6,9,15
50953,0,0,9,13,22
50955,0,0,7,12,19
50956,0,0,11,24,35
50958,0,0,7,11,18
50959,0,0,0,26,26
50960,0,0,1,1,2
50961,0,0,4,6,10
50962,0,0,7,13,20
50963,1,0,1,12,14
50964,0,0,6,12,18
50965,0,0,2,3,5
50966,0,0,4,7,11
50967,0,0,4,11,15
50968,0,0,5,6,11
50969,0,0,8,17,25
50970,0,0,5,8,13
50971,0,2,6,10,18
50972,0,0,7,18,25
50973,0,0,1,10,11
50974,0,1,5,16,22
50975,0,0,18,27,45
50976,0,0,11,11,22
50978,0,0,8,17,25
50979,0,0,8,13,21
50980,0,0,7,15,22
50981,0,0,9,6,15
50983,1,0,4,14,19
50984,0,1,3,24,28
50985,0,0,7,8,15
50988,0,0,1,8,9
50989,0,0,4,16,20
50990,0,0,6,5,11
50991,1,0,6,13,20
50992,0,0,4,10,14
50993,1,0,5,8,14
50994,0,0,4,9,13
50995,0,0,0,6,6
50996,0,0,3,2,5
50997,0,0,5,13,18
50998,0,0,4,2,6
50999,1,1,1,21,24
51000,0,1,1,5,7
51001,0,0,3,20,23
51002,0,0,8,8,16
51003,0,0,4,9,13
51004,1,2,15,31,49
51005,0,0,2,5,7
51006,0,0,9,22,31
51007,0,0,9,6,15
51008,0,1,2,6,9
51009,0,1,8,21,30
51011,0,0,3,10,13
51012,0,1,5,3,9
51013,0,0,4,11,15
51014,0,1,3,8,12
51016,0,0,1,2,3
51017,0,0,5,2,7
51018,0,2,2,10,14
51019,0,0,8,19,27
51021,0,0,5,5,10
51022,0,0,7,2,9
51023,0,0,4,5,9
51024,0,0,3,6,9
51026,0,0,6,11,17
51027,0,0,6,27,33
51028,0,0,2,3,5
51029,0,0,7,8,15
51031,0,1,7,18,26
51032,0,0,10,34,44
51033,0,0,11,22,33
51034,1,0,6,15,22
51035,0,1,10,17,28
51036,0,0,8,10,18
51037,1,6,1,9,17
51038,0,2,1,12,15
51039,0,1,6,14,21
51040,0,2,8,22,32
51041,0,0,4,4,8
51042,0,0,1,10,11
51043,0,0,10,6,16
51044,0,0,0,11,11
51045,0,0,17,22,39
51046,0,0,6,20,26
51047,0,0,2,11,13
51048,0,0,4,12,16
51049,1,1,3,16,21
51050,0,0,4,3,7
51051,2,2,1,13,18
51052,0,0,5,15,20
51053,0,0,2,3,5
51054,0,1,4,10,15
51055,0,0,5,3,8
51056,0,0,12,12,24
51057,0,0,13,19,32
51058,0,0,9,17,26
51059,0,0,2,4,6
51060,0,0,6,10,16
51061,0,0,3,8,11
51062,0,1,1,5,7
51063,0,0,5,1,6
51064,0,0,3,19,22
51065,0,0,8,12,20
51066,0,0,4,3,7
51067,0,0,10,27,37
51070,0,0,0,1,1
51071,2,0,0,20,22
51072,0,0,2,5,7
51073,1,2,4,16,23
51074,0,0,7,8,15
51075,0,5,2,14,21
51076,0,0,9,5,14
51077,0,0,1,6,7
51078,0,3,6,11,20
51080,0,0,3,7,10
51081,0,0,0,13,13
51082,0,0,1,4,5
51083,0,1,6,8,15
51084,0,1,6,11,18
51085,0,0,1,6,7
51089,0,0,2,9,11
51090,0,0,0,5,5
51091,0,0,8,12,20
51092,3,1,3,12,19
51093,2,1,9,30,42
51094,0,2,7,41,50
51095,0,0,4,11,15
51096,0,1,4,4,9
51097,0,0,1,4,5
51098,0,0,1,12,13
51099,0,0,6,3,9
51101,2,2,4,17,25
51102,0,0,7,11,18
51103,0,0,9,18,27
51104,0,1,0,4,5
51105,0,0,1,8,9
51106,0,0,3,7,10
51107,1,2,4,42,49
51108,0,0,5,5,10
51109,0,0,3,5,8
51110,0,0,3,12,15
51111,0,0,0,2,2
51112,1,1,6,11,19
51113,0,0,5,4,9
51114,0,0,6,4,10
51115,0,0,6,7,13
51117,0,0,7,17,24
51118,0,0,10,35,45
51119,0,0,5,15,20
51120,0,0,11,12,23
51121,1,0,2,11,14
51122,0,1,16,28,45
51123,0,0,4,10,14
51124,0,0,14,28,42
51125,0,1,3,10,14
51126,0,0,6,10,16
51127,0,0,5,13,18
51128,0,0,10,27,37
51130,0,0,16,18,34
51131,0,0,17,33,50
51132,0,0,2,9,11
51133,0,0,6,16,22
51134,0,0,0,6,6
51135,1,0,7,16,24
51136,0,0,6,14,20
51137,0,0,1,7,8
51138,0,0,2,10,12
51139,0,4,13,32,49
51140,1,0,11,38,50
51141,0,0,5,2,7
51142,0,0,8,12,20
51143,1,0,4,21,26
51144,0,1,8,18,27
51145,0,0,3,12,15
51146,0,0,6,15,21
51147,0,1,5,38,44
51148,1,0,10,12,23
51149,0,0,9,9,18
51150,0,0,13,34,47
51151,0,0,13,30,43
51152,0,0,8,19,27
51153,0,3,6,21,30
51154,0,0,10,31,41
51155,0,0,16,33,49
51156,0,0,10,14,24
51157,2,0,8,16,26
51158,1,0,15,23,39
51159,0,0,10,29,39
51160,0,2,5,22,29
51161,0,1,7,21,29
51162,0,0,11,37,48
51163,0,0,5,14,19
51164,0,0,6,6,12
51165,0,0,6,7,13
51166,0,0,3,7,10
51167,0,0,6,13,19
51168,0,0,11,10,21
51169,0,0,4,7,11
51170,0,0,4,10,14
51171,0,0,8,31,39
51172,1,1,13,30,45
51173,0,0,11,20,31
51175,0,0,5,16,21
51177,0,0,11,22,33
51178,2,1,9,38,50
51179,0,0,4,8,12
51180,0,0,4,8,12
51181,0,0,6,15,21
51182,0,0,4,17,21
51183,1,1,5,34,41
51184,0,0,2,12,14
51185,0,0,6,23,29
51186,0,0,7,13,20
51187,1,0,9,32,42
51188,0,1,8,13,22
51189,1,0,5,12,18
51190,0,0,13,24,37
51191,0,0,5,18,23
51192,0,3,13,26,42
51193,0,0,12,21,33
51194,0,1,4,26,31
51195,0,0,4,6,10
51196,0,0,7,13,20
51197,0,1,6,15,22
51198,0,1,4,45,50
51199,0,0,5,3,8
51200,1,1,11,37,50
51201,0,1,15,16,32
51202,1,3,6,39,49
51203,0,1,13,35,49
51204,1,0,5,19,25
51205,0,0,2,10,12
51206,0,0,2,3,5
51207,3,1,3,12,19
51208,0,0,5,8,13
51210,2,2,4,17,25
51211,0,2,9,38,49
51212,0,0,12,27,39
51213,0,1,4,4,9
51214,0,0,3,0,3
51215,5,1,5,28,39
51216,0,0,9,6,15
51217,0,0,1,8,9
51218,0,1,0,4,5
51219,0,5,2,14,21
51221,1,0,14,22,37
51222,1,0,9,25,35
51223,0,0,0,19,19
51224,2,0,8,16,26
51225,2,2,4,17,25
51226,0,0,12,12,24
51227,0,0,2,10,12
51228,0,0,5,16,21
51229,0,0,11,24,35
51230,0,0,11,12,23
51231,0,0,5,18,23
51232,0,5,2,14,21
51233,3,1,3,12,19
51234,1,2,4,42,49
51235,0,0,6,18,24
51236,1,3,6,39,49
51237,0,0,1,10,11
51238,0,0,12,5,17
51239,0,0,7,17,24
51240,1,1,11,37,50
51241,0,0,10,31,41
51242,0,1,0,4,5
51243,0,0,5,16,21
51244,0,0,0,2,2
51245,0,1,0,4,5
51247,0,0,10,31,41
51248,0,0,5,4,9
51250,1,1,11,37,50
51251,0,0,15,32,47
51252,0,0,13,30,43
51253,0,0,5,20,25
51254,1,1,5,34,41
51255,3,1,3,12,19
51256,0,2,6,10,18
51257,1,3,6,39,49
51258,2,2,4,17,25
51259,1,6,1,9,17
51260,2,1,9,30,42
51261,0,0,0,5,5
51262,0,0,11,9,20
51263,1,0,5,20,26
51264,1,0,1,24,26
51265,0,3,3,18,24
51266,0,0,9,22,31
51267,0,1,3,20,24
51268,0,1,13,33,47
51269,0,0,1,14,15
51270,0,0,14,32,46
51271,0,0,16,32,48
51272,0,1,8,39,48
51273,1,0,1,8,10
51274,0,1,6,22,29
51275,0,0,3,14,17
51276,0,1,2,16,19
51277,0,2,7,41,50
51278,0,1,3,17,21
51280,0,1,3,0,4
51281,0,0,1,12,13
51282,0,0,4,9,13
51283,0,0,16,24,40
51284,0,0,6,5,11
51285,0,0,1,7,8
51286,0,0,5,11,16
51289,0,0,6,7,13
51290,0,0,6,18,24
51291,1,0,10,13,24
51292,0,0,3,13,16
51293,0,1,6,19,26
51294,0,0,3,23,26
51295,0,0,4,17,21
51296,0,1,5,17,23
51297,0,0,1,6,7
51298,0,1,6,18,25
51299,0,0,9,25,34
51300,2,1,9,30,42
51301,0,0,21,25,46
51302,0,0,2,9,11
51303,0,1,5,5,11
51304,0,0,5,15,20
51305,0,0,0,6,6
51306,0,0,0,7,7
51307,0,0,5,17,22
51308,0,0,0,8,8
51309,0,0,6,24,30
51310,0,0,3,11,14
51311,0,2,5,18,25
51312,0,0,3,8,11
51313,0,0,6,14,20
51314,0,1,4,8,13
51315,0,0,13,26,39
51316,0,0,15,33,48
51317,0,0,3,1,4
51318,0,2,13,32,47
51319,0,0,1,12,13
51320,0,0,0,13,13
51321,0,0,0,9,9
51322,0,0,8,30,38
51323,1,3,6,13,23
51324,0,0,6,9,15
51325,0,0,10,7,17
51327,0,0,2,2,4
51330,0,2,2,12,16
51331,0,0,4,16,20
51332,0,0,3,5,8
51333,0,2,1,10,13
51334,0,0,0,3,3
51335,0,0,0,4,4
51336,1,0,7,14,22
51337,0,0,7,13,20
51338,0,0,11,17,28
51339,0,0,5,6,11
51340,0,0,8,24,32
51341,0,3,3,16,22
51342,0,0,5,4,9
51343,0,0,5,4,9
51344,0,0,3,8,11
51345,1,1,7,6,15
51346,0,0,7,9,16
51347,0,0,9,11,20
51348,0,0,1,17,18
51349,0,3,7,24,34
51350,0,0,5,10,15
51351,0,0,4,2,6
51352,0,0,15,34,49
51353,0,1,1,13,15
51354,0,2,6,22,30
51355,0,0,6,15,21
51356,0,1,1,16,18
51358,0,0,1,11,12
51359,0,1,4,15,20
51360,0,0,12,7,19
51361,0,0,4,3,7
51362,0,0,10,6,16
51363,1,0,3,10,14
51364,0,0,8,7,15
51365,0,0,2,7,9
51366,0,0,4,13,17
51368,0,0,11,9,20
51369,0,0,8,13,21
51370,0,0,5,12,17
51371,0,0,5,11,16
51372,0,0,0,2,2
51373,0,0,15,10,25
51374,0,0,3,2,5
51375,0,0,4,6,10
51376,0,0,6,19,25
51377,0,0,0,14,14
51378,0,0,6,12,18
51379,0,0,5,11,16
51380,0,0,8,10,18
51381,0,0,17,25,42
51382,0,0,8,3,11
51383,0,0,8,16,24
51385,0,0,0,18,18
51386,0,0,4,25,29
51387,0,0,3,13,16
51388,0,0,5,19,24
51389,0,0,6,14,20
51390,0,1,8,6,15
51391,0,1,8,41,50
51392,0,2,12,31,45
51393,0,0,7,8,15
51394,0,0,3,9,12
51395,0,0,0,6,6
51396,2,0,6,4,12
51397,0,0,12,18,30
51398,0,1,6,4,11
51399,0,0,4,13,17
51400,0,0,6,15,21
51401,0,0,1,5,6
51402,0,0,14,26,40
51403,1,0,1,13,15
51404,0,1,8,2,11
51405,0,0,3,18,21
51406,0,0,4,15,19
51407,0,0,8,14,22
51408,0,0,8,7,15
51409,0,0,13,25,38
51410,0,0,1,2,3
51411,0,0,11,19,30
51412,0,0,8,24,32
51413,0,2,5,13,20
51414,0,0,2,10,12
51415,0,0,3,16,19
51416,0,0,2,3,5
51417,0,0,11,9,20
51418,0,1,3,7,11
51419,0,0,5,9,14
51420,1,0,2,13,16
51421,0,0,8,19,27
51422,0,1,4,9,14
51423,0,0,0,5,5
51424,0,0,4,8,12
51425,0,0,3,17,20
51426,0,2,2,18,22
51427,0,0,3,7,10
51428,0,1,5,6,12
51429,0,0,7,19,26
51430,0,1,4,21,26
51431,0,0,11,19,30
51432,0,0,4,9,13
51433,0,0,3,12,15
51434,0,0,2,4,6
51436,0,0,7,12,19
51438,0,0,6,4,10
51439,0,0,2,6,8
51440,0,1,3,5,9
51441,2,0,2,10,14
51442,0,1,2,12,15
51443,0,1,4,13,18
51444,0,0,1,5,6
51445,0,0,8,12,20
51446,0,0,6,3,9
51447,0,0,7,18,25
51448,0,0,4,12,16
51449,0,0,8,18,26
51450,0,0,3,2,5
51451,0,0,7,12,19
51452,0,0,4,13,17
51453,0,0,6,18,24
51454,0,1,6,14,21
51455,0,0,7,19,26
51456,0,2,6,14,22
51457,0,0,3,7,10
51458,0,1,5,6,12
51459,0,0,0,5,5
51460,0,2,10,27,39
51461,0,0,14,19,33
51462,0,0,4,11,15
51463,0,0,6,27,33
51464,0,1,7,10,18
51465,0,0,6,3,9
51466,0,0,2,6,8
51467,0,0,1,5,6
51468,0,0,6,11,17
51469,0,0,2,8,10
51470,0,0,11,22,33
51471,0,0,7,19,26
51472,0,1,4,18,23
51473,0,0,6,11,17
51474,0,0,8,8,16
51475,0,0,8,14,22
51476,0,0,7,11,18
51477,0,1,19,29,49
51478,0,0,4,16,20
51479,0,0,9,2,11
51480,0,0,8,7,15
51481,0,0,16,24,40
51482,0,0,11,16,27
51483,0,0,1,17,18
51484,0,0,14,13,27
51485,0,0,3,2,5
51486,2,2,4,17,25
51487,0,0,12,23,35
51488,0,0,5,3,8
51490,0,0,9,23,32
51491,0,0,9,8,17
51492,0,1,4,11,16
51493,0,0,1,1,2
51494,0,0,9,20,29
51495,0,0,4,19,23
51496,0,0,2,7,9
51497,0,2,12,36,50
51498,0,0,6,5,11
51499,0,0,8,6,14
51501,0,0,2,24,26
51502,0,0,11,16,27
51503,0,0,1,7,8
51504,0,0,6,19,25
51505,0,0,7,10,17
51506,0,0,4,13,17
51507,0,0,6,19,25
51508,0,1,5,17,23
51509,0,0,8,14,22
51510,0,1,10,33,44
51511,1,0,10,27,38
51512,0,0,5,7,12
51513,0,1,7,32,40
51514,0,1,0,8,9
51515,0,2,1,23,26
51516,0,0,2,10,12
51517,0,1,2,5,8
51518,0,1,2,7,10
51520,1,0,11,31,43
51521,0,1,7,25,33
51522,0,0,3,7,10
51523,0,0,5,7,12
51524,0,0,12,17,29
51525,0,0,1,3,4
51526,0,1,5,6,12
51527,0,1,5,9,15
51528,0,0,3,3,6
51529,0,0,6,17,23
51530,0,0,7,4,11
51531,0,0,2,20,22
51532,0,0,12,21,33
51533,0,0,6,12,18
51534,0,0,5,1,6
51535,0,0,1,3,4
51536,0,2,3,14,19
51537,1,0,1,3,5
51538,0,0,8,7,15
51539,0,0,10,13,23
51540,0,0,9,28,37
51541,0,0,3,11,14
51542,0,0,5,3,8
51543,1,2,6,23,32
51544,0,0,7,3,10
51545,0,0,13,37,50
51546,0,0,1,3,4
51547,0,1,6,19,26
51548,0,0,7,7,14
51550,0,0,4,8,12
51551,0,0,2,5,7
51552,0,1,6,11,18
51553,0,0,4,19,23
51554,0,0,6,24,30
51555,0,0,5,4,9
51556,0,0,6,12,18
51557,0,1,4,20,25
51558,0,0,2,1,3
51559,0,0,11,17,28
51560,0,0,4,20,24
51561,0,0,3,8,11
51562,0,0,5,11,16
51563,0,0,12,16,28
51564,0,0,1,12,13
51565,0,0,0,9,9
51566,0,0,7,11,18
51567,0,0,12,13,25
51568,0,0,4,13,17
51570,0,1,7,22,30
51571,0,0,4,7,11
51572,0,0,13,18,31
51573,0,0,6,10,16
51574,0,2,7,16,25
51575,0,0,2,3,5
51576,0,0,5,8,13
51577,0,0,6,8,14
51578,0,0,5,12,17
51579,0,0,3,3,6
51580,0,0,0,7,7
51581,0,0,4,8,12
51582,0,1,5,10,16
51583,1,1,11,30,43
51584,0,0,2,8,10
51585,0,0,3,8,11
51586,2,1,5,25,33
51588,0,0,14,8,22
51590,0,0,6,19,25
51591,0,0,9,9,18
51592,0,1,12,31,44
51593,0,2,17,28,47
51594,0,0,0,1,1
51595,0,0,7,9,16
51596,1,0,10,17,28
51597,0,0,4,17,21
51598,0,2,16,18,36
51599,0,0,5,1,6
51600,0,0,8,6,14
51601,0,0,4,5,9
51602,0,1,3,7,11
51603,0,0,11,18,29
51605,0,1,4,7,12
51607,0,0,5,11,16
51608,0,0,2,6,8
51609,0,0,12,17,29
51610,0,0,3,7,10
51611,0,0,7,14,21
51612,0,0,2,9,11
51613,0,0,4,11,15
51614,0,0,4,18,22
51615,0,1,6,12,19
51616,2,0,1,40,43
51618,0,0,8,14,22
51619,0,0,1,13,14
51620,0,0,10,22,32
51621,0,0,10,20,30
51622,0,0,9,13,22
51623,0,2,2,2,6
51624,0,0,3,2,5
51625,0,1,0,17,18
51626,0,0,3,15,18
51627,0,0,20,26,46
51628,0,0,0,5,5
51629,0,0,2,5,7
51630,0,0,7,9,16
51631,0,0,5,6,11
51633,0,2,16,21,39
51634,0,0,5,12,17
51635,0,0,8,17,25
51636,0,0,9,29,38
51637,0,0,0,5,5
51638,0,0,3,15,18
51639,0,0,1,4,5
51640,1,0,5,17,23
51641,0,0,0,3,3
51642,0,0,4,29,33
51643,0,0,5,13,18
51644,0,1,7,24,32
51645,0,0,2,0,2
51646,0,0,1,12,13
51647,0,0,2,8,10
51649,4,0,0,12,16
51651,0,0,5,11,16
51652,0,0,9,11,20
51653,0,0,5,10,15
51654,0,0,0,8,8
51656,1,0,6,16,23
51657,0,0,2,3,5
51658,0,0,9,10,19
51659,1,0,1,24,26
51660,0,0,10,27,37
51661,0,2,9,38,49
51662,1,0,5,20,26
51663,0,0,1,13,14
51664,0,0,5,11,16
51665,0,0,1,8,9
51666,0,1,0,4,5
51667,0,0,4,4,8
51668,0,0,8,6,14
51669,0,1,3,3,7
51670,0,0,1,9,10
51671,0,5,4,7,16
51672,1,0,0,4,5
51673,1,2,2,10,15
51674,0,3,1,9,13
51675,0,0,0,2,2
51676,0,3,6,11,20
51677,0,1,14,27,42
51678,0,2,6,32,40
51679,0,0,4,18,22
51680,0,0,21,25,46
51681,0,0,6,23,29
51682,0,0,10,33,43
51683,1,3,6,39,49
51684,0,0,9,21,30
51685,0,0,4,7,11
51686,0,0,5,4,9
51687,0,0,7,10,17
51688,0,0,18,32,50
51689,0,1,1,10,12
51690,0,0,9,15,24
51691,0,1,16,27,44
51692,0,0,4,12,16
51693,0,0,0,5,5
51694,0,1,14,25,40
51695,0,0,7,7,14
51696,0,0,3,9,12
51697,2,0,8,35,45
51698,0,0,4,12,16
51699,0,0,11,32,43
51700,0,0,8,8,16
51701,0,1,4,16,21
51702,0,0,8,20,28
51703,0,1,10,39,50
51704,1,0,14,31,46
51705,0,0,9,25,34
51707,0,0,12,31,43
51708,0,0,5,9,14
51709,0,3,3,44,50
51710,0,0,18,25,43
51711,1,0,11,30,42
51712,2,0,4,7,13
51713,0,0,6,11,17
51714,0,0,4,5,9
51715,0,0,8,10,18
51716,0,0,1,4,5
51717,0,0,6,4,10
51718,0,0,1,2,3
51719,0,0,4,4,8
51720,0,0,9,14,23
51721,0,0,5,8,13
51722,0,1,7,30,38
51723,2,1,18,29,50
51724,0,0,11,16,27
51725,0,0,10,39,49
51726,1,1,0,8,10
51727,0,0,3,11,14
51728,0,0,6,19,25
51729,0,0,8,21,29
51730,0,0,8,6,14
51731,0,1,7,13,21
51732,0,0,7,16,23
51733,0,0,9,18,27
51734,0,0,7,19,26
51735,0,0,2,16,18
51736,0,0,4,3,7
51738,0,2,4,15,21
51739,1,1,11,37,50
51740,0,0,6,18,24
51741,0,0,6,19,25
51742,1,0,10,39,50
51745,2,5,6,23,36
51746,1,1,6,11,19
51747,0,0,9,10,19
51748,1,2,2,10,15
51749,0,0,10,6,16
51750,0,0,1,13,14
51751,0,0,6,27,33
51752,0,0,5,11,16
51753,0,1,0,4,5
51754,0,0,3,7,10
51755,0,0,4,4,8
51756,2,2,4,17,25
51757,0,1,6,12,19
51759,0,0,1,12,13
51760,0,0,1,12,13
51761,0,5,4,7,16
51762,0,0,1,9,10
51763,1,0,1,8,10
51764,0,0,1,16,17
51765,0,0,10,27,37
51766,0,1,3,38,42
51767,0,0,1,13,14
51768,0,2,6,32,40
51769,0,0,3,14,17
51770,0,0,10,33,43
51771,0,0,1,13,14
51773,2,2,4,17,25
51774,0,0,7,19,26
51775,3,1,12,28,44
51776,1,3,6,39,49
51777,0,0,9,27,36
51778,0,0,1,6,7
51779,0,0,1,24,25
51780,1,1,11,37,50
51781,0,1,0,4,5
51782,0,0,13,6,19
51783,0,2,2,12,16
51784,0,1,0,4,5
51785,0,0,0,2,2
51786,1,0,0,4,5
51787,1,0,1,24,26
51788,1,1,11,37,50
51789,0,0,6,27,33
51790,0,3,3,44,50
51791,0,2,2,19,23
51792,2,5,6,23,36
51793,0,0,16,24,40
51794,0,0,6,18,24
51795,0,0,14,32,46
51796,1,3,6,39,49
51798,0,1,10,33,44
51799,0,0,2,24,26
51800,2,2,4,17,25
51801,1,1,11,30,43
51802,0,0,1,12,13
51803,0,0,9,18,27
51804,0,0,0,10,10
51805,0,0,3,7,10
51806,0,0,7,22,29
51807,0,1,6,14,21
51808,0,1,2,3,6
51809,0,0,3,4,7
51810,0,0,7,10,17
51811,0,0,3,4,7
51812,0,0,6,8,14
51813,0,0,10,6,16
51814,1,0,9,32,42
51815,0,0,11,26,37
51816,0,0,4,3,7
51817,0,0,11,17,28
51818,0,0,1,20,21
51819,0,0,3,30,33
51820,0,0,7,23,30
51821,0,0,5,10,15
51822,0,1,2,14,17
51824,0,0,2,5,7
51825,1,1,9,39,50
51826,0,0,6,7,13
51827,0,0,7,6,13
51828,0,0,15,28,43
51829,0,1,4,9,14
51830,0,1,1,18,20
51831,0,0,3,4,7
51832,0,0,9,19,28
51833,0,0,2,0,2
51834,0,0,5,10,15
51835,0,0,5,18,23
51836,0,0,1,8,9
51837,1,0,11,30,42
51838,0,0,0,7,7
51839,0,0,6,3,9
51840,0,0,2,15,17
51841,0,1,8,31,40
51844,0,0,7,7,14
51845,0,0,7,8,15
51846,0,1,15,17,33
51847,0,0,11,19,30
51848,0,0,8,22,30
51849,1,0,6,18,25
51850,0,0,3,1,4
51851,0,0,2,34,36
51852,0,0,3,2,5
51853,0,0,3,11,14
51854,0,1,7,15,23
51855,0,0,4,11,15
51856,0,0,8,10,18
51857,0,0,2,25,27
51858,0,0,3,4,7
51859,0,0,1,4,5
51860,0,0,0,1,1
51861,0,0,4,7,11
51862,0,0,0,6,6
51863,0,0,0,5,5
51864,4,1,11,24,40
51865,0,0,13,20,33
51866,0,0,8,16,24
51867,0,1,3,15,19
51868,0,0,5,5,10
51869,0,1,7,15,23
51870,0,0,2,9,11
51871,1,0,2,24,27
51872,0,0,2,8,10
51873,0,0,0,3,3
51874,0,0,5,9,14
51875,0,1,0,7,8
51876,0,0,2,15,17
51877,0,1,11,13,25
51878,0,0,11,24,35
51879,0,0,1,11,12
51880,0,2,3,19,24
51881,0,0,10,19,29
51882,0,0,3,7,10
51883,0,0,1,2,3
51884,0,0,3,3,6
51885,0,1,3,13,17
51886,0,0,3,16,19
51887,0,2,5,21,28
51888,0,1,15,10,26
51889,0,0,5,13,18
51890,0,0,8,24,32
51891,0,1,1,7,9
51892,0,1,6,3,10
51893,0,0,7,12,19
51894,0,0,10,7,17
51895,0,0,6,15,21
51896,0,0,1,11,12
51897,0,0,12,14,26
51898,0,2,2,5,9
51899,0,0,12,22,34
51900,0,0,6,11,17
51901,0,0,2,9,11
51902,0,0,5,6,11
51903,0,0,5,21,26
51904,0,0,5,3,8
51905,0,0,3,2,5
51906,0,1,8,11,20
51907,0,0,9,9,18
51908,0,0,3,18,21
51909,0,0,5,9,14
51910,0,0,9,18,27
51911,0,0,15,33,48
51912,0,0,2,3,5
51913,2,1,9,23,35
51915,0,0,9,10,19
51916,0,0,7,7,14
51917,0,0,8,18,26
51918,0,2,7,10,19
51919,0,0,0,6,6
51920,0,0,9,13,22
51921,0,0,10,18,28
51922,1,1,2,13,17
51923,0,0,4,9,13
51924,0,0,0,10,10
51925,0,0,1,11,12
51926,1,0,1,10,12
51927,0,1,3,17,21
51928,0,0,1,8,9
51929,0,0,14,35,49
51931,0,0,11,19,30
51932,0,0,7,11,18
51933,0,0,1,4,5
51934,1,0,5,8,14
51935,0,0,3,7,10
51936,0,0,7,35,42
51937,0,1,5,17,23
51938,0,0,6,29,35
51939,1,0,0,13,14
51940,0,0,1,4,5
51941,0,0,3,20,23
51942,0,1,2,6,9
51943,0,0,3,16,19
51945,0,0,1,4,5
51946,0,0,0,5,5
51947,0,1,8,22,31
51948,0,0,1,2,3
51949,0,0,2,12,14
51950,0,0,4,4,8
51951,0,0,9,31,40
51952,1,0,1,16,18
51953,0,1,0,13,14
51954,0,0,5,11,16
51955,0,0,13,27,40
51956,0,0,2,3,5
51957,0,0,2,5,7
51958,0,0,6,11,17
51959,0,0,0,4,4
51960,0,0,4,2,6
51961,0,0,3,7,10
51962,0,0,5,14,19
51963,0,0,9,19,28
51964,0,0,6,2,8
51965,0,1,14,23,38
51966,0,0,6,10,16
51967,0,0,10,6,16
51968,0,0,12,21,33
51969,0,0,8,13,21
51970,0,0,5,12,17
51971,0,1,3,13,17
51972,0,0,4,3,7
51973,0,1,5,8,14
51974,0,0,3,15,18
51975,0,0,9,14,23
51976,0,0,0,5,5
51977,0,0,12,28,40
51978,0,0,9,15,24
51979,0,0,6,18,24
51980,0,2,6,18,26
51981,0,0,3,12,15
51982,0,0,10,16,26
51983,0,0,5,10,15
51984,0,0,9,11,20
51986,0,0,2,9,11
51987,0,0,6,13,19
51988,0,1,1,11,13
51989,1,0,5,17,23
51990,0,1,3,8,12
51991,0,0,0,5,5
51992,0,0,4,9,13
51993,0,1,11,27,39
51994,2,0,1,7,10
51995,0,0,9,21,30
51996,0,0,4,26,30
51997,1,0,6,16,23
51998,0,1,10,10,21
51999,0,0,9,17,26
52000,0,2,9,29,40
52001,0,0,7,17,24
52003,0,0,9,30,39
52004,0,0,1,5,6
52005,0,0,8,9,17
52006,0,0,6,11,17
52007,0,0,6,11,17
52008,0,0,5,24,29
52009,0,2,14,33,49
52010,0,0,5,17,22
52012,0,0,0,5,5
52014,1,1,5,19,26
52015,2,0,6,37,45
52017,0,0,12,11,23
52018,0,0,6,8,14
52019,0,0,8,14,22
52020,1,0,4,29,34
52021,0,0,4,4,8
52022,0,0,1,0,1
52023,1,0,1,3,5
52024,1,0,4,4,9
52026,0,0,6,2,8
52027,0,1,2,8,11
52030,1,0,1,11,13
52031,0,0,3,12,15
52033,0,3,1,9,13
52034,0,0,4,2,6
52035,0,1,4,15,20
52036,0,0,4,10,14
52037,1,0,3,18,22
52038,0,2,8,25,35
52039,0,0,11,15,26
52041,0,0,0,5,5
52042,0,0,2,3,5
52043,0,0,6,11,17
52044,0,0,5,8,13
52045,1,0,9,32,42
52046,0,3,5,25,33
52048,0,1,3,18,22
52049,0,0,2,4,6
52050,1,1,5,27,34
52051,0,0,5,7,12
52052,0,0,3,13,16
52053,0,0,1,13,14
52054,0,2,4,17,23
52055,1,0,10,39,50
52056,1,0,3,23,27
52057,0,0,5,8,13
52058,0,0,12,38,50
52059,0,0,6,16,22
52060,0,0,6,11,17
52061,0,1,2,14,17
52062,1,0,6,30,37
52063,0,1,9,18,28
52064,0,0,13,37,50
52065,0,1,11,16,28
52066,0,0,7,27,34
52067,0,0,1,14,15
52068,0,0,4,10,14
52069,1,0,3,18,22
52070,0,0,1,10,11
52071,0,0,1,7,8
52072,1,2,3,13,19
52073,0,1,10,33,44
52074,0,0,13,20,33
52075,0,0,3,15,18
52076,1,1,17,30,49
52077,0,4,4,23,31
52078,0,0,10,30,40
52079,0,0,4,1,5
52080,0,0,1,42,43
52081,0,0,12,18,30
52082,0,1,18,22,41
52083,0,0,5,9,14
52084,0,0,11,33,44
52085,0,0,12,38,50
52086,0,2,15,27,44
52087,0,0,8,7,15
52088,0,1,10,14,25
52089,0,1,6,9,16
52090,0,0,4,9,13
52091,1,0,3,6,10
52092,1,0,7,18,26
52093,0,0,7,18,25
52094,1,0,2,8,11
52095,0,0,10,30,40
52096,0,0,9,13,22
52097,0,1,3,25,29
52098,0,0,11,23,34
52099,0,0,6,17,23
52100,1,1,2,44,48
52101,0,0,11,24,35
52102,0,0,13,9,22
52104,0,0,7,14,21
52105,0,0,9,7,16
52106,1,1,15,25,42
52107,0,0,14,21,35
52108,0,2,8,19,29
52109,0,0,7,23,30
52110,0,0,11,15,26
52112,0,0,5,7,12
52113,0,0,8,20,28
52114,0,0,16,29,45
52115,1,1,10,19,31
52116,0,0,1,2,3
52117,0,0,9,41,50
52118,0,0,5,10,15
52119,0,0,1,8,9
52120,0,0,3,6,9
52121,0,0,0,6,6
52122,0,0,7,17,24
52123,0,0,4,4,8
52124,0,0,16,34,50
52125,0,0,4,0,4
52126,0,0,2,2,4
52127,0,1,12,35,48
52128,0,1,12,29,42
52129,0,0,2,4,6
52130,2,0,1,28,31
52131,0,0,7,9,16
52132,0,0,4,7,11
52133,0,0,4,10,14
52134,0,1,4,14,19
52135,0,1,5,21,27
52136,0,0,3,24,27
52137,0,0,0,9,9
52138,0,0,4,3,7
52139,0,0,16,33,49
52140,0,0,4,3,7
52141,0,0,9,13,22
52142,0,1,3,12,16
52143,0,0,6,13,19
52146,0,0,7,31,38
52147,0,2,0,7,9
52148,0,0,8,23,31
52149,0,0,6,25,31
52150,0,6,4,12,22
52151,0,1,4,11,16
52152,0,0,2,12,14
52153,0,0,9,14,23
52154,0,0,8,25,33
52155,4,0,10,29,43
52156,0,2,4,15,21
52158,0,0,11,11,22
52159,0,0,8,11,19
52160,0,0,1,11,12
52161,0,0,7,7,14
52162,1,0,0,16,17
52163,0,1,4,15,20
52164,0,0,10,19,29
52165,1,1,5,43,50
52166,1,0,9,32,42
52167,0,0,3,2,5
52168,0,0,0,5,5
52169,0,1,3,18,22
52170,0,2,2,5,9
52171,0,0,5,11,16
52172,0,1,14,23,38
52173,1,1,5,27,34
52174,0,0,5,7,12
52175,2,0,1,7,10
52176,0,0,3,7,10
52177,0,0,4,17,21
52178,0,0,10,25,35
52179,0,1,2,12,15
52180,0,2,8,19,29
52181,1,2,3,13,19
52182,0,0,3,21,24
52183,1,3,9,37,50
52184,1,0,10,39,50
52185,0,0,1,14,15
52186,0,0,2,18,20
52187,0,0,6,7,13
52188,0,1,5,11,17
52189,0,0,11,21,32
52190,0,0,7,13,20
52191,0,0,11,38,49
52193,0,0,7,22,29
52195,1,0,0,16,17
52196,0,1,12,29,42
52197,0,0,7,22,29
52198,0,0,6,7,13
52199,0,0,5,7,12
52200,0,0,15,14,29
52201,0,0,3,7,10
52202,0,0,16,34,50
52203,2,1,9,23,35
52204,0,0,10,5,15
52205,0,1,6,20,27
52206,0,0,11,9,20
52207,0,0,7,11,18
52208,2,0,7,27,36
52209,0,0,1,12,13
52210,0,1,2,6,9
52211,0,0,4,13,17
52212,0,0,2,13,15
52213,0,5,3,23,31
52214,0,0,8,12,20
52215,0,0,5,19,24
52216,0,0,2,4,6
52217,0,0,4,16,20
52218,0,0,6,8,14
52219,0,0,3,15,18
52220,0,0,3,12,15
52221,0,0,9,21,30
52222,0,0,2,18,20
52223,0,0,4,22,26
52224,0,1,5,21,27
52225,0,0,9,37,46
52226,0,0,4,11,15
52227,0,0,11,39,50
52228,0,0,5,15,20
52229,0,0,3,8,11
52230,1,3,3,33,40
52231,0,0,7,20,27
52232,0,0,2,6,8
52234,0,0,3,4,7
52235,0,2,8,36,46
52237,0,0,10,23,33
52238,0,0,3,3,6
52239,0,0,4,3,7
52240,0,0,4,13,17
52241,0,0,6,12,18
52242,0,0,14,35,49
52243,1,1,3,14,19
52244,0,0,6,7,13
52245,0,0,1,6,7
52247,0,0,5,19,24
52249,0,0,7,16,23
52250,0,0,1,12,13
52251,0,0,8,17,25
52252,0,0,6,13,19
52253,0,0,10,13,23
52254,0,0,6,3,9
52255,0,0,2,15,17
52256,0,0,5,5,10
52257,0,0,2,2,4
52258,0,0,9,28,37
52259,0,0,6,2,8
52261,0,0,2,17,19
52262,0,1,10,39,50
52263,0,0,8,1,9
52264,0,0,5,1,6
52265,1,0,0,5,6
52266,0,0,6,8,14
52267,0,0,2,12,14
52268,0,0,6,9,15
52269,0,0,8,14,22
52270,0,0,3,8,11
52271,0,0,5,1,6
52272,0,0,3,10,13
52273,0,0,13,17,30
52274,1,0,7,26,34
52275,0,0,11,15,26
52276,0,0,4,7,11
52277,0,2,4,23,29
52278,0,0,9,10,19
52279,0,0,6,15,21
52280,0,0,7,11,18
52281,0,1,4,13,18
52282,0,0,6,12,18
52283,0,1,8,32,41
52284,0,0,4,4,8
52285,0,0,6,8,14
52286,0,0,1,4,5
52287,0,0,2,14,16
52288,0,0,11,17,28
52290,0,0,0,6,6
52291,0,0,5,9,14
52292,0,0,1,1,2
52293,0,0,0,3,3
52294,1,0,5,5,11
52295,0,1,9,12,22
52296,0,0,9,8,17
52297,0,0,12,23,35
52298,0,1,4,19,24
52299,0,0,5,12,17
52300,0,0,3,8,11
52301,0,1,7,16,24
52302,0,0,0,3,3
52303,0,0,8,20,28
52304,1,2,6,11,20
52305,0,0,1,9,10
52306,0,0,1,21,22
52307,0,0,3,4,7
52308,0,0,8,9,17
52309,0,0,5,18,23
52310,0,1,2,19,22
52311,0,0,2,4,6
52312,0,0,5,3,8
52313,0,1,7,9,17
52314,0,0,9,13,22
52315,0,0,1,3,4
52316,0,0,6,7,13
52317,1,0,3,4,8
52318,0,0,5,6,11
52319,1,0,1,12,14
52320,0,0,6,9,15
52323,0,1,11,25,37
52324,0,0,10,15,25
52325,0,0,8,15,23
52326,0,0,8,15,23
52327,0,0,7,1,8
52328,0,0,6,10,16
52329,0,0,7,11,18
52330,0,0,3,7,10
52331,0,0,2,0,2
52332,0,0,5,7,12
52333,0,0,11,8,19
52334,0,0,4,13,17
52337,0,3,9,17,29
52338,0,0,9,3,12
52339,0,0,8,8,16
52340,0,0,5,9,14
52343,0,0,6,13,19
52344,0,0,7,20,27
52345,0,0,4,5,9
52347,0,0,10,19,29
52348,1,0,1,13,15
52349,0,0,4,4,8
52350,0,0,8,4,12
52351,0,0,0,7,7
52352,0,0,8,12,20
52354,0,0,6,3,9
52355,0,0,5,7,12
52356,0,0,2,4,6
52357,0,0,5,24,29
52359,0,0,2,7,9
52360,0,0,7,15,22
52362,0,0,12,13,25
52363,0,0,6,6,12
52364,1,1,11,37,50
52365,0,0,6,12,18
52366,0,0,1,8,9
52367,0,1,4,10,15
52368,0,0,0,15,15
52369,0,0,8,4,12
52372,0,2,1,23,26
52373,0,0,2,5,7
52374,0,1,14,23,38
52375,0,0,6,27,33
52377,0,1,9,20,30
52378,0,0,2,7,9
52379,0,0,4,7,11
52380,0,0,11,9,20
52381,1,0,12,22,35
52382,1,0,20,29,50
52383,1,1,11,37,50
52384,1,0,7,29,37
52385,0,2,11,35,48
52386,1,3,3,33,40
52387,0,0,9,16,25
52388,0,0,10,23,33
52389,0,0,9,39,48
52390,0,0,7,34,41
52391,0,1,15,32,48
52392,0,0,6,10,16
52393,0,0,7,18,25
52394,0,0,4,10,14
52395,1,0,3,34,38
52396,0,0,3,6,9
52397,0,0,21,26,47
52398,0,0,15,27,42
52399,0,0,3,19,22
52400,1,0,2,32,35
52401,0,1,13,30,44
52402,1,0,5,8,14
52403,0,0,1,4,5
52404,0,0,16,30,46
52405,1,1,7,41,50
52406,0,0,8,24,32
52407,0,0,6,9,15
52408,0,0,5,5,10
52409,0,0,10,9,19
52410,0,1,2,47,50
52411,0,0,7,8,15
52412,0,0,8,24,32
52413,0,0,15,30,45
52414,0,2,5,43,50
52415,1,1,1,25,28
52416,0,0,2,20,22
52417,0,0,14,34,48
52418,0,0,7,11,18
52419,0,0,5,31,36
52420,0,0,8,16,24
52421,0,1,0,10,11
52422,0,0,12,26,38
52423,1,0,7,23,31
52424,0,2,1,23,26
52425,0,0,1,14,15
52426,0,0,10,10,20
52427,0,0,6,9,15
52428,0,0,5,6,11
52430,0,0,1,6,7
52431,0,0,0,5,5
52432,0,0,1,7,8
52433,0,0,7,20,27
52434,0,0,9,10,19
52435,0,0,0,6,6
52436,0,1,14,23,38
52437,0,1,4,19,24
52438,0,0,14,35,49
52439,0,0,6,27,33
52440,0,1,9,20,30
52442,0,0,5,7,12
52443,0,0,3,25,28
52444,0,0,1,3,4
52445,0,2,1,15,18
52446,5,1,5,39,50
52447,0,0,5,8,13
52448,0,2,2,38,42
52449,0,0,7,43,50
52450,0,0,0,15,15
52451,0,0,1,21,22
52452,0,2,11,35,48
52453,0,0,11,30,41
52454,1,0,8,21,30
52455,0,0,15,25,40
52456,0,0,2,5,7
52457,0,0,8,24,32
52458,0,0,12,38,50
52459,1,1,11,37,50
52460,0,5,3,23,31
52461,1,1,11,37,50
52462,0,0,12,38,50
52463,0,0,11,39,50
52464,0,0,6,27,33
52465,0,0,7,43,50
52466,0,0,21,26,47
52467,0,0,1,14,15
52468,0,0,11,20,31
52469,0,2,4,16,22
52471,0,0,1,4,5
52472,0,0,6,14,20
52473,0,0,1,7,8
52474,0,2,4,2,8
52475,0,0,5,4,9
52476,0,0,3,7,10
52477,0,0,0,10,10
52478,0,0,8,21,29
52479,0,2,6,3,11
52480,0,0,5,7,12
52481,0,3,1,13,17
52482,0,0,2,4,6
52483,0,0,6,4,10
52484,1,0,8,14,23
52485,1,0,13,27,41
52486,0,1,13,17,31
52487,0,2,7,41,50
52488,0,0,8,22,30
52489,0,0,8,20,28
52490,0,0,6,44,50
52491,0,0,4,12,16
52492,1,1,4,22,28
52494,0,0,13,29,42
52495,0,0,9,31,40
52496,0,0,4,25,29
52497,1,2,17,23,43
52498,0,0,13,21,34
52499,0,1,4,15,20
52500,0,0,2,17,19
52501,0,0,13,37,50
52502,0,0,5,3,8
52503,0,0,1,7,8
52504,0,0,2,11,13
52505,0,0,5,24,29
52506,0,0,15,32,47
52507,0,0,3,12,15
52508,0,1,9,39,49
52509,0,5,4,30,39
52510,0,1,8,20,29
52511,0,1,3,0,4
52512,0,0,5,11,16
52513,0,0,3,8,11
52514,0,0,8,20,28
52515,0,2,6,22,30
52517,2,0,5,23,30
52518,0,0,3,21,24
52519,0,0,6,19,25
52520,0,0,2,12,14
52521,0,0,0,8,8
52522,0,1,4,30,35
52523,0,0,6,7,13
52524,1,4,9,31,45
52525,0,0,10,23,33
52526,0,0,7,23,30
52527,0,1,12,8,21
52528,0,1,14,35,50
52529,0,1,0,37,38
52530,0,0,2,9,11
52531,0,0,9,13,22
52532,0,0,5,15,20
52533,0,0,0,4,4
52534,0,0,6,7,13
52535,0,0,6,13,19
52536,0,2,6,38,46
52537,0,0,3,20,23
52538,0,0,4,12,16
52539,0,0,5,14,19
52540,0,0,8,15,23
52541,0,2,3,16,21
52542,0,0,12,26,38
52543,0,2,13,32,47
52544,0,0,6,9,15
52545,0,0,7,25,32
52546,0,1,16,17,34
52547,0,0,6,24,30
52548,0,0,6,26,32
52549,0,0,3,9,12
52550,0,0,5,4,9
52551,0,0,3,8,11
52552,1,0,7,16,24
52553,0,0,11,12,23
52554,1,0,10,25,36
52555,2,0,3,14,19
52556,0,0,3,14,17
52557,0,0,2,20,22
52558,1,0,13,35,49
52559,0,0,6,14,20
52560,0,1,5,8,14
52561,0,0,10,28,38
52562,0,0,5,10,15
52563,0,0,3,15,18
52564,0,0,12,27,39
52565,0,0,4,6,10
52566,0,0,7,11,18
52568,0,0,16,33,49
52569,0,0,1,11,12
52570,0,0,5,25,30
52571,0,0,4,8,12
52572,0,0,13,37,50
52573,1,1,4,16,22
52575,0,0,4,3,7
52576,1,2,2,13,18
52577,0,0,2,21,23
52578,0,0,6,14,20
52579,0,0,16,20,36
52580,1,1,8,16,26
52581,0,1,4,16,21
52583,0,0,4,20,24
52584,0,0,2,8,10
52585,0,0,4,9,13
52586,0,0,13,31,44
52587,0,0,4,27,31
52588,0,1,5,17,23
52589,0,3,4,15,22
52590,0,0,7,8,15
52591,0,0,9,23,32
52592,0,0,6,19,25
52593,0,0,1,6,7
52594,0,0,8,16,24
52595,0,0,7,18,25
52596,0,0,4,34,38
52597,0,2,7,30,39
52598,0,1,13,36,50
52599,0,0,6,8,14
52600,0,0,6,7,13
52601,0,0,9,9,18
52602,0,0,0,39,39
52603,0,0,2,9,11
52604,1,1,3,17,22
52605,0,0,1,6,7
52606,0,1,3,19,23
52607,0,0,7,11,18
52608,0,1,16,33,50
52609,0,0,7,18,25
52610,0,0,5,11,16
52611,0,0,6,6,12
52612,0,0,0,1,1
52613,0,0,7,11,18
52614,0,0,8,11,19
52616,0,0,5,16,21
52617,0,1,11,19,31
52618,0,1,11,13,25
52619,0,0,4,5,9
52620,0,0,4,10,14
52621,0,3,12,26,41
52622,0,0,1,1,2
52623,0,0,1,9,10
52624,0,1,7,11,19
52625,0,0,9,25,34
52626,0,0,5,10,15
52627,0,2,14,29,45
52628,0,0,6,26,32
52629,0,0,6,30,36
52630,0,0,7,12,19
52631,0,0,10,19,29
52632,0,0,2,3,5
52633,0,0,5,13,18
52634,0,0,3,5,8
52635,0,0,4,1,5
52636,0,0,7,11,18
52638,0,0,6,24,30
52639,0,0,12,21,33
52640,0,0,7,19,26
52641,3,0,4,8,15
52642,0,0,7,19,26
52643,0,0,7,12,19
52644,0,0,7,20,27
52645,0,0,2,7,9
52646,0,0,5,10,15
52647,0,0,10,25,35
52648,0,0,9,17,26
52649,0,0,12,14,26
52650,0,0,2,5,7
52651,0,0,4,14,18
52652,0,0,7,21,28
52653,0,0,5,4,9
52654,0,0,3,2,5
52655,0,0,5,9,14
52656,0,0,3,12,15
52657,0,2,1,31,34
52658,0,0,4,11,15
52659,1,0,10,39,50
52660,0,0,8,13,21
52661,0,0,4,8,12
52662,0,0,7,9,16
52664,0,0,5,11,16
52665,0,0,9,10,19
52666,0,0,14,16,30
52667,0,0,1,5,6
52668,0,0,1,8,9
52669,1,0,8,27,36
52670,0,0,8,11,19
52671,0,0,4,16,20
52672,0,1,1,6,8
52673,0,0,7,16,23
52674,0,0,9,26,35
52675,0,0,1,1,2
52676,0,0,3,16,19
52677,0,0,10,10,20
52678,0,1,7,10,18
52679,0,0,4,3,7
52680,0,2,5,16,23
52681,0,0,2,7,9
52682,0,0,8,10,18
52683,0,0,3,2,5
52684,0,0,7,26,33
52685,0,0,3,4,7
52686,1,1,11,13,26
52687,0,0,7,2,9
52688,0,1,8,12,21
52689,0,0,7,4,11
52690,0,0,1,17,18
52691,0,0,4,20,24
52692,0,0,3,4,7
52693,2,2,13,22,39
52694,0,0,1,7,8
52695,1,3,14,32,50
52696,0,0,5,8,13
52697,0,0,10,21,31
52698,0,2,5,25,32
52699,0,1,1,18,20
52700,0,0,4,7,11
52701,0,0,12,21,33
52702,0,0,14,13,27
52703,0,0,1,6,7
52704,0,0,10,2,12
52705,0,0,5,15,20
52706,0,1,4,6,11
52707,0,1,10,3,14
52708,0,0,5,31,36
52709,0,0,1,12,13
52710,0,0,5,7,12
52711,0,0,0,3,3
52712,0,2,22,15,39
52713,0,0,3,7,10
52714,1,2,5,15,23
52715,0,0,1,14,15
52716,0,0,14,36,50
52717,0,1,4,18,23
52718,0,0,2,29,31
52719,0,0,6,6,12
52720,0,0,4,4,8
52721,0,0,3,17,20
52722,0,0,5,4,9
52723,0,0,13,26,39
52724,0,0,1,11,12
52725,0,0,3,18,21
52726,0,0,7,14,21
52727,0,0,1,15,16
52728,0,0,10,18,28
52729,0,0,5,12,17
52730,1,1,9,22,33
52731,0,0,6,21,27
52732,0,0,5,6,11
52733,0,0,7,3,10
52734,0,0,4,8,12
52735,0,0,6,8,14
52736,0,1,7,11,19
52737,0,1,4,15,20
52738,0,0,8,23,31
52739,0,1,12,26,39
52741,0,1,8,12,21
52742,0,0,3,16,19
52743,0,0,5,4,9
52744,0,0,2,4,6
52745,0,0,6,6,12
52747,0,1,11,21,33
52748,0,0,10,10,20
52749,0,0,4,7,11
52750,0,0,4,9,13
52751,0,0,0,8,8
52752,1,0,8,28,37
52753,0,0,4,14,18
52754,0,0,11,6,17
52755,0,0,6,10,16
52756,0,0,8,9,17
52757,0,0,3,30,33
52758,0,0,7,12,19
52759,0,0,0,5,5
52760,0,0,7,13,20
52761,0,0,10,12,22
52762,0,0,1,14,15
52763,0,0,7,11,18
52764,0,0,9,11,20
52765,0,0,8,9,17
52766,0,1,5,17,23
52767,0,0,6,14,20
52768,2,0,9,32,43
52769,0,0,4,8,12
52770,0,1,3,8,12
52771,0,1,12,28,41
52772,0,0,2,14,16
52773,1,2,2,10,15
52774,0,0,1,17,18
52775,0,0,3,9,12
52776,0,1,4,4,9
52777,0,0,6,12,18
52778,0,0,7,5,12
52779,0,0,3,9,12
52780,0,3,12,26,41
52781,0,0,1,7,8
52782,0,1,0,16,17
52783,0,0,7,9,16
52784,1,1,4,17,23
52785,0,0,7,15,22
52786,0,0,6,3,9
52787,0,0,10,13,23
52788,0,0,11,15,26
52789,0,0,4,5,9
52790,0,0,6,6,12
52792,0,0,6,26,32
52793,0,0,1,4,5
52794,0,0,2,3,5
52795,0,0,5,5,10
52796,0,0,8,3,11
52797,0,1,16,20,37
52798,0,0,11,6,17
52799,0,0,2,5,7
52800,0,0,2,13,15
52801,0,1,3,9,13
52803,0,0,4,9,13
52804,0,1,7,12,20
52805,0,0,5,4,9
52806,0,0,8,10,18
52807,0,0,3,18,21
52808,0,0,5,7,12
52809,0,0,7,14,21
52812,0,0,1,10,11
52813,0,0,3,5,8
52814,0,0,10,16,26
52815,0,0,3,7,10
52816,0,0,2,6,8
52817,0,0,4,2,6
52818,0,2,3,12,17
52819,0,0,4,12,16
52820,0,0,5,2,7
52822,0,0,6,9,15
52823,0,0,8,7,15
52824,0,1,5,12,18
52825,0,0,8,16,24
52826,0,1,4,19,24
52828,0,0,3,5,8
52829,0,0,4,16,20
52830,0,0,8,5,13
52831,1,1,8,24,34
52832,0,0,2,2,4
52833,0,0,6,3,9
52834,0,0,7,5,12
52835,2,1,4,10,17
52836,1,0,4,6,11
52837,1,0,6,18,25
52838,0,0,9,12,21
52839,0,0,3,4,7
52840,0,0,7,11,18
52841,0,0,2,4,6
52842,0,0,8,9,17
52843,0,0,8,10,18
52844,0,0,9,22,31
52845,0,0,9,15,24
52846,0,0,3,8,11
52847,0,0,5,3,8
52848,0,0,5,11,16
52849,0,0,7,24,31
52850,0,0,7,14,21
52851,0,0,10,18,28
52852,0,1,6,26,33
52853,0,0,14,16,30
52854,1,0,8,18,27
52855,0,2,2,21,25
52856,1,0,4,31,36
52857,1,0,6,43,50
52858,0,0,10,14,24
52859,0,2,18,29,49
52860,0,0,1,11,12
52861,0,1,9,17,27
52862,0,1,4,16,21
52863,1,0,0,4,5
52864,0,0,1,10,11
52865,0,0,10,12,22
52866,0,0,4,9,13
52867,0,1,7,5,13
52868,2,2,4,25,33
52869,0,0,6,20,26
52870,0,1,4,9,14
52871,0,0,6,12,18
52872,0,0,10,7,17
52873,0,0,8,15,23
52874,2,1,8,27,38
52875,0,0,7,13,20
52876,0,0,0,6,6
52877,0,0,2,9,11
52878,0,0,4,4,8
52879,0,0,6,7,13
52880,0,1,12,10,23
52881,0,0,3,12,15
52882,0,0,4,7,11
52883,0,0,6,4,10
52884,0,2,8,10,20
52885,0,0,0,3,3
52886,0,1,3,23,27
52887,0,0,2,3,5
52888,0,0,2,3,5
52889,0,0,10,10,20
52890,0,0,6,4,10
52891,0,0,2,7,9
52892,0,0,7,11,18
52893,0,0,6,1,7
52894,0,0,6,10,16
52895,0,1,8,7,16
52896,0,0,8,6,14
52897,0,0,1,1,2
52898,0,0,0,2,2
52899,0,0,4,9,13
52900,0,0,5,2,7
52901,0,0,2,5,7
52902,0,0,0,8,8
52903,0,0,5,3,8
52904,0,0,5,4,9
52905,0,0,1,9,10
52906,0,1,2,6,9
52907,0,0,0,1,1
52908,0,0,6,10,16
52909,2,1,7,22,32
52910,0,0,7,11,18
52911,0,0,5,5,10
52912,0,0,0,1,1
52913,0,0,4,5,9
52915,0,2,10,12,24
52916,0,0,5,9,14
52917,0,0,1,2,3
52918,0,0,6,18,24
52919,0,0,1,4,5
52920,0,0,5,11,16
52922,0,0,3,2,5
52923,0,0,5,17,22
52924,0,0,14,34,48
52925,0,0,0,31,31
52926,0,0,11,20,31
52927,0,0,1,6,7
52928,0,0,10,6,16
52929,0,0,1,4,5
52930,0,0,12,27,39
52932,2,5,6,23,36
52933,0,0,4,3,7
52934,0,1,5,27,33
52935,0,2,1,23,26
52936,0,0,5,7,12
52937,0,0,8,21,29
52938,0,0,3,13,16
52939,0,1,4,29,34
52940,0,0,0,15,15
52941,0,0,0,10,10
52942,0,1,4,19,24
52943,0,0,5,8,13
52944,2,6,1,14,23
52946,0,0,4,14,18
52947,0,3,1,13,17
52948,0,1,9,17,27
52949,0,2,4,16,22
52950,0,0,0,5,5
52951,0,2,6,3,11
52952,0,0,7,20,27
52953,0,0,3,11,14
52954,0,1,2,10,13
52955,0,0,8,19,27
52956,0,0,1,0,1
52957,0,2,4,17,23
52958,0,0,10,27,37
52959,0,2,4,23,29
52960,1,0,9,23,33
52961,0,0,3,9,12
52962,0,0,11,12,23
52963,1,2,9,17,29
52964,0,0,4,11,15
52965,0,1,6,14,21
52966,0,0,2,11,13
52967,0,0,6,22,28
52968,0,0,8,34,42
52969,0,0,6,23,29
52970,0,1,4,12,17
52972,1,0,2,6,9
52973,0,0,5,13,18
52974,0,0,11,39,50
52975,0,0,7,23,30
52976,0,0,10,13,23
52977,0,0,7,8,15
52978,0,0,10,32,42
52979,0,0,8,5,13
52980,2,0,7,14,23
52981,0,0,9,17,26
52982,0,0,5,23,28
52983,0,1,7,16,24
52985,0,0,4,12,16
52986,0,0,6,7,13
52987,1,0,4,21,26
52988,0,0,14,29,43
52989,2,5,6,23,36
52990,1,0,7,11,19
52991,0,0,5,2,7
52992,1,0,7,7,15
52993,0,0,8,7,15
52994,1,0,20,29,50
52995,0,0,1,6,7
52996,0,1,5,15,21
52997,0,0,12,36,48
52998,0,0,10,21,31
52999,0,0,8,15,23
53000,0,0,6,21,27
53001,0,0,6,26,32
53002,0,0,3,7,10
53003,0,0,7,13,20
53004,1,0,11,26,38
53005,0,0,10,29,39
53006,0,1,9,40,50
53007,0,0,9,37,46
53008,0,1,0,6,7
53009,0,0,9,14,23
53010,0,0,9,17,26
53011,0,1,11,16,28
53012,0,0,6,10,16
53013,1,0,7,29,37
53014,0,2,11,32,45
53015,0,0,0,5,5
53016,0,0,17,26,43
53017,0,0,14,36,50
53019,0,0,10,6,16
53020,2,0,8,29,39
53021,1,0,14,34,49
53022,0,0,8,26,34
53023,0,0,7,7,14
53024,0,0,14,30,44
53025,0,0,14,34,48
53026,0,0,11,24,35
53027,0,0,6,30,36
53028,0,0,10,19,29
53029,0,0,3,12,15
53030,0,0,3,11,14
53031,0,0,6,12,18
53032,0,3,14,32,49
53033,1,2,5,34,42
53034,0,0,3,2,5
53035,0,1,3,37,41
53036,0,0,12,26,38
53037,2,0,12,26,40
53038,0,0,12,27,39
53039,0,0,9,14,23
53040,0,0,1,3,4
53042,0,1,13,18,32
53043,0,0,4,28,32
53044,0,0,7,10,17
53045,0,0,5,17,22
53046,0,0,11,26,37
53047,0,0,1,4,5
53048,0,1,7,25,33
53049,0,1,1,12,14
53050,0,2,8,29,39
53051,0,0,7,18,25
53052,0,1,9,27,37
53053,0,0,12,37,49
53054,1,1,16,32,50
53055,0,0,6,11,17
53057,0,0,9,10,19
53058,0,1,3,13,17
53059,0,1,7,10,18
53060,0,0,2,23,25
53061,0,0,4,1,5
53062,0,0,6,15,21
53063,0,2,11,23,36
53064,1,1,1,26,29
53065,0,0,15,34,49
53066,0,0,4,2,6
53067,0,0,18,25,43
53068,0,0,11,29,40
53069,0,1,4,16,21
53070,0,0,2,3,5
53071,0,0,7,17,24
53072,0,1,5,17,23
53073,3,0,2,9,14
53075,0,0,6,10,16
53076,0,0,4,19,23
53077,0,0,4,13,17
53078,0,1,5,12,18
53079,0,0,5,2,7
53080,0,0,0,7,7
53081,1,1,3,18,23
53082,2,0,1,16,19
53083,0,0,6,38,44
53084,0,0,8,1,9
53085,0,1,5,27,33
53086,0,0,0,1,1
53087,3,0,1,14,18
53088,0,0,9,15,24
53089,2,0,7,8,17
53090,0,0,13,14,27
53091,1,0,7,12,20
53092,0,1,1,13,15
53093,0,0,2,17,19
53094,0,0,14,11,25
53095,0,3,12,30,45
53096,0,0,9,23,32
53097,0,0,3,22,25
53098,0,0,6,22,28
53100,0,2,7,4,13
53101,0,0,5,23,28
53102,0,0,6,4,10
53103,0,0,8,25,33
53104,0,0,2,19,21
53105,0,0,4,9,13
53106,1,0,1,15,17
53107,0,0,5,18,23
53108,0,0,12,22,34
53109,0,0,5,10,15
53110,0,1,9,16,26
53111,0,0,2,6,8
53112,0,0,4,13,17
53113,0,0,8,7,15
53114,0,2,1,12,15
53115,0,0,7,22,29
53116,0,0,3,8,11
53117,0,1,13,23,37
53118,1,0,9,32,42
53119,0,0,1,3,4
53120,1,1,4,17,23
53121,0,0,7,4,11
53122,0,0,8,8,16
53123,0,0,11,22,33
53124,0,0,5,32,37
53125,0,0,3,4,7
53126,0,0,12,20,32
53127,0,0,14,36,50
53128,0,0,5,9,14
53129,0,0,9,15,24
53130,0,0,1,13,14
53131,1,0,0,5,6
53132,0,1,5,3,9
53133,0,0,13,34,47
53134,0,1,9,20,30
53135,0,0,11,17,28
53136,0,0,10,21,31
53137,0,0,10,36,46
53138,0,0,2,3,5
53139,0,0,6,5,11
53140,0,2,11,21,34
53141,1,0,2,8,11
53142,0,0,1,0,1
53144,1,2,8,30,41
53145,1,0,4,9,14
53146,0,0,9,24,33
53147,0,0,6,4,10
53148,0,0,4,33,37
53149,0,0,20,15,35
53150,0,0,8,15,23
53152,0,0,12,13,25
53153,0,0,1,12,13
53154,0,0,4,29,33
53155,0,0,1,6,7
53156,0,0,3,7,10
53157,0,0,3,5,8
53158,0,0,1,4,5
53159,1,0,5,34,40
53160,0,0,4,11,15
53161,0,0,4,14,18
53162,0,0,1,6,7
53163,0,0,14,36,50
53164,0,0,2,9,11
53165,0,1,14,35,50
53166,0,1,12,8,21
53167,2,0,3,14,19
53170,0,0,2,20,22
53171,0,0,11,20,31
53172,1,0,5,32,38
53173,0,0,8,17,25
53174,0,0,1,8,9
53175,0,1,4,15,20
53176,0,1,4,19,24
53177,0,0,5,8,13
53178,0,0,4,20,24
53179,1,2,2,10,15
53180,0,0,4,4,8
53181,0,1,1,13,15
53182,0,2,1,23,26
53183,0,0,7,11,18
53184,0,1,4,29,34
53186,0,0,0,1,1
53187,0,2,2,21,25
53188,0,0,4,3,7
53189,0,0,0,6,6
53190,0,0,1,14,15
53191,0,1,4,45,50
53192,0,0,4,36,40
53193,0,0,3,30,33
53194,1,0,9,35,45
53195,0,0,0,31,31
53196,1,1,10,38,50
53197,0,0,11,39,50
53198,0,0,1,6,7
53199,0,0,2,6,8
53200,0,1,4,27,32
53201,1,0,0,20,21
53202,0,1,4,16,21
53203,0,0,0,11,11
53204,0,0,2,23,25
53205,0,0,2,15,17
53206,0,0,0,10,10
53207,0,0,5,4,9
53208,3,0,1,14,18
53209,0,1,13,13,27
53211,0,1,0,14,15
53212,0,0,6,7,13
53213,0,0,4,20,24
53214,0,0,8,17,25
53215,0,0,9,11,20
53216,0,0,3,5,8
53217,0,1,1,13,15
53218,0,0,13,32,45
53219,0,0,5,18,23
53220,0,0,17,21,38
53221,0,0,0,15,15
53222,0,0,4,14,18
53223,0,0,12,31,43
53224,1,1,15,33,50
53225,2,6,1,14,23
53226,0,0,7,9,16
53227,0,1,4,12,17
53228,0,1,7,10,18
53229,0,0,6,7,13
53231,2,6,1,14,23
53232,1,0,20,29,50
53233,2,6,1,14,23
53234,1,0,0,4,5
53235,0,0,3,7,10
53236,0,0,0,2,2
53237,0,0,15,32,47
53238,2,5,6,23,36
53239,2,6,1,14,23
53240,0,0,1,14,15
53241,0,1,15,16,32
53242,0,0,11,20,31
53243,0,0,2,10,12
53244,0,1,9,32,42
53245,1,2,11,36,50
53246,0,0,3,21,24
53247,0,0,6,10,16
53248,0,1,4,36,41
53249,0,0,8,8,16
53250,0,0,7,5,12
53251,0,0,3,14,17
53252,0,0,14,19,33
53253,0,0,6,11,17
53255,0,0,9,19,28
53256,0,2,3,15,20
53257,0,0,9,14,23
53258,0,0,6,3,9
53259,0,0,11,20,31
53260,1,0,4,14,19
53261,0,0,7,7,14
53262,0,1,5,41,47
53263,0,0,7,22,29
53264,0,0,4,3,7
53265,1,0,10,37,48
53266,0,0,1,6,7
53267,0,0,6,17,23
53268,0,0,7,9,16
53269,0,0,3,7,10
53270,0,0,7,18,25
53271,1,0,3,12,16
53272,0,0,5,6,11
53273,0,0,9,13,22
53275,0,0,4,13,17
53276,0,0,4,12,16
53277,0,0,3,18,21
53278,0,0,2,8,10
53279,0,0,5,13,18
53280,0,0,2,3,5
53282,0,0,0,6,6
53283,0,0,5,8,13
53284,0,0,0,5,5
53285,0,1,17,32,50
53286,0,0,4,4,8
53287,0,0,9,25,34
53288,0,0,6,6,12
53289,0,0,4,13,17
53290,0,0,12,30,42
53291,0,0,9,22,31
53292,0,0,13,21,34
53293,0,0,7,7,14
53294,0,0,0,6,6
53295,0,1,5,37,43
53296,0,0,5,9,14
53297,0,0,16,30,46
53298,0,0,7,9,16
53299,0,1,1,17,19
53300,0,1,16,14,31
53301,0,0,9,11,20
53302,0,0,4,22,26
53303,0,0,0,8,8
53304,0,0,9,10,19
53305,0,0,12,22,34
53306,0,0,8,12,20
53307,0,1,3,18,22
53308,0,0,11,13,24
53309,0,0,8,29,37
53310,0,0,4,8,12
53311,0,1,8,13,22
53312,0,0,8,10,18
53313,0,1,1,12,14
53314,0,0,5,4,9
53315,0,0,3,13,16
53316,0,0,1,3,4
53317,0,0,20,30,50
53318,0,0,2,6,8
53319,1,0,6,21,28
53320,0,1,5,44,50
53321,0,0,1,14,15
53322,0,0,7,8,15
53323,0,0,4,14,18
53324,0,0,7,11,18
53325,0,0,4,13,17
53326,0,0,5,3,8
53327,0,0,9,19,28
53328,0,0,4,5,9
53329,0,0,7,3,10
53330,0,1,7,8,16
53331,0,0,1,36,37
53332,0,1,5,4,10
53333,0,0,3,5,8
53334,2,0,2,11,15
53336,0,0,5,9,14
53337,0,0,8,8,16
53338,0,1,2,11,14
53339,0,0,4,5,9
53340,0,0,6,2,8
53342,0,0,0,1,1
53343,0,1,6,22,29
53344,0,0,7,10,17
53345,0,0,15,32,47
53346,0,0,6,5,11
53347,0,0,8,13,21
53348,0,0,3,3,6
53349,0,0,4,3,7
53350,0,1,7,7,15
53351,0,0,5,0,5
53353,0,1,0,10,11
53354,0,0,12,23,35
53355,0,0,4,10,14
53356,0,0,1,16,17
53357,0,0,11,9,20
53358,0,1,9,16,26
53359,0,0,5,8,13
53361,0,1,6,5,12
53362,0,0,6,18,24
53363,0,0,1,3,4
53365,0,0,4,3,7
53366,0,0,4,7,11
53367,0,0,2,17,19
53369,0,0,11,4,15
53370,0,0,11,20,31
53371,0,0,5,4,9
53372,0,1,12,18,31
53373,2,0,5,18,25
53374,0,1,7,7,15
53375,0,0,10,11,21
53376,0,0,0,6,6
53377,0,0,8,25,33
53378,0,0,1,4,5
53379,0,0,11,31,42
53380,3,0,4,38,45
53381,0,1,14,33,48
53382,0,0,19,31,50
53383,0,0,11,20,31
53384,0,1,4,24,29
53385,0,0,9,25,34
53386,0,0,4,30,34
53387,0,0,2,15,17
53388,0,0,4,22,26
53389,0,0,3,12,15
53390,0,0,2,8,10
53391,0,0,8,19,27
53392,0,0,0,24,24
53393,0,1,1,37,39
53394,0,0,11,34,45
53395,0,0,7,7,14
53396,0,0,4,28,32
53397,0,1,3,14,18
53398,0,0,10,11,21
53399,0,0,13,21,34
53400,0,1,1,11,13
53401,0,0,3,17,20
53402,0,0,5,16,21
53403,0,0,7,7,14
53404,0,0,4,13,17
53405,0,0,8,18,26
53406,0,0,14,35,49
53407,0,0,12,27,39
53408,0,0,1,12,13
53409,0,0,5,7,12
53410,0,1,12,12,25
53411,0,0,6,11,17
53412,0,0,9,14,23
53413,0,1,3,10,14
53414,0,0,5,5,10
53415,1,0,3,4,8
53416,1,1,10,22,34
53418,0,0,0,5,5
53419,0,0,6,8,14
53420,0,0,2,6,8
53421,0,0,8,8,16
53422,0,0,9,27,36
53423,0,0,1,11,12
53424,0,0,1,7,8
53425,0,1,5,14,20
53426,0,0,2,12,14
53427,0,0,1,10,11
53428,0,1,2,22,25
53429,0,0,3,26,29
53430,0,0,0,6,6
53431,1,0,9,40,50
53432,0,0,6,8,14
53433,0,0,5,17,22
53434,0,0,8,23,31
53435,0,0,0,6,6
53436,0,1,2,17,20
53437,0,0,1,15,16
53438,0,0,1,13,14
53439,0,1,5,12,18
53440,0,0,1,10,11
53441,0,2,2,19,23
53442,1,0,11,22,34
53443,3,1,2,9,15
53444,0,0,9,4,13
53445,0,0,7,3,10
53446,1,0,4,9,14
53447,1,1,3,31,36
53448,0,0,1,20,21
53449,0,1,9,12,22
53450,0,0,10,15,25
53451,1,1,18,30,50
53452,0,1,2,11,14
53453,0,0,0,3,3
53454,0,2,8,22,32
53455,1,0,9,40,50
53456,0,1,3,15,19
53457,0,1,3,18,22
53458,0,0,3,6,9
53459,0,0,11,8,19
53460,0,0,5,18,23
53461,0,0,2,8,10
53462,0,0,9,35,44
53463,0,0,8,25,33
53464,1,1,6,17,25
53465,0,0,0,8,8
53466,0,0,1,14,15
53467,0,0,4,3,7
53468,1,0,6,17,24
53469,0,0,2,2,4
53470,1,0,1,10,12
53471,1,0,1,12,14
53472,0,0,16,21,37
53473,0,0,8,5,13
53474,1,0,7,13,21
53475,0,1,5,20,26
53476,0,0,8,6,14
53477,0,0,5,8,13
53478,0,0,3,13,16
53479,0,0,4,9,13
53480,0,0,7,20,27
53481,0,0,11,39,50
53482,0,0,4,12,16
53483,1,1,11,37,50
53485,0,0,3,30,33
53486,0,1,2,5,8
53487,0,0,0,13,13
53488,0,0,0,8,8
53489,2,2,8,38,50
53490,0,1,13,36,50
53491,0,1,3,9,13
53492,0,0,8,1,9
53493,0,0,0,8,8
53494,0,1,0,6,7
53495,0,0,15,15,30
53497,0,0,4,9,13
53498,0,0,1,4,5
53499,0,1,7,7,15
53500,0,0,10,11,21
53501,0,0,5,4,9
53502,0,1,15,16,32
53503,0,0,0,7,7
53504,0,2,3,41,46
53505,0,0,6,12,18
53506,0,0,11,31,42
53507,3,0,4,38,45
53508,0,0,5,18,23
53509,0,0,1,20,21
53510,3,1,2,9,15
53511,0,0,4,28,32
53512,0,0,2,11,13
53513,0,0,3,13,16
53514,0,0,1,11,12
53515,0,0,5,19,24
53516,0,0,11,31,42
53517,2,0,5,18,25
53518,0,0,1,15,16
53519,0,0,4,11,15
53520,0,2,4,16,22
53521,0,0,5,9,14
53522,0,1,15,16,32
53523,0,0,11,20,31
53524,1,0,5,20,26
53525,0,0,5,3,8
53526,0,0,7,6,13
53527,0,1,5,12,18
53528,0,0,1,2,3
53529,0,0,4,13,17
53530,0,0,7,16,23
53531,0,1,9,11,21
53532,0,0,5,14,19
53533,0,0,1,7,8
53534,0,0,4,13,17
53535,0,0,6,11,17
53536,0,0,6,14,20
53537,0,0,5,11,16
53538,0,0,10,15,25
53539,0,0,11,20,31
53540,0,0,5,24,29
53541,0,0,17,22,39
53542,0,0,6,5,11
53543,0,0,5,14,19
53545,0,1,4,35,40
53546,0,1,9,32,42
53547,0,0,1,11,12
53549,0,0,1,13,14
53550,0,0,6,9,15
53551,0,0,6,5,11
53552,0,0,1,3,4
53553,0,0,5,17,22
53554,0,0,0,7,7
53555,1,2,6,24,33
53556,0,0,2,9,11
53557,0,0,12,15,27
53558,0,0,2,10,12
53559,0,1,3,25,29
53560,0,0,3,1,4
53563,0,0,4,10,14
53564,0,0,1,10,11
53565,2,0,3,22,27
53566,0,0,2,6,8
53567,1,0,9,21,31
53568,0,0,14,31,45
53569,0,0,8,17,25
53570,0,0,6,6,12
53571,1,0,8,25,34
53572,0,0,19,20,39
53573,0,0,14,35,49
53574,0,1,11,30,42
53575,0,0,8,26,34
53576,0,0,8,26,34
53577,0,0,2,18,20
53578,0,1,1,3,5
53579,0,1,12,36,49
53580,0,1,12,23,36
53581,0,0,1,2,3
53582,0,0,10,11,21
53583,0,0,0,17,17
53584,1,1,4,16,22
53585,1,0,10,25,36
53586,0,0,1,5,6
53588,1,3,2,21,27
53589,0,0,4,16,20
53590,0,0,3,10,13
53591,0,1,8,11,20
53592,0,0,21,27,48
53594,0,0,2,4,6
53595,1,0,2,14,17
53596,0,0,3,6,9
53597,0,0,7,8,15
53598,0,1,10,23,34
53599,0,0,6,16,22
53600,2,0,8,28,38
53601,0,2,6,21,29
53602,0,0,2,16,18
53603,0,0,4,10,14
53604,0,0,5,8,13
53605,0,0,4,3,7
53606,0,0,6,7,13
53607,0,0,0,12,12
53608,0,4,11,35,50
53609,1,0,9,35,45
53610,0,0,1,7,8
53611,0,1,15,27,43
53612,0,0,6,12,18
53613,0,0,8,3,11
53614,0,0,5,16,21
53615,0,0,1,8,9
53616,0,1,8,20,29
53617,0,0,2,3,5
53618,0,0,7,18,25
53619,0,1,8,23,32
53620,0,0,5,11,16
53621,0,1,9,17,27
53622,0,0,9,22,31
53623,0,0,6,6,12
53624,0,0,12,18,30
53625,0,0,3,13,16
53626,0,0,16,25,41
53627,0,0,1,14,15
53628,0,0,2,5,7
53629,0,0,8,7,15
53630,0,1,13,29,43
53631,0,0,4,14,18
53632,0,0,6,35,41
53633,0,1,4,22,27
53634,0,0,13,18,31
53635,0,0,2,17,19
53636,0,1,10,13,24
53637,0,0,1,11,12
53638,0,0,2,3,5
53639,0,0,12,24,36
53640,0,0,11,18,29
53641,0,0,5,8,13
53642,0,0,2,3,5
53644,0,0,8,28,36
53645,0,1,5,7,13
53646,0,0,8,9,17
53647,0,3,5,31,39
53648,1,0,6,35,42
53649,0,0,0,18,18
53650,0,1,3,7,11
53651,0,0,4,7,11
53652,1,0,6,17,24
53653,0,0,5,15,20
53654,0,0,7,6,13
53655,1,1,5,16,23
53656,0,0,6,16,22
53657,0,0,10,10,20
53658,0,0,6,9,15
53659,0,0,3,2,5
53660,0,0,4,8,12
53661,0,0,11,24,35
53662,0,0,9,10,19
53663,0,0,6,8,14
53664,0,1,3,19,23
53665,0,0,12,18,30
53667,0,0,5,13,18
53668,0,0,9,22,31
53669,0,0,6,14,20
53670,0,0,4,27,31
53671,0,0,5,15,20
53672,0,0,3,7,10
53673,0,0,16,25,41
53674,0,1,3,12,16
53675,1,0,5,20,26
53676,1,0,1,8,10
53677,0,0,9,14,23
53678,0,0,5,5,10
53679,1,0,7,33,41
53680,0,0,2,9,11
53681,0,1,7,3,11
53682,0,0,9,19,28
53683,0,0,7,9,16
53685,1,2,13,33,49
53686,0,0,7,7,14
53687,0,0,4,16,20
53688,0,0,2,18,20
53689,0,0,4,11,15
53690,0,0,8,21,29
53691,1,0,6,14,21
53692,0,1,4,13,18
53693,0,1,6,8,15
53694,1,1,3,38,43
53695,0,1,9,14,24
53696,0,0,8,25,33
53697,0,0,4,9,13
53698,0,0,6,13,19
53699,0,0,4,9,13
53700,0,0,1,4,5
53701,0,0,4,0,4
53702,0,0,4,4,8
53703,2,0,2,8,12
53704,0,0,4,3,7
53705,0,0,4,2,6
53706,0,0,6,9,15
53707,0,0,5,14,19
53708,0,0,13,35,48
53709,0,0,11,28,39
53710,0,0,7,22,29
53711,0,0,7,11,18
53712,0,0,4,22,26
53713,0,1,6,43,50
53714,1,1,8,19,29
53715,0,1,8,28,37
53716,0,1,3,34,38
53717,0,0,10,8,18
53718,0,0,2,3,5
53719,0,0,8,29,37
53720,0,0,8,15,23
53721,0,1,3,8,12
53722,0,0,7,6,13
53723,0,0,1,2,3
53724,0,0,6,13,19
53725,0,0,3,13,16
53726,0,0,15,10,25
53727,0,0,12,19,31
53728,0,9,4,32,45
53729,0,1,6,8,15
53730,0,1,11,15,27
53732,0,1,3,5,9
53733,0,0,9,20,29
53735,0,0,6,17,23
53736,0,1,0,43,44
53737,0,0,1,4,5
53738,0,0,8,18,26
53739,0,0,2,25,27
53740,0,0,7,12,19
53741,0,1,5,13,19
53743,1,0,5,13,19
53744,0,0,5,11,16
53746,0,0,2,8,10
53747,0,0,7,9,16
53748,0,0,5,45,50
53749,0,0,1,8,9
53750,1,0,11,21,33
53751,1,1,11,27,40
53752,1,1,16,19,37
53753,0,0,14,12,26
53754,0,0,7,10,17
53755,0,0,1,8,9
53756,0,0,3,12,15
53757,0,0,9,6,15
53759,0,0,7,11,18
53760,0,0,3,13,16
53761,0,0,14,36,50
53762,0,2,12,22,36
53764,0,0,5,9,14
53765,0,0,6,12,18
53766,0,0,4,2,6
53767,0,0,7,6,13
53768,0,0,5,9,14
53769,0,0,12,38,50
53770,0,0,6,12,18
53771,1,0,9,26,36
53772,0,0,1,4,5
53773,0,0,4,15,19
53774,0,0,8,13,21
53775,0,0,2,22,24
53776,0,0,3,13,16
53777,1,0,9,19,29
53778,0,1,8,8,17
53779,0,0,5,16,21
53780,0,0,15,29,44
53781,0,0,3,5,8
53782,0,0,0,16,16
53783,0,0,2,17,19
53784,0,0,10,9,19
53785,0,0,6,24,30
53786,0,0,7,13,20
53787,2,0,7,38,47
53788,0,0,5,6,11
53789,0,0,14,36,50
53790,0,0,5,7,12
53791,0,0,2,24,26
53792,0,0,8,39,47
53793,0,0,2,3,5
53794,0,0,4,6,10
53795,0,0,6,5,11
53796,0,0,5,8,13
53797,0,0,0,27,27
53798,0,0,5,12,17
53799,0,0,3,12,15
53800,2,1,2,31,36
53801,0,0,0,20,20
53802,0,0,20,30,50
53803,0,0,1,1,2
53804,0,1,1,11,13
53805,0,0,3,14,17
53806,0,0,8,3,11
53807,0,0,1,13,14
53808,0,0,1,6,7
53809,0,0,12,13,25
53810,0,0,4,4,8
53811,0,0,4,5,9
53812,1,1,0,11,13
53814,0,0,4,9,13
53815,0,0,12,17,29
53816,0,0,8,21,29
53817,1,0,0,7,8
53818,0,0,7,7,14
53819,0,0,9,14,23
53820,0,0,8,11,19
53821,0,1,5,13,19
53822,1,1,1,21,24
53823,0,0,8,14,22
53825,0,0,0,7,7
53826,0,0,6,16,22
53828,0,1,5,18,24
53829,0,0,14,11,25
53830,0,0,8,16,24
53831,0,0,3,10,13
53832,0,0,2,5,7
53833,0,0,4,16,20
53834,0,0,0,13,13
53835,0,1,9,15,25
53836,0,0,15,24,39
53837,0,0,6,18,24
53838,0,1,4,15,20
53840,0,0,3,7,10
53841,0,0,10,12,22
53842,0,0,4,8,12
53843,0,0,8,16,24
53844,2,1,10,14,27
53845,0,2,11,37,50
53846,0,5,4,7,16
53847,0,0,5,7,12
53848,0,0,6,5,11
53849,0,2,4,16,22
53850,0,0,6,19,25
53851,0,0,10,19,29
53852,0,0,9,12,21
53853,0,0,3,13,16
53854,0,2,13,30,45
53855,0,0,8,10,18
53856,0,0,8,11,19
53857,0,0,5,1,6
53858,0,0,0,20,20
53859,0,0,1,5,6
53861,0,0,0,5,5
53862,0,0,8,11,19
53863,0,0,7,6,13
53864,0,0,2,4,6
53865,0,0,3,6,9
53866,0,0,10,10,20
53869,0,0,0,11,11
53870,0,0,8,7,15
53871,0,0,2,4,6
53872,0,0,1,11,12
53873,0,0,8,15,23
53874,0,1,2,20,23
53876,0,0,3,9,12
53877,0,1,10,6,17
53878,0,0,0,5,5
53879,0,0,1,5,6
53881,0,0,1,8,9
53882,0,0,0,4,4
53887,1,1,4,15,21
53888,0,0,6,13,19
53889,0,0,4,11,15
53890,0,0,2,11,13
53891,0,0,1,12,13
53892,0,1,14,35,50
53893,0,1,0,9,10
53894,0,2,2,21,25
53895,0,5,9,18,32
53896,0,0,1,13,14
53897,2,6,1,14,23
53898,0,1,6,4,11
53899,0,0,1,4,5
53902,1,1,6,5,13
53903,0,0,10,24,34
53904,1,2,2,22,27
53905,0,0,3,21,24
53906,0,0,8,33,41
53907,0,0,2,11,13
53908,0,0,5,17,22
53909,0,0,9,12,21
53910,0,1,10,6,17
53911,0,0,8,5,13
53912,0,2,2,30,34
53913,0,2,2,24,28
53914,0,0,17,27,44
53915,0,1,14,31,46
53916,0,1,14,35,50
53917,0,0,14,32,46
53918,0,0,13,34,47
53919,0,1,1,8,10
53920,0,0,10,27,37
53921,0,0,5,8,13
53922,1,1,3,29,34
53923,0,0,1,9,10
53924,0,0,10,34,44
53925,0,0,1,6,7
53926,0,0,9,41,50
53927,0,0,2,10,12
53928,0,0,10,21,31
53929,0,0,1,12,13
53930,0,1,2,19,22
53931,1,0,4,14,19
53932,0,0,1,17,18
53933,0,1,8,23,32
53934,0,0,6,28,34
53935,1,2,9,27,39
53936,0,0,10,27,37
53937,1,1,17,30,49
53938,0,1,6,22,29
53939,0,0,2,8,10
53940,0,0,14,31,45
53941,0,0,5,11,16
53942,2,0,2,8,12
53944,0,0,14,19,33
53945,0,1,7,21,29
53946,1,0,9,21,31
53947,0,1,12,36,49
53948,0,0,8,16,24
53949,1,0,4,18,23
53950,0,1,4,22,27
53951,0,1,5,12,18
53952,0,0,3,12,15
53953,0,0,7,6,13
53954,0,3,6,21,30
53955,0,2,11,32,45
53956,0,0,8,23,31
53957,0,0,10,10,20
53958,0,1,0,9,10
53959,0,0,11,37,48
53960,0,0,11,9,20
53961,0,0,3,21,24
53962,0,0,2,3,5
53963,0,0,14,27,41
53964,0,0,6,10,16
53965,0,0,2,43,45
53966,1,0,4,19,24
53967,0,0,6,27,33
53968,0,0,6,21,27
53969,0,0,7,12,19
53970,0,0,6,4,10
53972,0,0,1,19,20
53973,0,0,4,4,8
53974,0,2,9,39,50
53975,1,0,9,27,37
53976,0,2,1,40,43
53977,0,0,11,24,35
53978,0,0,3,2,5
53979,0,1,9,20,30
53980,0,0,6,39,45
53981,1,0,7,23,31
53982,1,0,7,18,26
53983,1,0,9,39,49
53984,0,0,3,4,7
53985,0,0,3,6,9
53986,0,0,7,19,26
53987,0,0,5,14,19
53988,0,0,9,16,25
53989,0,0,2,4,6
53990,0,1,18,31,50
53991,1,0,11,30,42
53993,0,1,16,28,45
53994,0,0,16,34,50
53995,0,0,5,20,25
53996,0,1,1,48,50
53997,3,0,5,42,50
53998,0,0,4,6,10
53999,0,0,2,5,7
54000,0,1,2,19,22
54001,4,0,3,17,24
54002,0,0,5,10,15
54003,0,0,10,8,18
54004,0,0,9,19,28
54005,0,0,10,15,25
54006,0,0,9,18,27
54007,0,0,14,16,30
54008,0,0,1,16,17
54009,1,0,1,12,14
54010,0,0,7,9,16
54012,0,0,5,8,13
54013,1,0,4,45,50
54014,1,0,4,25,30
54015,0,0,6,13,19
54016,0,0,7,8,15
54017,3,1,11,31,46
54018,0,1,1,13,15
54020,0,0,6,13,19
54021,0,0,7,15,22
54022,0,0,7,21,28
54023,0,1,0,6,7
54024,0,0,7,7,14
54025,1,0,5,32,38
54026,0,0,0,13,13
54027,4,0,8,37,49
54028,0,0,7,20,27
54029,0,0,12,28,40
54030,1,1,14,34,50
54031,0,0,5,12,17
54032,0,0,9,16,25
54033,0,0,7,10,17
54034,0,0,7,12,19
54035,0,0,12,19,31
54036,0,1,2,19,22
54037,1,0,6,29,36
54038,0,0,6,19,25
54039,0,0,11,21,32
54040,0,0,11,15,26
54041,0,2,7,34,43
54042,1,0,3,19,23
54043,1,0,3,6,10
54044,0,0,7,10,17
54045,0,0,4,7,11
54046,0,0,8,5,13
54047,0,0,7,21,28
54048,0,0,12,11,23
54049,0,0,9,7,16
54050,0,1,5,14,20
54051,0,0,22,27,49
54052,0,0,2,4,6
54053,0,2,3,12,17
54054,0,0,5,15,20
54055,0,2,4,15,21
54056,0,0,0,15,15
54057,0,1,14,34,49
54058,0,1,4,17,22
54059,0,0,1,7,8
54060,1,0,10,20,31
54061,0,0,5,6,11
54062,0,0,0,10,10
54063,0,0,5,17,22
54064,0,0,0,1,1
54065,0,0,6,10,16
54066,1,0,6,40,47
54067,0,0,1,16,17
54068,0,0,8,10,18
54069,0,3,2,9,14
54070,2,0,3,8,13
54071,0,1,5,13,19
54073,1,0,6,34,41
54074,1,0,2,12,15
54075,0,1,3,14,18
54076,0,0,6,24,30
54078,0,0,1,2,3
54079,0,0,5,5,10
54080,0,0,0,4,4
54081,0,0,11,20,31
54082,0,0,4,10,14
54083,1,2,0,23,26
54085,0,2,2,21,25
54086,0,0,14,35,49
54087,2,3,3,23,31
54088,0,0,1,12,13
54089,0,0,1,13,14
54090,0,1,15,16,32
54091,0,0,6,16,22
54092,0,5,4,7,16
54093,1,1,4,15,21
54094,1,1,6,5,13
54095,1,1,10,38,50
54096,0,0,1,25,26
54097,1,0,6,34,41
54098,0,1,10,6,17
54099,0,1,3,14,18
54100,0,0,2,8,10
54101,1,0,3,12,16
54102,0,0,1,12,13
54103,0,0,0,18,18
54104,0,1,8,23,32
54105,1,0,7,31,39
54106,0,1,12,36,49
54107,0,1,1,48,50
54108,3,0,5,42,50
54109,0,0,1,12,13
54110,1,0,7,23,31
54111,3,1,11,31,46
54112,1,0,9,27,37
54113,0,0,2,36,38
54114,0,1,9,36,46
54115,0,0,4,5,9
54116,1,0,0,2,3
54117,0,0,1,2,3
54118,0,0,1,20,21
54119,0,0,9,26,35
54120,0,0,11,16,27
54121,0,1,1,13,15
54122,0,0,1,6,7
54123,0,0,2,11,13
54124,0,0,1,13,14
54125,0,2,13,30,45
54126,0,0,2,5,7
54127,2,6,1,14,23
54128,1,2,0,23,26
54129,0,1,1,6,8
54130,0,1,6,4,11
54131,0,0,0,6,6
54132,1,1,6,5,13
54133,3,0,1,14,18
54134,0,0,1,10,11
54135,2,6,1,14,23
54136,0,0,2,6,8
54137,2,6,1,14,23
54138,0,5,9,18,32
54139,2,6,1,14,23
54140,0,0,5,3,8
54141,0,0,6,9,15
54142,0,0,4,7,11
54143,0,0,0,8,8
54144,0,0,4,3,7
54145,0,0,23,27,50
54146,1,0,0,4,5
54147,0,0,6,13,19
54148,0,0,2,2,4
54149,0,0,4,7,11
54150,0,0,5,13,18
54151,0,0,6,14,20
54152,0,0,1,6,7
54153,0,0,4,9,13
54154,1,13,0,17,31
54155,0,1,8,20,29
54156,0,0,6,3,9
54157,0,0,1,7,8
54158,0,0,10,15,25
54159,0,1,5,7,13
54160,0,0,4,12,16
54161,0,2,0,11,13
54162,0,0,1,9,10
54163,0,1,5,4,10
54164,2,1,1,18,22
54165,0,0,4,21,25
54166,0,0,6,9,15
54167,0,0,7,14,21
54168,0,0,1,7,8
54169,0,0,7,21,28
54170,0,0,2,2,4
54171,1,0,4,3,8
54172,0,0,14,36,50
54173,0,0,2,10,12
54174,0,0,0,8,8
54175,0,0,2,2,4
54176,0,2,14,26,42
54177,0,0,2,2,4
54178,0,2,14,26,42
54179,0,1,8,20,29
54180,0,0,14,36,50
54181,1,0,0,8,9
54182,0,0,6,9,15
54183,0,0,5,9,14
54184,0,0,1,4,5
54185,0,0,0,8,8
54186,0,0,3,5,8
54187,0,0,5,8,13
54188,0,0,2,3,5
54189,0,0,10,12,22
54190,0,0,13,35,48
54191,0,0,10,11,21
54192,1,6,2,12,21
54193,0,2,3,3,8
54194,0,2,20,28,50
54195,0,0,14,13,27
54196,0,0,21,26,47
54197,0,1,12,36,49
54198,0,0,1,9,10
54199,0,0,5,1,6
54200,0,0,12,21,33
54201,1,0,8,22,31
54202,0,1,6,10,17
54203,0,0,10,13,23
54204,0,0,16,27,43
54205,0,0,6,7,13
54206,0,0,10,12,22
54207,0,0,7,11,18
54208,0,0,12,11,23
54209,0,0,3,3,6
54210,0,0,3,5,8
54211,0,0,2,16,18
54212,0,0,0,2,2
54213,1,0,11,21,33
54215,0,0,4,6,10
54217,0,0,7,3,10
54218,0,0,3,4,7
54219,0,0,3,13,16
54220,0,1,8,20,29
54221,1,1,7,16,25
54222,0,0,11,31,42
54223,0,2,15,24,41
54224,0,0,5,8,13
54225,0,0,4,8,12
54226,0,0,12,16,28
54227,0,0,12,13,25
54228,0,0,2,15,17
54229,0,1,4,26,31
54230,0,0,7,11,18
54231,0,0,5,8,13
54232,0,1,9,20,30
54233,0,0,2,11,13
54234,0,0,9,17,26
54235,0,0,9,20,29
54236,0,1,15,25,41
54237,0,0,5,8,13
54238,0,0,6,12,18
54239,0,0,11,17,28
54240,0,1,17,12,30
54241,0,0,6,3,9
54243,0,0,6,3,9
54244,0,0,12,31,43
54245,0,0,5,0,5
54246,0,0,1,3,4
54247,0,1,6,5,12
54248,0,0,4,5,9
54250,0,0,3,5,8
54252,0,0,3,4,7
54253,0,0,6,10,16
54254,0,1,5,7,13
54255,0,0,5,9,14
54256,0,0,0,7,7
54257,0,0,6,5,11
54258,0,0,3,5,8
54259,0,0,2,2,4
54260,0,0,2,10,12
54261,0,0,6,14,20
54262,0,0,10,10,20
54263,0,0,5,6,11
54264,0,0,13,22,35
54265,0,0,12,26,38
54266,1,0,13,19,33
54267,0,0,14,32,46
54268,0,0,9,10,19
54269,0,0,1,4,5
54270,0,0,14,36,50
54271,1,2,7,40,50
54272,0,0,0,8,8
54273,0,1,11,37,49
54274,0,0,3,6,9
54275,0,0,10,13,23
54276,1,0,4,3,8
54277,0,0,2,2,4
54278,0,0,0,7,7
54279,0,0,2,2,4
54280,0,1,11,37,49
54281,0,0,12,21,33
54282,0,0,2,2,4
54283,1,6,2,12,21
54284,0,1,8,20,29
54285,1,2,7,40,50
54286,0,0,14,36,50
54287,0,0,1,4,5
54288,0,0,3,6,9
54289,0,4,7,27,38
54290,0,0,12,4,16
54291,0,0,8,30,38
54292,0,0,9,14,23
54293,1,0,0,4,5
54294,0,0,14,13,27
54295,0,0,12,22,34
54296,0,0,12,19,31
54297,0,0,18,20,38
54298,0,0,6,7,13
54299,0,0,7,3,10
54300,0,0,7,10,17
54301,0,1,2,15,18
54302,0,0,12,10,22
54303,0,0,11,29,40
54304,0,0,8,40,48
54305,0,0,10,16,26
54306,0,0,6,15,21
54307,0,0,3,5,8
54308,0,0,3,3,6
54309,0,1,9,29,39
54310,0,0,8,14,22
54311,0,0,9,9,18
54312,0,0,6,12,18
54313,0,0,4,5,9
54314,0,0,8,11,19
54315,0,0,7,12,19
54316,0,0,14,28,42
54317,0,0,2,5,7
54318,0,1,8,14,23
54319,0,0,4,13,17
54320,0,0,7,11,18
54321,0,0,9,11,20
54322,0,0,9,12,21
54323,0,0,11,20,31
54324,0,0,10,24,34
54325,0,0,14,35,49
54326,0,4,16,23,43
54327,0,0,15,32,47
54328,0,0,10,10,20
54329,0,0,8,27,35
54330,0,1,5,3,9
54331,0,0,15,18,33
54332,0,2,7,13,22
54334,0,1,5,7,13
54335,0,0,5,11,16
54336,0,0,8,6,14
54337,0,0,6,7,13
54339,1,0,0,13,14
54340,0,0,8,13,21
54341,0,1,11,19,31
54342,0,0,2,9,11
54343,0,0,3,13,16
54344,0,0,13,9,22
54345,0,0,9,26,35
54346,0,0,5,12,17
54347,0,0,5,4,9
54348,0,0,0,7,7
54349,0,1,11,7,19
54350,0,0,7,14,21
54351,0,0,10,8,18
54352,0,0,9,14,23
54353,1,0,15,30,46
54354,1,2,7,40,50
54355,0,0,12,22,34
54356,0,1,11,37,49
54357,0,0,8,31,39
54358,1,1,7,21,30
54359,0,1,5,16,22
54360,0,0,6,8,14
54361,0,0,8,11,19
54362,0,0,3,5,8
54363,0,1,14,25,40
54364,0,0,7,3,10
54365,0,1,7,9,17
54366,0,0,9,6,15
54367,0,1,8,14,23
54368,0,0,14,28,42
54369,0,0,2,9,11
54370,0,2,7,13,22
54371,0,0,6,17,23
54372,1,0,4,3,8
54373,0,0,10,10,20
54374,1,0,0,13,14
54375,0,0,0,7,7
54376,0,2,7,13,22
54377,0,1,5,16,22
54378,1,1,4,4,10
54379,1,0,15,30,46
54380,0,0,6,43,49
54381,0,1,11,37,49
54382,1,2,7,40,50
54383,0,0,8,13,21
54384,0,0,3,5,8
54385,0,0,14,9,23
54388,0,0,8,11,19
54389,0,0,4,8,12
54390,0,0,2,11,13
54391,0,0,2,5,7
54392,0,0,3,11,14
54393,0,1,3,11,15
54394,0,0,9,19,28
54395,0,1,4,20,25
54396,0,0,4,8,12
54397,0,0,6,5,11
54398,0,0,2,12,14
54399,0,0,7,19,26
54400,1,0,9,40,50
54401,0,2,2,29,33
54402,0,1,1,3,5
54403,0,0,5,23,28
54404,0,0,10,12,22
54405,0,1,4,2,7
54406,0,0,11,13,24
54407,0,1,14,28,43
54409,0,0,2,19,21
54410,1,0,6,17,24
54411,0,3,7,19,29
54412,0,0,4,15,19
54414,0,0,6,8,14
54415,0,0,5,6,11
54416,0,0,14,13,27
54417,0,0,7,8,15
54418,0,0,5,20,25
54419,0,0,11,36,47
54420,0,0,3,5,8
54421,0,0,7,6,13
54422,0,0,2,4,6
54423,0,3,3,15,21
54424,0,0,3,6,9
54425,0,0,6,4,10
54426,0,0,5,8,13
54427,0,1,9,20,30
54428,0,0,16,19,35
54429,0,1,4,14,19
54430,0,0,11,9,20
54431,0,0,8,15,23
54432,0,0,9,26,35
54433,0,2,10,14,26
54434,0,0,8,13,21
54436,0,0,4,9,13
54437,0,0,1,16,17
54438,0,0,0,7,7
54439,0,0,6,14,20
54440,0,0,6,7,13
54441,0,0,6,15,21
54442,0,0,8,11,19
54443,1,0,9,20,30
54444,0,0,2,12,14
54445,0,0,11,36,47
54446,0,0,10,15,25
54447,0,1,4,6,11
54448,0,0,10,17,27
54449,0,0,6,10,16
54450,0,1,3,8,12
54451,0,0,16,34,50
54452,0,0,3,25,28
54453,0,0,10,22,32
54454,0,0,4,21,25
54455,0,0,7,16,23
54456,0,0,10,13,23
54457,0,2,10,6,18
54459,0,0,3,16,19
54460,0,0,2,30,32
54461,0,0,0,6,6
54462,0,1,5,17,23
54463,0,0,0,7,7
54464,0,3,3,10,16
54465,0,0,5,8,13
54466,0,0,6,9,15
54468,0,0,3,14,17
54469,0,0,6,14,20
54470,0,0,7,32,39
54471,0,0,21,15,36
54472,0,0,6,9,15
54473,0,0,7,14,21
54474,0,0,1,14,15
54475,0,0,6,16,22
54476,0,0,1,4,5
54477,0,0,7,20,27
54478,0,0,2,0,2
54479,0,0,4,9,13
54480,0,0,11,29,40
54481,0,0,4,5,9
54482,0,0,5,4,9
54483,0,0,5,27,32
54484,0,0,8,12,20
54485,0,0,5,3,8
54486,0,0,2,4,6
54487,1,1,4,14,20
54488,0,0,6,14,20
54489,0,1,2,4,7
54490,0,0,10,18,28
54491,0,0,9,13,22
54492,0,0,4,3,7
54493,0,0,13,22,35
54494,0,0,5,5,10
54495,0,0,3,10,13
54496,0,1,0,11,12
54497,0,0,3,5,8
54499,0,0,5,12,17
54500,0,0,9,9,18
54501,0,0,10,13,23
54502,0,1,7,20,28
54503,0,0,6,10,16
54504,0,0,0,7,7
54505,0,0,10,10,20
54506,0,0,5,8,13
54508,0,0,10,7,17
54509,0,3,3,10,16
54510,0,2,7,13,22
54511,0,0,3,7,10
54512,0,0,10,18,28
54513,0,0,9,8,17
54514,1,0,14,31,46
54515,0,0,1,7,8
54516,0,0,6,16,22
54517,0,0,7,14,21
54518,0,0,9,41,50
54519,0,0,0,5,5
54520,0,0,1,10,11
54521,0,0,5,14,19
54522,0,0,7,33,40
54523,0,0,10,33,43
54524,1,1,7,41,50
54525,0,0,4,3,7
54526,0,0,1,9,10
54527,0,0,6,10,16
54528,0,1,10,18,29
54529,0,0,9,24,33
54530,0,0,10,13,23
54531,0,0,9,13,22
54532,0,0,6,8,14
54533,0,1,2,4,7
54534,0,0,6,9,15
54535,0,0,7,20,27
54536,0,0,9,15,24
54537,0,0,10,7,17
54538,0,0,10,10,20
54539,1,0,5,11,17
54540,0,0,0,7,7
54541,0,2,7,13,22
54542,0,2,7,13,22
54543,0,0,3,3,6
54544,0,0,6,9,15
54545,0,0,7,9,16
54546,2,0,6,34,42
54547,0,0,3,2,5
54548,0,0,5,9,14
54549,0,0,1,5,6
54550,0,0,11,11,22
54553,0,0,7,16,23
54554,0,2,1,24,27
54555,0,0,7,18,25
54556,0,0,1,9,10
54557,0,2,5,36,43
54558,0,1,6,26,33
54559,0,1,0,4,5
54560,0,0,14,17,31
54561,0,0,2,7,9
54562,0,0,8,13,21
54563,0,0,4,14,18
54565,0,1,3,15,19
54566,0,0,10,8,18
54567,0,0,2,5,7
54568,0,0,11,8,19
54570,0,0,3,9,12
54571,0,0,4,4,8
54572,0,0,8,16,24
54573,0,0,7,25,32
54574,0,0,5,8,13
54575,0,0,11,18,29
54576,0,0,7,13,20
54577,0,0,3,7,10
54578,0,1,9,19,29
54579,0,0,2,4,6
54580,0,1,10,35,46
54581,0,0,12,14,26
54582,0,0,17,18,35
54583,0,0,2,16,18
54584,0,0,5,10,15
54585,0,0,8,17,25
54586,0,0,10,27,37
54587,0,0,3,4,7
54588,0,0,6,8,14
54589,0,0,1,1,2
54590,0,3,7,15,25
54593,0,0,0,5,5
54594,0,0,3,8,11
54595,0,1,3,9,13
54596,0,0,7,13,20
54597,0,0,7,4,11
54599,0,0,6,6,12
54600,0,0,2,15,17
54601,0,0,0,5,5
54602,0,0,2,11,13
54603,0,0,3,5,8
54604,0,0,10,9,19
54605,0,0,2,6,8
54606,0,0,1,5,6
54607,0,0,8,10,18
54609,0,0,6,9,15
54610,0,0,4,7,11
54611,0,0,11,16,27
54612,0,0,4,1,5
54613,0,0,2,3,5
54614,0,0,13,32,45
54615,0,0,9,6,15
54616,0,0,13,16,29
54617,0,0,4,14,18
54618,0,0,10,16,26
54619,0,0,7,13,20
54620,0,0,3,2,5
54622,0,0,5,19,24
54623,0,0,3,6,9
54624,0,0,6,7,13
54625,0,1,3,14,18
54626,0,0,5,13,18
54627,0,0,18,21,39
54628,0,0,12,14,26
54629,0,0,11,19,30
54630,0,0,9,23,32
54632,0,0,8,9,17
54633,0,0,10,28,38
54634,0,0,6,6,12
54635,0,0,14,35,49
54636,0,0,4,9,13
54637,0,0,3,2,5
54638,0,0,5,9,14
54639,0,0,7,2,9
54640,0,0,7,20,27
54641,0,0,0,7,7
54642,0,0,0,7,7
54643,0,0,7,3,10
54644,0,3,6,30,39
54645,0,0,9,8,17
54646,0,0,10,12,22
54647,0,0,6,9,15
54648,1,2,2,4,9
54649,0,0,10,13,23
54650,0,0,11,23,34
54652,0,0,14,22,36
54653,0,0,2,14,16
54654,0,0,3,2,5
54655,0,0,8,12,20
54656,0,0,2,11,13
54657,0,0,8,20,28
54658,0,0,1,5,6
54660,0,4,6,21,31
54661,0,0,9,25,34
54662,0,0,4,19,23
54663,0,0,8,7,15
54664,0,0,2,8,10
54665,1,0,4,6,11
54666,0,0,6,6,12
54667,0,0,3,4,7
54668,0,2,5,8,15
54669,0,0,4,11,15
54670,1,13,0,17,31
54671,0,1,15,31,47
54674,0,0,3,3,6
54675,0,0,5,9,14
54676,0,0,5,16,21
54677,0,1,14,30,45
54678,0,0,4,2,6
54679,0,0,2,1,3
54680,0,0,4,15,19
54681,0,0,4,7,11
54684,0,0,1,7,8
54685,0,0,5,12,17
54686,1,0,10,32,43
54687,0,0,3,3,6
54688,0,0,10,18,28
54689,0,0,14,30,44
54690,0,0,6,21,27
54691,0,0,1,5,6
54692,0,0,11,31,42
54693,0,0,7,17,24
54694,0,0,15,35,50
54695,0,0,10,27,37
54696,0,0,7,25,32
54697,0,0,3,19,22
54698,0,0,14,17,31
54699,0,0,4,15,19
54700,0,0,11,21,32
54701,0,0,9,19,28
54702,0,0,14,35,49
54703,1,3,3,22,29
54704,0,1,3,15,19
54705,0,0,11,7,18
54706,0,0,8,27,35
54707,0,1,17,28,46
54708,0,0,12,16,28
54709,0,0,4,21,25
54710,0,0,5,8,13
54711,0,0,3,20,23
54712,0,0,9,26,35
54713,3,0,8,24,35
54715,0,0,2,30,32
54716,0,0,10,9,19
54717,0,0,6,23,29
54719,0,0,8,13,21
54720,0,2,4,5,11
54721,0,0,7,5,12
54723,0,0,14,20,34
54724,0,0,0,5,5
54725,0,0,4,20,24
54726,0,2,4,5,11
54727,0,0,2,9,11
54728,0,1,0,4,5
54730,0,0,4,1,5
54731,0,0,3,14,17
54732,0,2,3,3,8
54733,0,2,9,11,22
54734,0,0,6,11,17
54735,0,0,2,23,25
54736,0,2,11,35,48
54737,0,0,16,27,43
54738,0,2,3,24,29
54739,0,0,6,9,15
54740,0,0,8,7,15
54741,0,0,6,6,12
54742,0,1,8,37,46
54743,0,0,7,3,10
54744,0,1,5,24,30
54745,0,1,8,6,15
54746,0,1,2,10,13
54747,0,0,6,12,18
54748,0,0,4,10,14
54749,0,1,4,9,14
54750,0,0,2,13,15
54751,0,1,5,20,26
54752,0,0,11,6,17
54753,0,0,9,27,36
54754,0,0,6,5,11
54755,0,0,7,16,23
54756,0,6,0,10,16
54757,0,1,6,17,24
54758,1,1,10,13,25
54759,0,0,9,19,28
54760,0,0,4,3,7
54762,0,0,5,5,10
54763,0,1,3,6,10
54764,0,1,4,15,20
54766,0,2,5,2,9
54767,0,0,7,14,21
54768,0,1,9,8,18
54769,0,0,10,19,29
54770,0,0,8,19,27
54771,0,0,14,35,49
54772,0,0,3,9,12
54773,0,0,17,32,49
54774,0,1,4,27,32
54775,0,2,7,3,12
54776,0,0,4,11,15
54777,0,0,2,14,16
54779,0,0,6,7,13
54780,0,0,13,23,36
54781,0,0,4,2,6
54782,0,0,2,6,8
54783,0,0,6,6,12
54785,0,0,3,8,11
54786,0,0,13,11,24
54787,0,3,8,23,34
54788,0,0,5,12,17
54789,0,0,14,29,43
54790,0,1,4,4,9
54791,0,0,4,2,6
54792,0,0,1,5,6
54793,0,0,2,4,6
54794,0,0,4,3,7
54795,0,0,10,15,25
54796,0,0,3,5,8
54797,0,0,2,7,9
54798,2,0,4,13,19
54799,0,0,5,10,15
54800,0,0,9,12,21
54801,0,0,10,15,25
54802,0,0,4,8,12
54804,0,0,6,3,9
54805,0,0,16,18,34
54806,0,1,2,4,7
54807,2,0,1,9,12
54808,0,1,5,3,9
54809,0,0,5,2,7
54810,0,0,4,1,5
54812,0,0,2,14,16
54813,0,0,8,18,26
54814,0,0,2,9,11
54815,0,1,15,34,50
54816,0,0,8,27,35
54817,0,0,7,8,15
54818,0,0,9,24,33
54819,0,2,4,17,23
54820,0,0,9,19,28
54821,0,1,4,29,34
54822,0,0,6,11,17
54823,0,0,5,3,8
54824,0,0,10,12,22
54825,0,0,9,15,24
54826,0,0,0,6,6
54827,0,0,9,18,27
54828,0,0,8,42,50
54829,0,1,10,39,50
54830,0,1,4,9,14
54831,0,0,2,5,7
54832,0,1,11,11,23
54833,0,0,2,4,6
54834,0,1,2,4,7
54835,0,0,7,9,16
54836,0,3,3,14,20
54837,0,3,10,35,48
54838,0,2,1,18,21
54839,0,1,8,12,21
54840,0,0,11,26,37
54842,0,0,1,5,6
54843,0,0,2,8,10
54844,0,0,7,38,45
54845,0,1,2,10,13
54846,0,1,11,11,23
54847,0,0,6,4,10
54848,0,0,0,8,8
54849,0,0,6,5,11
54850,0,0,10,11,21
54851,0,0,4,8,12
54852,0,0,14,23,37
54853,0,0,13,16,29
54854,0,0,5,7,12
54855,0,0,3,11,14
54856,0,0,6,20,26
54857,0,0,8,20,28
54858,0,0,2,22,24
54859,0,0,13,25,38
54860,0,0,9,11,20
54861,0,1,4,17,22
54862,0,0,3,5,8
54863,1,1,4,14,20
54864,0,0,3,19,22
54865,0,1,0,9,10
54866,0,2,2,18,22
54867,0,0,4,11,15
54868,0,0,11,10,21
54869,0,0,3,5,8
54870,0,0,7,17,24
54871,0,1,9,40,50
54872,0,0,10,27,37
54873,0,0,1,0,1
54874,0,0,13,13,26
54875,0,0,2,8,10
54876,0,0,5,10,15
54877,0,1,17,25,43
54878,0,0,8,29,37
54879,0,0,2,31,33
54880,0,0,6,5,11
54881,0,2,7,26,35
54882,1,1,12,33,47
54883,0,1,11,22,34
54884,0,1,4,6,11
54885,0,0,3,16,19
54886,0,0,1,0,1
54887,0,0,23,27,50
54888,0,0,9,9,18
54889,0,0,6,7,13
54890,2,1,7,13,23
54891,0,0,2,3,5
54892,0,0,10,28,38
54893,0,1,5,15,21
54894,0,0,5,5,10
54895,0,0,1,10,11
54896,0,0,1,7,8
54897,0,0,2,10,12
54898,0,0,1,3,4
54899,0,1,7,27,35
54900,0,0,1,9,10
54901,0,0,8,3,11
54902,0,0,7,8,15
54903,0,2,0,11,13
54904,0,0,0,7,7
54905,0,0,13,34,47
54906,0,1,2,17,20
54907,0,0,14,32,46
54908,0,0,14,22,36
54909,0,0,0,9,9
54910,0,0,3,19,22
54911,0,0,1,9,10
54912,0,0,11,35,46
54913,0,0,9,19,28
54914,1,0,1,11,13
54915,0,0,0,8,8
54916,0,0,1,10,11
54917,0,0,3,4,7
54918,0,0,1,7,8
54919,0,3,1,13,17
54920,0,0,3,8,11
54921,5,1,1,13,20
54922,1,0,1,11,13
54923,0,0,0,7,7
54924,0,2,0,11,13
54925,0,0,8,22,30
54926,0,1,5,15,21
54927,0,1,9,20,30
54928,0,0,5,14,19
54929,0,0,1,10,11
54930,0,0,2,15,17
54931,0,0,6,1,7
54932,0,0,17,33,50
54933,0,1,3,26,30
54934,0,1,9,20,30
54935,0,1,0,2,3
54936,0,1,3,26,30
54937,0,1,6,17,24
54938,0,0,4,11,15
54939,0,0,11,34,45
54940,0,0,13,13,26
54941,0,0,12,25,37
54942,0,0,5,2,7
54943,0,0,4,18,22
54944,0,0,5,11,16
54945,0,0,3,9,12
54946,0,0,3,7,10
54947,0,0,9,22,31
54948,0,0,3,11,14
54949,0,0,4,11,15
54950,0,0,1,9,10
54951,0,1,1,43,45
54952,0,1,6,14,21
54953,0,0,8,17,25
54954,0,1,4,12,17
54955,0,0,5,16,21
54956,0,0,6,7,13
54957,0,2,3,7,12
54958,0,0,7,8,15
54959,0,0,1,5,6
54960,0,0,4,18,22
54961,0,0,11,25,36
54962,0,0,5,13,18
54963,0,1,14,29,44
54964,0,0,3,5,8
54965,0,0,7,28,35
54966,0,0,5,4,9
54967,0,0,3,13,16
54968,0,0,1,4,5
54969,0,1,19,28,48
54970,0,0,1,6,7
54971,0,0,13,16,29
54972,1,1,9,14,25
54973,0,0,2,3,5
54974,0,0,3,2,5
54975,0,0,7,10,17
54976,0,1,5,12,18
54977,0,0,0,5,5
54978,0,0,2,15,17
54979,0,0,15,31,46
54980,0,0,3,5,8
54981,0,0,12,22,34
54982,0,0,5,4,9
54983,0,1,3,15,19
54984,0,0,6,9,15
54985,0,2,9,24,35
54986,0,0,0,4,4
54987,0,0,3,9,12
54988,0,0,1,11,12
54989,0,0,2,6,8
54991,0,0,3,8,11
54993,0,0,6,17,23
54994,0,1,13,16,30
54995,0,0,8,16,24
54996,0,0,3,10,13
54997,0,0,3,3,6
54998,0,0,5,5,10
54999,0,2,1,8,11
55000,1,0,1,3,5
55001,0,0,2,10,12
55002,0,0,0,5,5
55003,0,0,2,4,6
55004,0,1,9,19,29
55005,0,0,1,8,9
55006,0,0,8,2,10
55007,0,1,0,4,5
55008,0,0,8,7,15
55009,0,0,3,4,7
55010,0,0,18,25,43
55011,1,0,5,9,15
55012,0,0,6,10,16
55013,0,2,3,10,15
55014,0,2,2,21,25
55015,0,1,1,6,8
55016,0,3,9,25,37
55017,0,1,3,4,8
55018,0,0,12,16,28
55019,0,0,2,3,5
55021,0,0,5,18,23
55022,0,0,2,9,11
55023,1,0,4,8,13
55024,0,3,6,14,23
55025,0,0,6,1,7
55026,0,1,0,0,1
55027,0,1,1,5,7
55028,0,0,2,6,8
55029,0,0,5,10,15
55030,0,1,0,19,20
55031,0,0,7,15,22
55032,0,0,4,12,16
55033,13,1,2,28,44
55034,0,0,2,10,12
55035,0,0,1,5,6
55036,1,0,2,7,10
55037,0,0,4,10,14
55038,0,0,1,3,4
55039,0,0,6,13,19
55040,0,0,3,8,11
55041,0,0,0,5,5
55042,0,1,1,6,8
55043,0,0,0,5,5
55045,0,0,3,2,5
55048,0,0,1,4,5
55049,0,3,18,29,50
55050,0,0,14,31,45
55051,0,2,3,21,26
55052,0,0,7,12,19
55053,0,2,5,33,40
55054,0,4,4,20,28
55055,0,0,4,6,10
55056,5,1,5,28,39
55057,0,1,3,8,12
55058,0,1,14,33,48
55059,3,0,1,8,12
55060,0,1,8,22,31
55061,0,0,1,8,9
55062,0,1,0,9,10
55063,1,5,13,25,44
55064,0,0,1,4,5
55065,1,0,2,4,7
55066,0,1,6,17,24
55067,0,0,15,30,45
55068,0,0,3,3,6
55069,5,1,5,28,39
55070,0,0,6,10,16
55071,0,0,4,28,32
55072,0,1,4,16,21
55073,0,1,3,26,30
55074,0,0,8,8,16
55075,0,0,9,21,30
55076,0,0,10,20,30
55077,0,0,2,14,16
55078,0,0,11,6,17
55079,0,1,3,31,35
55080,1,1,8,40,50
55081,1,1,13,25,40
55082,0,0,12,25,37
55083,0,1,12,21,34
55084,0,0,2,8,10
55085,0,0,3,3,6
55086,0,0,3,8,11
55087,0,0,4,9,13
55088,0,0,4,17,21
55089,0,0,5,5,10
55090,1,1,9,14,25
55091,0,0,1,4,5
55092,1,5,13,25,44
55093,0,0,3,5,8
55094,0,0,5,4,9
55095,0,0,14,31,45
55096,1,0,2,4,7
55097,0,1,0,19,20
55098,0,1,0,9,10
55099,0,0,5,4,9
55100,0,0,3,8,11
55101,0,0,1,9,10
55102,1,1,9,14,25
55104,0,0,2,14,16
55105,0,1,14,33,48
55106,1,1,9,14,25
55107,0,0,2,8,10
55108,0,0,7,8,15
55109,1,5,13,25,44
55110,0,4,4,20,28
55111,0,0,6,7,13
55112,0,0,8,11,19
55113,0,0,9,13,22
55114,1,1,13,25,40
55115,0,0,9,12,21
55116,0,1,1,43,45
55117,0,2,3,21,26
55118,0,0,6,7,13
55119,0,2,5,33,40
55120,0,1,3,26,30
55121,0,0,9,16,25
55122,0,0,4,9,13
55123,0,0,4,17,21
55124,1,5,13,25,44
55125,0,0,1,8,9
55126,1,1,8,40,50
55127,0,3,18,29,50
55128,0,1,3,8,12
55129,0,1,8,22,31
55130,1,0,2,4,7
55131,0,1,6,17,24
55132,0,2,11,37,50
55133,0,1,7,16,24
55134,0,0,4,11,15
55135,0,0,4,6,10
55136,0,0,3,2,5
55137,0,1,10,38,49
55138,0,1,6,17,24
55139,0,0,2,4,6
55140,0,0,6,17,23
55141,0,0,7,23,30
55142,0,0,15,22,37
55143,0,1,13,29,43
55144,0,0,4,12,16
55145,0,2,3,21,26
55146,0,0,5,10,15
55147,0,0,3,11,14
55148,0,0,2,9,11
55149,0,0,5,10,15
55150,0,0,3,9,12
55151,0,2,4,37,43
55152,0,0,8,14,22
55153,1,0,9,10,20
55154,0,0,19,26,45
55155,5,1,5,28,39
55156,0,0,11,34,45
55157,0,0,5,5,10
55159,0,0,3,6,9
55160,0,0,13,37,50
55161,0,0,2,12,14
55162,0,0,4,5,9
55163,0,0,4,5,9
55164,0,0,8,24,32
55165,0,0,2,6,8
55166,0,1,12,22,35
55167,0,0,7,19,26
55168,0,0,7,12,19
55169,0,0,7,14,21
55170,0,0,6,9,15
55171,0,0,7,16,23
55172,0,0,4,11,15
55173,0,0,1,4,5
55174,0,0,1,12,13
55175,0,0,7,16,23
55176,0,2,8,18,28
55179,0,0,6,18,24
55180,0,1,2,16,19
55181,0,0,11,14,25
55182,0,0,2,3,5
55183,0,0,4,6,10
55184,0,0,6,16,22
55185,0,1,5,28,34
55186,0,0,4,14,18
55188,0,1,14,19,34
55189,0,0,8,12,20
55190,0,0,4,18,22
55191,0,0,6,31,37
55192,0,0,8,12,20
55193,0,0,8,31,39
55194,1,0,1,3,5
55195,0,0,8,15,23
55196,0,0,4,14,18
55197,0,0,5,20,25
55198,0,0,6,24,30
55200,0,0,4,8,12
55201,0,0,5,6,11
55202,1,0,11,24,36
55203,0,0,3,7,10
55204,0,0,5,14,19
55205,0,0,1,2,3
55206,0,0,5,8,13
55207,0,0,6,14,20
55208,0,0,2,4,6
55209,0,0,7,11,18
55210,0,0,9,25,34
55213,0,0,3,17,20
55214,1,0,7,14,22
55215,0,0,4,10,14
55216,0,1,7,4,12
55217,0,0,7,11,18
55218,0,1,4,9,14
55219,0,1,6,20,27
55220,0,0,0,5,5
55222,0,0,9,29,38
55223,0,0,6,24,30
55224,0,0,4,16,20
55225,0,1,8,21,30
55226,0,0,2,6,8
55227,0,0,6,10,16
55228,0,0,2,11,13
55229,0,0,4,5,9
55230,0,0,2,4,6
55232,0,0,4,5,9
55233,0,0,4,10,14
55234,0,1,5,14,20
55235,0,0,1,4,5
55236,1,2,1,22,26
55237,0,0,6,6,12
55238,1,0,13,20,34
55239,2,0,11,34,47
55240,0,0,7,13,20
55241,0,0,7,11,18
55242,0,0,3,2,5
55243,0,0,6,14,20
55245,0,0,0,9,9
55246,0,1,3,8,12
55247,0,0,7,25,32
55248,0,0,2,5,7
55249,0,0,5,2,7
55250,0,0,19,29,48
55251,1,0,5,24,30
55252,1,0,12,19,32
55253,0,0,3,6,9
55254,0,0,1,5,6
55255,0,0,3,6,9
55256,0,0,5,14,19
55258,0,0,2,5,7
55259,0,1,10,38,49
55260,1,1,6,12,20
55261,0,0,3,18,21
55262,0,1,20,26,47
55263,0,1,3,7,11
55264,1,0,3,17,21
55265,0,1,4,8,13
55266,0,1,4,12,17
55267,0,0,8,7,15
55268,0,0,8,16,24
55269,0,0,5,8,13
55270,0,0,6,14,20
55271,0,0,6,15,21
55273,0,0,13,36,49
55274,0,0,7,20,27
55275,0,0,6,8,14
55276,0,0,0,2,2
55277,0,0,5,10,15
55278,0,0,3,4,7
55279,0,0,5,11,16
55282,0,6,6,26,38
55283,0,0,1,18,19
55284,0,0,6,8,14
55285,0,0,3,5,8
55286,1,5,13,25,44
55287,0,0,4,19,23
55288,0,0,6,8,14
55289,0,0,8,21,29
55290,0,0,3,2,5
55291,0,0,4,4,8
55292,0,1,5,17,23
55293,0,0,3,3,6
55295,0,0,3,10,13
55296,0,0,4,7,11
55297,0,3,7,14,24
55298,0,0,9,36,45
55299,0,0,5,8,13
55300,0,1,3,10,14
55301,0,0,5,18,23
55302,0,0,0,8,8
55303,0,0,2,2,4
55304,0,0,1,24,25
55306,0,0,10,22,32
55307,0,0,4,17,21
55308,0,0,4,5,9
55309,0,0,7,15,22
55310,0,0,7,8,15
55311,0,0,12,31,43
55312,0,0,7,23,30
55313,0,0,7,11,18
55314,0,0,4,10,14
55315,0,0,6,10,16
55316,0,1,10,15,26
55317,0,0,5,4,9
55318,0,0,3,7,10
55319,0,0,8,10,18
55320,0,1,3,3,7
55321,0,0,3,7,10
55322,0,0,7,7,14
55324,0,0,2,4,6
55325,0,1,3,10,14
55326,0,0,3,6,9
55327,0,0,4,17,21
55328,0,0,6,4,10
55330,0,0,3,6,9
55331,0,0,1,10,11
55332,0,0,2,5,7
55333,0,0,3,3,6
55334,0,2,6,13,21
55335,0,0,3,5,8
55336,0,0,0,3,3
55337,0,0,1,6,7
55338,0,0,3,20,23
55340,1,0,5,25,31
55341,0,0,0,8,8
55342,0,2,3,37,42
55343,0,1,1,23,25
55344,0,1,11,23,35
55345,0,0,5,4,9
55346,0,2,6,20,28
55347,0,0,2,4,6
55348,1,1,12,24,38
55349,0,0,7,8,15
55350,1,0,7,20,28
55351,0,0,0,14,14
55352,0,0,14,31,45
55353,0,0,1,15,16
55354,0,1,6,17,24
55355,0,0,2,5,7
55356,0,1,7,16,24
55357,0,0,9,15,24
55358,1,0,7,4,12
55359,0,0,9,13,22
55360,0,1,0,24,25
55361,0,1,3,26,30
55362,0,1,9,13,23
55363,2,2,2,32,38
55364,2,1,11,29,43
55365,0,0,13,30,43
55366,0,0,6,18,24
55367,0,1,8,21,30
55368,0,2,9,18,29
55369,0,0,13,37,50
55370,1,0,2,11,14
55371,0,0,9,18,27
55372,0,0,4,6,10
55373,0,0,15,35,50
55374,0,0,9,26,35
55375,0,0,8,24,32
55376,0,0,13,27,40
55377,0,0,3,3,6
55378,0,0,11,19,30
55379,1,0,5,25,31
55380,0,0,5,4,9
55381,0,0,5,19,24
55382,0,0,6,10,16
55383,1,0,18,31,50
55384,0,0,0,8,8
55385,0,0,9,20,29
55387,0,1,12,26,39
55388,0,0,5,6,11
55389,0,0,11,28,39
55390,0,0,10,18,28
55391,0,0,13,21,34
55392,0,0,14,31,45
55393,0,0,1,15,16
55394,0,0,4,9,13
55395,0,0,4,17,21
55396,2,1,15,32,50
55397,0,0,4,7,11
55398,0,2,1,4,7
55399,0,1,14,35,50
55400,0,0,2,18,20
55402,1,0,0,5,6
55403,0,2,11,37,50
55404,1,0,7,20,28
55405,0,3,3,24,30
55406,0,0,6,9,15
55407,0,0,0,14,14
55408,0,0,8,10,18
55409,5,1,5,28,39
55410,0,0,5,4,9
55411,0,0,2,4,6
55412,1,5,13,25,44
55413,0,0,13,37,50
55414,0,1,10,38,49
55415,0,1,11,23,35
55416,0,0,4,5,9
55417,0,0,2,5,7
55418,0,1,7,13,21
55420,0,1,0,24,25
55421,0,2,3,37,42
55422,0,0,2,3,5
55423,1,0,9,26,36
55424,0,0,8,41,49
55425,0,0,5,4,9
55426,0,0,0,8,8
55427,0,0,3,7,10
55428,0,0,2,4,6
55429,0,0,0,14,14
55430,0,1,14,35,50
55431,1,1,7,14,23
55432,0,1,5,28,34
55433,0,2,6,20,28
55434,1,1,12,24,38
55435,0,0,7,8,15
55436,1,5,13,25,44
55437,1,1,7,14,23
55438,0,2,6,20,28
55439,0,1,3,26,30
55440,0,0,4,9,13
55441,1,1,12,24,38
55442,0,1,11,23,35
55443,0,1,3,8,12
55444,1,5,13,25,44
55445,0,1,6,17,24
55446,0,2,3,21,26
55447,0,0,4,20,24
55448,0,0,5,4,9
55449,0,1,6,17,24
55450,0,0,4,19,23
55451,0,0,5,13,18
55452,0,2,6,11,19
55453,0,0,9,29,38
55454,0,5,11,26,42
55455,0,0,0,3,3
55456,0,0,5,10,15
55457,0,0,6,5,11
55458,0,0,8,10,18
55459,0,0,8,12,20
55460,0,0,8,13,21
55461,0,1,1,4,6
55462,0,0,14,35,49
55463,0,0,8,7,15
55464,0,0,7,12,19
55465,0,0,7,10,17
55466,0,0,2,19,21
55467,0,1,13,36,50
55468,1,0,14,21,36
55469,1,0,10,12,23
55470,0,0,7,17,24
55471,0,0,4,4,8
55472,0,0,8,15,23
55473,0,0,5,17,22
55474,0,0,8,17,25
55475,0,1,8,8,17
55476,0,0,3,0,3
55479,0,0,6,8,14
55480,0,0,8,35,43
55481,0,0,0,5,5
55482,0,0,10,15,25
55483,0,0,9,19,28
55484,0,0,6,16,22
55485,0,0,4,11,15
55486,0,0,4,21,25
55487,0,0,10,11,21
55488,0,0,3,4,7
55489,0,0,3,9,12
55490,0,0,11,21,32
55491,0,0,8,4,12
55492,0,0,11,27,38
55493,0,0,10,16,26
55494,0,0,6,29,35
55495,0,0,5,32,37
55496,0,0,3,7,10
55497,0,1,5,6,12
55498,1,0,1,3,5
55499,0,0,4,12,16
55500,0,2,3,14,19
55501,0,0,1,3,4
55502,0,0,4,12,16
55503,0,0,8,11,19
55504,0,0,5,2,7
55505,0,1,0,15,16
55506,0,1,7,16,24
55507,0,0,9,20,29
55508,0,0,2,5,7
55509,0,0,4,8,12
55510,0,0,4,16,20
55511,0,1,7,4,12
55512,0,0,3,13,16
55513,2,0,12,24,38
55514,0,0,7,16,23
55515,0,0,10,13,23
55516,0,0,4,4,8
55517,1,0,1,13,15
55518,0,0,14,23,37
55520,0,0,9,21,30
55521,0,0,17,32,49
55522,0,0,11,25,36
55523,0,0,8,22,30
55524,0,0,4,13,17
55525,0,0,9,20,29
55526,0,0,10,24,34
55527,0,0,1,4,5
55528,0,0,4,17,21
55529,0,0,5,13,18
55530,0,0,10,12,22
55531,0,0,3,4,7
55532,0,0,0,5,5
55533,0,1,6,16,23
55534,0,0,6,16,22
55535,0,0,3,12,15
55536,0,0,5,2,7
55537,0,1,8,15,24
55538,0,0,1,11,12
55539,0,0,1,8,9
55540,0,0,5,17,22
55541,0,0,12,24,36
55542,0,0,17,33,50
55543,0,0,0,7,7
55544,0,0,8,15,23
55545,1,0,10,30,41
55546,0,0,3,10,13
55547,0,0,10,11,21
55548,0,0,1,11,12
55549,0,1,15,26,42
55550,0,0,11,36,47
55551,1,1,7,14,23
55552,0,0,11,16,27
55553,0,1,13,10,24
55554,0,0,3,13,16
55555,0,0,2,3,5
55556,0,0,2,12,14
55557,0,0,8,15,23
55558,0,0,0,5,5
55559,0,0,4,2,6
55560,1,0,6,18,25
55562,0,0,6,14,20
55563,0,0,7,22,29
55564,0,0,3,6,9
55565,0,0,2,8,10
55566,0,0,20,23,43
55567,0,0,2,9,11
55568,1,3,4,42,50
55570,0,0,8,42,50
55571,0,0,4,10,14
55572,0,0,5,7,12
55573,0,0,2,10,12
55574,0,4,3,21,28
55575,0,0,7,20,27
55576,0,0,0,5,5
55577,0,0,5,3,8
55578,0,1,4,5,10
55580,0,0,2,8,10
55581,0,1,2,19,22
55582,0,0,9,15,24
55583,0,0,8,12,20
55584,0,0,8,10,18
55585,0,0,0,7,7
55586,0,0,0,6,6
55587,0,0,2,21,23
55588,0,0,3,9,12
55589,0,1,6,10,17
55590,0,0,1,4,5
55591,0,1,7,10,18
55592,0,5,3,26,34
55594,0,0,3,4,7
55595,0,0,1,6,7
55596,0,0,2,1,3
55597,0,0,9,10,19
55598,1,0,10,29,40
55599,0,1,4,2,7
55600,0,0,2,7,9
55602,0,0,4,10,14
55603,0,2,2,21,25
55604,0,1,10,5,16
55605,0,0,2,13,15
55606,1,0,7,14,22
55607,0,0,9,14,23
55608,0,0,2,12,14
55609,0,0,5,3,8
55610,1,0,4,26,31
55611,0,0,1,5,6
55612,0,0,11,13,24
55613,0,0,1,8,9
55614,0,0,9,23,32
55615,1,0,15,32,48
55616,0,0,5,16,21
55617,0,0,2,13,15
55618,0,0,0,10,10
55619,0,1,0,9,10
55621,0,0,2,4,6
55622,0,1,12,14,27
55626,0,0,1,3,4
55630,0,0,7,7,14
55631,0,2,13,17,32
55632,0,0,3,28,31
55633,0,0,1,9,10
55634,0,0,4,5,9
55635,0,0,5,8,13
55636,1,1,9,14,25
55637,0,0,4,5,9
55638,0,1,11,23,35
55639,0,0,0,4,4
55641,0,3,1,17,21
55642,0,0,8,10,18
55643,0,1,6,17,24
55644,0,0,5,4,9
55646,1,5,13,25,44
55647,0,0,1,3,4
55649,0,0,19,30,49
55650,0,0,12,20,32
55651,0,0,9,21,30
55652,0,0,5,13,18
55653,0,0,4,5,9
55655,0,0,9,31,40
55656,1,2,8,23,34
55657,1,0,14,21,36
55658,0,0,8,9,17
55659,1,0,6,43,50
55660,0,0,6,7,13
55661,0,0,4,2,6
55662,0,0,1,4,5
55663,0,0,4,5,9
55664,0,0,5,15,20
55665,0,0,7,15,22
55666,0,0,10,18,28
55667,0,0,8,23,31
55668,0,0,5,9,14
55669,0,0,11,19,30
55670,1,0,5,11,17
55671,0,1,12,24,37
55672,0,0,14,35,49
55673,0,0,17,18,35
55674,0,0,5,17,22
55675,0,0,17,24,41
55676,0,0,12,16,28
55678,0,0,9,27,36
55679,0,0,7,9,16
55680,0,0,8,18,26
55681,0,0,6,14,20
55682,0,0,7,30,37
55683,0,0,9,16,25
55684,0,0,9,16,25
55685,0,0,9,15,24
55686,0,0,0,5,5
55687,0,1,11,23,35
55688,0,2,13,17,32
55689,1,1,2,13,17
55690,0,0,8,19,27
55691,0,0,4,11,15
55692,0,0,4,28,32
55693,0,0,13,22,35
55694,1,0,7,42,50
55695,0,0,1,10,11
55697,0,0,8,20,28
55699,0,0,9,28,37
55700,0,0,1,4,5
55701,0,0,9,12,21
55702,0,1,7,20,28
55703,0,0,11,36,47
55704,0,0,4,7,11
55705,0,0,4,17,21
55706,0,2,11,20,33
55707,1,5,13,25,44
55708,0,1,4,8,13
55709,0,0,1,3,4
55710,0,0,1,10,11
55711,1,1,9,14,25
55712,0,5,3,26,34
55713,0,0,4,20,24
55714,0,0,5,4,9
55715,0,0,8,10,18
55716,0,1,0,9,10
55717,0,0,0,7,7
55718,0,0,5,32,37
55719,0,0,12,12,24
55720,1,0,2,33,36
55721,0,1,0,8,9
55722,3,1,2,30,36
55723,0,0,1,28,29
55724,0,0,2,18,20
55725,0,1,4,45,50
55726,0,0,8,19,27
55727,0,0,15,29,44
55728,2,1,13,34,50
55729,0,0,1,10,11
55730,0,0,6,36,42
55731,1,1,9,14,25
55732,0,0,0,5,5
55733,1,1,9,14,25
55734,0,1,0,8,9
55735,0,0,3,28,31
55737,1,5,13,25,44
55738,1,5,13,25,44
55739,0,1,11,23,35
55740,0,0,6,36,42
55741,0,1,6,17,24
55742,0,2,11,37,50
55743,0,0,5,4,9
55744,0,0,8,6,14
55745,0,0,4,7,11
55746,0,0,10,13,23
55747,0,0,6,18,24
55748,0,0,7,14,21
55749,0,0,4,12,16
55750,0,1,13,31,45
55751,0,0,4,18,22
55752,0,0,3,16,19
55753,0,1,9,21,31
55754,0,2,3,37,42
55755,0,0,3,11,14
55756,0,1,8,11,20
55757,0,0,1,13,14
55758,0,0,1,4,5
55759,0,0,4,5,9
55760,0,0,2,11,13
55761,0,0,2,9,11
55762,0,0,10,10,20
55764,0,0,5,8,13
55765,0,0,1,13,14
55766,0,0,3,8,11
55767,0,0,3,4,7
55768,0,0,7,14,21
55769,0,0,14,34,48
55770,0,0,10,37,47
55771,0,0,1,5,6
55772,0,0,1,7,8
55773,0,2,7,10,19
55774,0,2,1,9,12
55775,0,0,3,9,12
55776,0,0,6,10,16
55777,0,0,8,20,28
55778,0,0,8,4,12
55779,0,0,9,21,30
55781,0,1,8,13,22
55782,0,1,9,35,45
55783,0,0,4,11,15
55784,0,0,1,34,35
55785,0,1,14,33,48
55786,0,2,1,3,6
55787,0,0,9,11,20
55788,0,0,8,14,22
55789,0,0,5,18,23
55790,0,1,0,18,19
55791,0,1,6,11,18
55792,1,1,13,35,50
55793,1,1,7,18,27
55794,0,0,4,12,16
55795,0,0,3,14,17
55796,0,0,0,2,2
55797,0,0,2,3,5
55798,0,1,1,11,13
55799,0,1,0,4,5
55800,0,0,4,17,21
55801,0,0,2,26,28
55802,0,0,7,15,22
55803,0,0,2,13,15
55804,0,0,4,6,10
55805,0,1,4,20,25
55806,0,0,2,3,5
55807,0,0,4,12,16
55808,0,0,5,5,10
55809,0,0,3,3,6
55810,1,0,11,29,41
55811,0,0,3,5,8
55812,0,0,5,4,9
55813,0,0,4,2,6
55814,0,0,6,14,20
55815,0,0,6,13,19
55816,1,0,0,3,4
55817,4,1,3,20,28
55818,0,0,10,24,34
55819,0,0,5,8,13
55820,0,0,5,9,14
55821,0,0,9,13,22
55823,0,0,1,7,8
55824,0,0,0,2,2
55826,0,0,0,10,10
55827,0,1,5,3,9
55828,0,0,5,7,12
55829,0,0,2,7,9
55830,0,0,7,11,18
55831,0,0,4,8,12
55832,1,0,5,12,18
55833,0,0,4,7,11
55834,0,0,5,8,13
55836,0,1,9,17,27
55837,0,0,6,4,10
55838,0,0,0,1,1
55839,0,0,0,3,3
55840,0,0,4,15,19
55841,0,1,7,22,30
55842,0,0,4,10,14
55844,0,0,3,7,10
55846,0,2,0,6,8
55847,0,0,4,9,13
55848,0,0,10,18,28
55849,0,0,5,3,8
55851,0,0,11,16,27
55852,0,0,2,11,13
55853,0,2,6,13,21
55854,0,3,1,22,26
55855,0,0,4,7,11
55856,1,0,3,18,22
55857,0,1,3,10,14
55859,0,0,17,17,34
55860,0,3,0,8,11
55861,0,0,7,14,21
55862,0,0,3,5,8
55863,1,0,5,21,27
55864,0,0,6,26,32
55865,0,0,8,4,12
55866,1,0,8,38,47
55867,0,0,2,4,6
55868,0,0,3,4,7
55869,0,0,1,2,3
55870,0,0,2,5,7
55871,0,0,8,13,21
55872,0,1,5,16,22
55873,0,0,7,8,15
55874,0,1,11,23,35
55875,0,0,1,15,16
55876,0,0,0,7,7
55877,0,0,3,5,8
55878,0,0,4,16,20
55879,0,0,10,13,23
55880,0,0,9,18,27
55881,0,0,7,22,29
55882,0,0,3,16,19
55883,0,0,4,28,32
55884,0,2,11,37,50
55885,0,0,3,2,5
55886,0,1,8,11,20
55887,0,1,12,30,43
55888,0,0,0,8,8
55889,0,0,3,15,18
55890,0,0,13,26,39
55891,0,0,16,34,50
55892,0,0,9,25,34
55893,1,1,14,19,35
55894,0,1,15,34,50
55895,0,0,2,13,15
55896,0,1,11,23,35
55897,0,2,4,15,21
55898,0,0,8,14,22
55899,0,0,6,19,25
55900,1,0,12,16,29
55901,0,0,7,7,14
55902,2,0,5,29,36
55903,0,0,13,20,33
55904,0,1,8,13,22
55905,2,0,13,21,36
55906,1,0,8,13,22
55907,1,1,13,35,50
55908,0,0,4,7,11
55909,0,0,4,6,10
55910,0,1,1,14,16
55911,0,0,1,10,11
55912,0,0,7,7,14
55913,0,0,6,26,32
55914,0,0,1,15,16
55915,1,0,16,33,50
55916,0,0,6,9,15
55917,1,0,12,29,42
55918,0,2,7,19,28
55919,0,0,1,2,3
55920,0,0,0,2,2
55921,4,1,3,20,28
55922,1,0,8,38,47
55923,0,0,2,26,28
55924,2,1,1,16,20
55925,0,0,5,4,9
55926,0,0,4,5,9
55927,1,1,13,25,40
55928,0,0,1,10,11
55929,0,1,6,35,42
55930,0,0,1,16,17
55932,0,3,1,18,22
55933,0,2,0,16,18
55934,0,0,0,2,2
55935,0,0,3,16,19
55936,0,2,3,37,42
55937,0,0,2,29,31
55938,0,0,1,10,11
55939,0,0,2,13,15
55940,0,1,14,33,48
55941,0,0,7,8,15
55942,1,1,13,25,40
55943,0,1,11,23,35
55944,0,0,14,25,39
55945,0,0,11,29,40
55946,0,0,11,25,36
55947,0,0,5,4,9
55948,0,0,1,15,16
55949,0,2,7,10,19
55950,0,0,3,7,10
55951,0,1,4,9,14
55952,0,0,4,30,34
55953,0,0,1,6,7
55954,0,0,16,28,44
55955,0,0,3,11,14
55956,0,2,5,33,40
55957,0,0,9,25,34
55958,0,0,10,10,20
55959,0,0,1,5,6
55960,0,0,2,14,16
55961,0,1,13,13,27
55962,0,0,4,10,14
55963,0,0,6,7,13
55964,0,0,8,9,17
55965,1,0,1,21,23
55966,0,0,8,2,10
55968,1,0,6,12,19
55969,0,0,16,34,50
55971,2,1,5,30,38
55972,0,0,8,10,18
55973,0,0,9,8,17
55974,0,0,1,19,20
55975,0,0,13,37,50
55976,0,0,7,3,10
55977,0,0,5,23,28
55979,0,0,7,11,18
55980,1,1,3,45,50
55981,0,0,3,7,10
55982,0,2,4,11,17
55983,0,0,2,4,6
55984,0,0,8,10,18
55985,0,1,0,19,20
55986,0,1,9,20,30
55987,1,0,5,25,31
55989,0,0,4,10,14
55990,0,0,9,14,23
55991,0,0,1,12,13
55992,0,0,10,28,38
55993,0,0,1,7,8
55994,0,0,8,19,27
55995,1,0,6,7,14
55996,0,1,7,31,39
55997,1,1,4,18,24
55998,0,1,9,22,32
55999,0,1,15,22,38
56001,0,0,1,4,5
56002,0,0,8,10,18
56003,0,0,0,9,9
56004,0,0,4,28,32
56005,0,0,5,19,24
56006,0,0,9,9,18
56007,0,0,8,11,19
56008,0,0,7,32,39
56010,0,0,7,8,15
56011,0,0,1,10,11
56012,0,0,8,7,15
56013,0,0,1,10,11
56015,0,1,2,11,14
56016,0,0,8,35,43
56017,0,0,1,6,7
56018,0,0,0,8,8
56019,0,1,9,20,30
56020,1,0,5,25,31
56021,1,0,1,21,23
56022,0,1,0,19,20
56024,0,0,13,30,43
56025,0,0,0,7,7
56026,0,0,3,26,29
56028,0,0,9,11,20
56029,0,1,5,44,50
56030,0,0,2,16,18
56033,0,2,5,33,40
56034,0,2,11,37,50
56035,0,0,4,7,11
56036,0,0,10,13,23
56037,0,0,5,4,9
56038,0,0,4,6,10
56039,0,0,8,19,27
56040,0,0,1,9,10
56041,0,0,6,21,27
56042,0,0,4,10,14
56043,0,0,6,16,22
56044,0,0,10,34,44
56045,0,0,2,25,27
56046,0,0,5,11,16
56047,0,0,8,12,20
56048,0,1,3,17,21
56049,0,0,11,16,27
56050,0,0,0,7,7
56051,0,0,8,8,16
56052,0,0,7,12,19
56053,0,1,6,14,21
56054,0,0,7,8,15
56055,0,0,0,6,6
56056,0,0,8,7,15
56057,1,0,1,5,7
56058,0,0,1,4,5
56059,0,0,8,7,15
56060,0,0,4,7,11
56061,0,1,8,8,17
56062,0,0,3,17,20
56063,0,0,9,25,34
56064,0,1,6,19,26
56065,0,0,1,18,19
56066,0,0,15,16,31
56068,0,0,0,10,10
56069,0,0,12,22,34
56070,0,0,6,11,17
56071,0,0,9,25,34
56072,0,0,8,15,23
56073,0,0,1,7,8
56074,0,0,3,10,13
56075,1,0,2,4,7
56076,0,0,5,5,10
56077,0,0,0,16,16
56078,0,0,7,15,22
56079,0,0,5,17,22
56080,0,0,2,8,10
56081,2,0,2,5,9
56082,0,1,7,16,24
56083,0,1,10,26,37
56084,0,0,9,6,15
56085,0,0,1,9,10
56086,0,0,2,3,5
56087,0,0,3,20,23
56088,0,0,3,4,7
56089,0,0,0,6,6
56090,0,0,6,15,21
56091,0,0,9,20,29
56092,0,1,12,25,38
56093,0,0,8,23,31
56094,0,0,2,9,11
56095,0,0,3,5,8
56096,0,0,4,18,22
56097,0,0,1,12,13
56098,0,1,4,7,12
56099,0,0,9,8,17
56100,0,0,4,20,24
56101,0,1,14,35,50
56102,0,0,4,6,10
56103,0,0,9,8,17
56104,0,1,8,18,27
56105,0,2,6,20,28
56106,0,0,2,4,6
56107,0,0,2,18,20
56108,0,0,10,28,38
56109,0,0,5,16,21
56110,0,0,3,20,23
56111,2,1,3,25,31
56112,0,0,7,7,14
56113,0,1,7,11,19
56114,0,0,7,7,14
56115,0,3,18,29,50
56116,0,0,0,11,11
56117,0,0,2,8,10
56118,0,0,11,27,38
56119,0,0,0,5,5
56120,0,2,8,23,33
56121,0,0,16,34,50
56122,0,0,2,6,8
56123,0,0,2,8,10
56124,0,1,1,23,25
56125,0,0,10,30,40
56126,0,0,4,13,17
56127,0,0,7,12,19
56128,0,0,15,28,43
56129,0,0,2,6,8
56130,0,0,9,7,16
56131,0,0,14,32,46
56132,1,0,13,20,34
56133,0,0,6,12,18
56134,0,0,4,12,16
56135,0,0,3,6,9
56136,0,0,6,9,15
56137,0,1,0,6,7
56138,0,1,2,19,22
56139,0,0,3,11,14
56140,0,0,1,31,32
56141,0,0,6,15,21
56142,0,1,11,14,26
56143,0,0,4,8,12
56144,0,0,2,3,5
56145,0,0,1,13,14
56146,0,0,2,34,36
56147,0,1,7,12,20
56148,0,0,2,6,8
56149,1,0,4,7,12
56150,0,0,5,19,24
56151,0,0,9,13,22
56152,0,0,5,25,30
56153,0,0,2,16,18
56154,0,0,1,2,3
56155,0,0,4,3,7
56156,0,1,7,30,38
56157,0,0,2,2,4
56158,0,0,3,7,10
56159,0,1,8,14,23
56160,0,0,11,14,25
56161,1,0,6,12,19
56162,0,0,8,19,27
56164,0,0,3,5,8
56165,0,0,8,15,23
56166,0,0,0,2,2
56167,0,0,6,13,19
56168,0,0,4,9,13
56169,0,0,0,5,5
56170,0,0,0,5,5
56171,0,0,3,6,9
56172,0,0,2,5,7
56173,0,0,4,15,19
56176,0,1,2,2,5
56177,0,0,7,15,22
56178,0,0,0,5,5
56180,0,1,8,15,24
56181,0,0,1,10,11
56183,0,2,6,9,17
56184,0,0,5,4,9
56185,0,0,1,6,7
56186,0,1,11,23,35
56187,0,2,8,9,19
56188,0,0,1,1,2
56189,0,0,5,9,14
56191,0,0,3,6,9
56192,0,0,10,13,23
56193,0,0,4,6,10
56194,0,0,0,5,5
56195,0,0,2,6,8
56196,0,5,3,26,34
56197,0,0,1,3,4
56198,0,0,6,4,10
56199,0,1,5,16,22
56200,1,0,4,5,10
56201,0,0,1,4,5
56202,0,0,0,2,2
56204,0,0,5,5,10
56205,0,0,11,14,25
56206,0,0,9,24,33
56207,0,0,11,22,33
56208,0,1,12,34,47
56209,1,0,6,42,49
56210,1,0,1,29,31
56211,0,2,11,37,50
56212,0,0,3,30,33
56213,0,0,10,26,36
56214,0,0,14,34,48
56215,0,1,7,4,12
56216,0,1,4,30,35
56217,0,0,17,31,48
56218,0,1,11,25,37
56219,0,0,3,17,20
56220,0,1,5,19,25
56221,1,0,9,20,30
56222,0,0,1,6,7
56223,0,0,12,19,31
56224,0,0,6,16,22
56225,0,1,9,21,31
56226,0,0,8,13,21
56227,0,0,6,15,21
56228,0,1,10,24,35
56229,0,0,9,14,23
56230,0,0,11,29,40
56231,0,0,9,41,50
56232,0,0,11,35,46
56233,0,1,11,23,35
56234,0,0,3,5,8
56235,0,0,8,13,21
56236,1,1,6,12,20
56237,0,0,6,12,18
56238,0,0,4,18,22
56239,0,0,12,14,26
56240,0,0,17,32,49
56241,0,0,5,8,13
56242,0,0,2,3,5
56243,0,0,10,24,34
56244,2,0,16,30,48
56245,0,0,11,24,35
56246,0,0,12,33,45
56247,0,0,6,22,28
56248,0,1,9,23,33
56249,0,0,8,24,32
56250,0,0,4,14,18
56251,0,0,6,25,31
56252,0,0,5,24,29
56253,0,0,1,15,16
56254,0,0,5,15,20
56255,0,0,17,29,46
56256,0,1,10,36,47
56257,0,0,4,17,21
56258,0,0,2,3,5
56259,0,0,1,4,5
56260,0,0,9,30,39
56261,0,1,7,30,38
56262,0,0,7,9,16
56263,0,0,2,7,9
56264,0,0,7,11,18
56265,0,0,8,12,20
56266,0,2,6,27,35
56267,0,0,10,18,28
56268,0,0,10,16,26
56269,0,0,6,17,23
56270,0,1,6,8,15
56271,0,0,1,2,3
56272,0,0,1,0,1
56274,0,0,5,9,14
56275,0,0,5,27,32
56276,0,0,0,5,5
56277,1,0,13,35,49
56278,0,0,11,27,38
56279,0,1,8,15,24
56280,2,1,3,25,31
56281,0,0,1,10,11
56282,0,0,4,6,10
56283,0,0,4,7,11
56284,0,1,0,6,7
56285,0,0,6,4,10
56286,0,0,2,8,10
56287,0,0,0,2,2
56288,1,1,8,40,50
56289,0,0,1,3,4
56290,0,5,3,26,34
56291,0,0,2,6,8
56292,0,0,1,4,5
56293,0,0,2,5,7
56294,0,0,0,2,2
56295,0,0,1,10,11
56296,0,0,9,28,37
56297,1,0,0,10,11
56298,0,0,0,5,5
56299,0,0,0,16,16
56300,0,2,6,20,28
56302,1,0,4,20,25
56303,1,0,13,35,49
56304,0,2,6,20,28
56305,0,1,11,23,35
56306,0,3,18,29,50
56307,1,1,8,40,50
56308,0,1,0,6,7
56309,0,0,4,17,21
56310,0,1,8,15,24
56311,0,0,6,2,8
56312,1,2,8,38,49
56313,0,1,8,29,38
56314,0,0,0,6,6
56315,0,1,1,12,14
56316,0,1,8,30,39
56317,0,2,10,11,23
56318,0,1,1,12,14
56319,0,1,8,29,38
56320,0,1,8,30,39
56321,0,0,6,2,8
56322,0,0,17,23,40
56323,6,2,2,15,25
56324,0,0,6,11,17
56326,0,1,0,8,9
56327,0,0,6,9,15
56328,0,0,5,4,9
56329,2,1,10,35,48
56330,0,0,5,16,21
56331,0,0,7,10,17
56332,0,0,8,17,25
56333,1,1,7,26,35
56334,0,2,1,6,9
56335,0,0,7,15,22
56336,0,0,4,6,10
56337,0,0,1,14,15
56338,0,0,6,9,15
56339,0,0,7,16,23
56340,0,0,7,12,19
56341,1,0,7,21,29
56342,0,1,2,13,16
56343,0,0,3,7,10
56344,0,0,7,21,28
56345,0,0,8,10,18
56346,0,0,2,16,18
56347,0,0,1,5,6
56348,1,1,2,32,36
56349,1,3,5,14,23
56350,0,0,13,25,38
56351,1,13,0,17,31
56352,0,0,0,5,5
56353,6,2,2,15,25
56354,0,1,0,8,9
56355,0,0,0,5,5
56356,0,3,0,14,17
56357,6,1,4,39,50
56358,1,3,5,14,23
56359,0,0,6,11,17
56360,2,1,2,10,15
56361,1,0,0,7,8
56362,0,0,7,16,23
56364,6,2,2,15,25
56365,6,2,2,15,25
56366,0,0,0,7,7
56367,1,1,2,32,36
56368,0,1,4,3,8
56369,0,0,7,13,20
56370,0,0,14,23,37
56371,0,3,0,14,17
56372,0,0,6,22,28
56373,0,0,9,10,19
56374,0,0,1,10,11
56375,1,1,4,10,16
56376,0,0,4,6,10
56377,0,0,0,5,5
56378,0,1,7,23,31
56379,0,0,6,16,22
56380,0,0,7,14,21
56381,0,3,14,22,39
56382,0,0,5,16,21
56383,0,0,0,2,2
56384,0,0,16,34,50
56385,0,0,12,19,31
56386,0,0,1,11,12
56387,0,0,6,2,8
56388,6,2,2,15,25
56389,0,0,6,6,12
56390,0,0,8,15,23
56391,0,0,8,10,18
56392,0,1,0,8,9
56393,0,0,1,4,5
56394,0,0,5,9,14
56395,0,1,4,2,7
56396,0,0,2,4,6
56397,0,0,6,11,17
56399,0,0,10,9,19
56400,0,0,10,30,40
56401,0,0,2,9,11
56402,0,0,16,32,48
56403,0,1,13,23,37
56404,0,0,2,16,18
56405,0,0,9,17,26
56406,0,0,10,23,33
56407,0,0,3,3,6
56408,1,0,10,20,31
56409,0,0,8,25,33
56410,0,0,9,5,14
56411,0,0,3,6,9
56412,0,0,0,6,6
56413,0,1,5,22,28
56414,0,2,0,16,18
56415,0,0,0,8,8
56416,0,0,12,21,33
56417,0,0,3,10,13
56418,0,0,4,2,6
56419,0,0,11,11,22
56420,0,1,1,18,20
56421,0,0,7,13,20
56422,0,0,0,6,6
56423,0,0,8,20,28
56425,0,0,4,10,14
56426,0,0,5,25,30
56427,0,0,12,16,28
56428,0,0,2,2,4
56430,0,0,2,7,9
56431,0,0,8,12,20
56432,0,0,3,5,8
56433,0,0,4,10,14
56434,0,1,1,16,18
56435,0,0,7,26,33
56436,0,2,0,8,10
56437,0,0,8,12,20
56438,0,0,5,23,28
56439,0,0,11,12,23
56441,0,1,5,11,17
56442,0,0,2,2,4
56443,1,0,5,24,30
56444,0,0,8,8,16
56445,0,0,2,21,23
56446,1,0,7,11,19
56447,0,2,7,34,43
56448,0,0,0,10,10
56449,0,0,3,6,9
56450,0,0,3,19,22
56451,0,0,11,8,19
56452,0,0,19,28,47
56453,0,0,6,10,16
56454,0,0,4,4,8
56455,0,0,6,16,22
56456,0,3,19,22,44
56457,0,0,5,5,10
56458,1,1,20,27,49
56459,0,0,6,9,15
56460,0,0,13,23,36
56461,0,0,1,7,8
56462,0,0,9,17,26
56463,1,1,4,10,16
56464,0,0,4,1,5
56465,0,2,0,10,12
56466,0,0,8,12,20
56467,0,0,14,22,36
56468,0,0,11,34,45
56469,0,0,6,7,13
56470,0,8,2,7,17
56471,0,0,7,10,17
56472,0,0,8,20,28
56473,0,1,7,9,17
56474,1,2,10,18,31
56475,0,0,2,17,19
56476,0,0,1,4,5
56477,0,0,3,6,9
56478,1,0,4,26,31
56479,0,0,6,17,23
56480,0,0,7,7,14
56481,2,6,7,35,50
56482,0,0,10,27,37
56483,0,0,4,5,9
56484,0,1,4,21,26
56485,0,0,2,20,22
56486,0,0,15,18,33
56487,0,1,5,39,45
56488,0,0,2,9,11
56489,0,0,7,7,14
56490,0,0,2,18,20
56491,0,0,15,30,45
56492,0,0,13,25,38
56493,0,1,0,8,9
56494,1,0,4,9,14
56495,0,0,5,9,14
56496,0,0,5,11,16
56497,0,1,7,9,17
56498,0,1,2,5,8
56499,0,0,0,4,4
56501,0,0,5,8,13
56502,0,0,12,33,45
56503,0,0,1,7,8
56504,0,2,13,35,50
56505,0,0,8,9,17
56506,0,0,3,3,6
56507,0,0,8,22,30
56508,0,0,6,10,16
56509,0,0,11,3,14
56510,1,1,1,8,11
56511,0,0,8,6,14
56512,0,0,5,2,7
56513,0,0,4,4,8
56514,0,0,2,11,13
56515,0,0,2,9,11
56516,0,0,0,7,7
56517,0,1,0,6,7
56519,0,1,0,7,8
56520,0,0,8,9,17
56521,0,0,9,11,20
56522,0,1,7,10,18
56523,0,0,6,6,12
56524,0,0,3,18,21
56525,0,0,5,8,13
56526,1,0,8,4,13
56527,0,0,4,5,9
56528,0,0,1,5,6
56529,0,0,12,12,24
56530,0,0,6,19,25
56531,0,0,6,25,31
56532,0,1,7,14,22
56533,0,0,7,8,15
56534,1,1,3,12,17
56535,0,0,5,6,11
56536,0,0,11,2,13
56537,0,0,6,3,9
56538,0,0,6,9,15
56539,0,0,6,25,31
56540,0,0,5,4,9
56541,1,0,1,8,10
56542,0,1,16,20,37
56543,1,0,4,10,15
56544,0,0,19,19,38
56545,0,0,14,27,41
56546,0,0,3,9,12
56547,0,0,2,5,7
56548,0,0,5,4,9
56549,0,0,2,13,15
56550,0,1,0,8,9
56551,0,0,4,6,10
56552,0,0,5,9,14
56553,0,0,7,12,19
56554,0,0,4,6,10
56555,0,0,8,21,29
56556,0,0,7,19,26
56557,0,0,6,16,22
56558,0,1,11,11,23
56559,0,0,1,5,6
56560,0,1,2,7,10
56561,0,0,6,6,12
56562,0,0,15,33,48
56563,0,5,10,26,41
56564,0,0,2,1,3
56565,0,5,1,28,34
56567,0,0,1,6,7
56568,0,0,0,5,5
56570,1,1,1,2,5
56571,0,0,4,1,5
56572,0,0,7,5,12
56573,0,0,4,11,15
56574,0,0,2,3,5
56575,0,0,1,0,1
56576,0,0,8,13,21
56577,0,0,6,6,12
56579,1,0,0,7,8
56580,0,0,3,6,9
56581,0,0,14,23,37
56582,0,0,8,13,21
56583,0,0,1,5,6
56584,0,0,6,22,28
56585,0,0,6,12,18
56587,0,0,0,2,2
56588,0,0,2,16,18
56590,0,3,0,18,21
56591,1,0,0,7,8
56592,6,2,2,15,25
56593,1,0,1,8,10
56594,0,0,4,1,5
56595,1,1,10,25,37
56596,0,0,16,32,48
56597,0,1,9,13,23
56598,0,0,6,22,28
56599,0,0,14,15,29
56600,0,0,11,24,35
56601,0,2,14,34,50
56602,0,1,9,9,19
56603,0,0,9,27,36
56604,0,0,0,14,14
56605,0,4,13,33,50
56606,0,0,2,13,15
56607,4,0,11,31,46
56608,0,0,10,12,22
56609,0,0,11,23,34
56610,0,1,3,16,20
56611,0,0,2,16,18
56612,6,1,0,25,32
56613,1,0,12,29,42
56614,0,0,6,21,27
56615,0,0,9,15,24
56616,0,0,11,34,45
56617,1,0,13,19,33
56618,0,0,7,19,26
56619,0,0,8,3,11
56620,0,0,1,6,7
56621,0,0,8,7,15
56622,0,0,17,23,40
56623,0,0,1,5,6
56624,0,1,10,19,30
56625,0,2,12,33,47
56626,1,10,13,26,50
56627,0,1,7,23,31
56628,0,0,6,21,27
56629,0,0,14,27,41
56630,0,3,1,15,19
56632,0,0,2,6,8
56633,0,0,2,26,28
56634,2,0,2,1,5
56635,1,0,9,21,31
56636,0,0,11,26,37
56637,0,0,14,27,41
56639,0,0,19,29,48
56640,0,0,3,5,8
56641,0,0,7,7,14
56642,0,0,14,24,38
56643,0,0,7,15,22
56644,0,0,3,38,41
56645,0,1,18,31,50
56646,0,0,8,13,21
56647,0,1,2,6,9
56648,0,0,10,13,23
56649,1,1,7,26,35
56650,0,0,10,9,19
56651,0,1,1,18,20
56652,0,0,8,15,23
56653,1,0,0,7,8
56654,0,0,2,18,20
56655,0,0,0,7,7
56656,6,2,2,15,25
56657,0,1,7,9,17
56658,0,0,1,4,5
56659,2,0,4,21,27
56660,0,0,0,2,2
56661,0,0,0,5,5
56663,0,0,6,11,17
56664,0,0,2,7,9
56665,0,0,6,16,22
56666,1,0,0,7,8
56667,0,0,8,17,25
56668,0,0,0,4,4
56669,2,0,4,21,27
56670,0,0,3,38,41
56671,2,0,2,21,25
56672,0,0,0,5,5
56673,0,0,2,8,10
56674,0,3,3,34,40
56675,0,0,1,5,6
56676,0,0,2,7,9
56677,1,0,0,7,8
56678,0,0,6,12,18
56679,6,2,2,15,25
56680,0,0,11,37,48
56681,1,0,8,23,32
56682,1,0,12,29,42
56683,0,0,0,7,7
56684,0,0,13,25,38
56685,0,0,12,21,33
56686,2,0,2,1,5
56687,0,0,0,7,7
56688,0,1,18,31,50
56689,6,2,2,15,25
56690,0,0,2,7,9
56691,1,3,1,25,30
56692,0,0,7,15,22
56693,0,1,7,23,31
56694,0,0,12,19,31
56695,0,0,14,23,37
56696,0,0,0,2,2
56697,2,0,2,1,5
56698,0,0,6,22,28
56699,0,0,17,23,40
56700,0,0,0,7,7
56701,1,0,5,24,30
56702,6,2,2,15,25
56703,0,0,6,11,17
56704,0,0,4,20,24
56705,0,0,6,11,17
56706,0,0,8,15,23
56707,0,1,8,21,30
56708,0,0,4,23,27
56709,0,0,10,19,29
56710,0,2,0,16,18
56711,0,0,5,24,29
56712,0,0,14,15,29
56713,0,0,5,15,20
56714,0,1,4,14,19
56715,0,0,4,15,19
56716,0,0,9,10,19
56717,1,0,3,12,16
56718,0,0,10,10,20
56719,0,0,9,22,31
56720,0,2,15,33,50
56721,0,0,6,14,20
56722,0,0,3,9,12
56723,0,0,2,10,12
56724,0,0,4,9,13
56725,0,1,5,15,21
56726,0,0,1,8,9
56727,0,0,9,7,16
56729,0,0,8,10,18
56730,0,0,11,25,36
56731,0,0,2,12,14
56732,0,0,2,16,18
56733,1,0,3,6,10
56734,0,0,2,15,17
56735,0,0,5,7,12
56736,3,1,6,40,50
56737,0,0,2,7,9
56738,1,0,5,9,15
56739,0,1,7,16,24
56740,0,0,4,10,14
56741,0,1,4,24,29
56742,0,1,4,7,12
56743,0,0,8,21,29
56744,0,0,11,11,22
56745,0,0,5,19,24
56746,0,0,2,10,12
56747,0,0,3,13,16
56748,1,2,13,30,46
56749,0,1,2,15,18
56750,0,0,0,24,24
56751,0,0,5,8,13
56752,0,0,8,22,30
56753,0,0,8,20,28
56754,0,0,1,6,7
56755,0,0,5,10,15
56757,0,0,2,12,14
56759,0,0,6,5,11
56760,0,0,3,3,6
56761,0,0,0,9,9
56762,0,0,5,3,8
56763,0,1,13,17,31
56764,0,0,2,3,5
56765,0,2,7,12,21
56766,0,0,1,9,10
56767,0,0,15,35,50
56768,1,0,2,44,47
56769,0,0,0,23,23
56770,0,0,2,3,5
56771,0,0,5,10,15
56772,0,0,4,17,21
56773,0,0,1,4,5
56774,0,0,4,1,5
56775,0,0,8,21,29
56776,0,0,11,9,20
56778,0,0,0,7,7
56779,1,0,8,21,30
56780,0,1,5,13,19
56781,0,0,6,11,17
56782,0,1,23,26,50
56783,0,0,3,6,9
56784,0,0,3,15,18
56785,0,0,5,6,11
56786,0,1,5,4,10
56787,0,0,4,3,7
56788,0,0,1,7,8
56789,0,0,8,5,13
56790,0,0,7,10,17
56791,0,1,4,21,26
56792,0,2,2,14,18
56793,0,0,8,11,19
56794,0,0,11,33,44
56795,0,0,12,23,35
56796,0,2,8,2,12
56797,0,0,5,1,6
56798,0,1,9,5,15
56799,0,2,1,15,18
56800,0,0,5,13,18
56801,2,0,1,12,15
56802,0,1,14,35,50
56803,0,1,15,24,40
56804,0,0,5,12,17
56805,0,1,10,4,15
56806,0,0,1,5,6
56807,0,0,3,6,9
56808,1,0,7,22,30
56809,0,0,6,1,7
56810,0,0,4,6,10
56811,0,0,3,6,9
56812,0,0,8,26,34
56813,0,0,6,19,25
56815,0,0,6,4,10
56816,0,0,3,7,10
56817,0,0,4,10,14
56818,0,0,4,7,11
56819,0,0,5,8,13
56820,0,0,9,14,23
56821,0,1,3,6,10
56822,0,0,2,3,5
56823,0,0,2,11,13
56824,1,0,3,8,12
56826,0,0,2,6,8
56827,0,1,4,45,50
56828,0,0,5,2,7
56829,0,0,6,15,21
56830,0,0,4,22,26
56831,0,0,6,6,12
56832,0,1,8,12,21
56833,0,0,5,5,10
56834,1,0,0,7,8
56835,0,0,2,7,9
56837,0,1,3,14,18
56838,0,2,5,32,39
56839,1,1,4,13,19
56840,0,0,11,9,20
56841,0,0,7,9,16
56842,0,0,1,13,14
56843,0,0,8,11,19
56844,0,0,3,2,5
56845,0,0,4,9,13
56846,0,0,3,5,8
56847,0,1,3,2,6
56848,0,0,3,6,9
56850,0,0,8,5,13
56851,0,1,9,16,26
56852,0,0,5,6,11
56853,1,0,3,11,15
56854,0,2,13,26,41
56855,0,0,3,5,8
56857,0,1,13,31,45
56858,0,0,0,5,5
56859,4,0,0,12,16
56860,2,1,10,35,48
56861,0,0,4,3,7
56862,0,0,8,15,23
56863,0,0,8,13,21
56864,0,0,10,19,29
56865,0,0,7,17,24
56867,2,1,11,26,40
56868,0,0,2,3,5
56869,0,0,8,23,31
56870,0,0,1,35,36
56871,0,0,6,22,28
56872,1,2,8,38,49
56873,1,0,0,7,8
56874,0,0,6,6,12
56875,0,1,9,21,31
56876,0,0,1,28,29
56877,1,0,16,31,48
56878,0,0,17,25,42
56879,1,0,8,35,44
56880,0,2,14,32,48
56881,0,1,15,34,50
56882,0,0,16,34,50
56883,0,0,2,14,16
56884,0,2,12,33,47
56885,0,0,7,8,15
56886,0,1,12,22,35
56887,0,0,7,14,21
56888,0,0,5,5,10
56889,2,1,10,35,48
56890,0,1,10,39,50
56891,0,0,8,37,45
56892,0,0,8,15,23
56893,1,1,17,23,42
56894,0,1,12,34,47
56895,0,0,13,37,50
56896,0,0,4,16,20
56897,0,1,7,19,27
56898,0,0,11,26,37
56899,0,0,8,17,25
56900,1,1,4,17,23
56901,0,1,8,32,41
56902,0,0,3,38,41
56903,1,0,3,6,10
56904,0,0,5,4,9
56905,0,0,1,14,15
56906,0,0,4,32,36
56907,0,0,7,15,22
56908,0,2,11,37,50
56909,0,0,4,8,12
56910,0,0,15,25,40
56911,0,0,7,19,26
56912,0,0,19,18,37
56913,0,0,7,28,35
56914,0,2,8,5,15
56915,0,0,13,7,20
56916,2,0,16,32,50
56917,0,4,17,21,42
56918,0,0,5,11,16
56919,0,0,1,6,7
56920,0,0,9,16,25
56921,0,0,8,42,50
56922,0,0,1,20,21
56923,0,0,4,6,10
56924,0,1,2,12,15
56925,0,0,12,22,34
56926,0,0,6,31,37
56927,1,0,6,7,14
56928,0,1,14,21,36
56929,0,0,8,23,31
56930,0,0,6,6,12
56932,0,0,2,3,5
56933,1,0,0,7,8
56934,0,1,1,14,16
56935,1,0,2,11,14
56936,0,2,0,16,18
56937,0,0,11,32,43
56938,0,2,0,27,29
56939,0,0,4,16,20
56940,1,0,4,13,18
56941,0,0,0,9,9
56942,0,0,6,8,14
56943,0,0,1,8,9
56944,0,1,13,31,45
56945,0,0,2,16,18
56946,0,2,1,30,33
56947,0,0,0,9,9
56948,0,1,18,31,50
56949,0,0,5,7,12
56950,0,0,5,6,11
56951,0,0,6,11,17
56952,1,0,0,7,8
56953,0,0,4,20,24
56954,0,2,5,32,39
56956,0,0,0,12,12
56957,0,0,0,6,6
56958,3,1,2,30,36
56959,0,1,7,19,27
56960,0,0,1,20,21
56961,0,1,15,34,50
56962,0,0,0,5,5
56963,2,1,2,44,49
56964,0,0,2,14,16
56965,0,2,1,30,33
56966,0,0,9,37,46
56967,0,0,1,17,18
56968,0,0,4,37,41
56970,0,0,3,38,41
56971,1,0,0,7,8
56973,0,0,2,14,16
56974,0,1,18,31,50
56975,0,0,6,11,17
56976,0,0,8,13,21
56977,0,0,9,10,19
56978,0,0,5,11,16
56979,0,0,6,11,17
56980,0,0,7,9,16
56981,0,0,7,9,16
56982,0,0,4,14,18
56983,0,0,11,16,27
56984,0,0,14,29,43
56985,0,2,0,16,18
56986,0,3,4,19,26
56987,0,0,4,10,14
56988,0,0,2,4,6
56989,0,0,2,7,9
56990,0,0,14,25,39
56991,0,1,8,23,32
56992,0,0,7,5,12
56993,1,1,5,36,43
56994,0,0,6,15,21
56995,0,0,8,13,21
56997,0,0,8,10,18
56998,0,0,9,13,22
56999,0,3,5,17,25
57000,0,0,1,5,6
57001,0,2,10,37,49
57002,0,0,4,0,4
57003,0,0,12,21,33
57005,0,0,8,26,34
57006,0,0,7,7,14
57007,0,0,2,4,6
57008,0,1,9,22,32
57009,0,0,6,11,17
57010,0,0,0,7,7
57011,0,0,10,15,25
57012,1,0,8,16,25
57013,0,0,3,5,8
57014,0,1,15,33,49
57015,0,0,1,16,17
57016,0,1,12,21,34
57017,0,0,12,28,40
57018,0,0,9,6,15
57019,0,0,3,15,18
57021,0,1,11,15,27
57022,0,0,4,4,8
57023,0,0,2,17,19
57024,0,1,2,17,20
57025,0,1,11,20,32
57026,0,0,2,4,6
57027,0,0,1,3,4
57028,0,0,9,8,17
57029,0,0,1,9,10
57030,0,0,7,8,15
57031,0,0,2,17,19
57032,0,0,9,5,14
57033,0,0,5,11,16
57035,0,4,6,8,18
57036,0,0,1,1,2
57037,0,1,8,6,15
57038,2,1,11,26,40
57039,0,0,4,9,13
57040,0,0,5,13,18
57041,0,0,3,6,9
57042,0,0,11,19,30
57043,0,0,0,5,5
57044,0,5,9,36,50
57045,0,0,6,5,11
57046,0,1,9,32,42
57047,1,0,3,6,10
57048,0,0,1,11,12
57049,0,0,5,17,22
57050,0,0,0,11,11
57051,0,0,3,7,10
57052,0,0,2,14,16
57053,0,0,4,3,7
57054,0,0,9,9,18
57055,0,0,3,14,17
57056,0,0,1,4,5
57058,0,0,2,3,5
57059,0,0,1,0,1
57060,0,1,4,16,21
57061,0,0,4,7,11
57062,0,0,5,0,5
57065,0,0,13,26,39
57066,0,0,11,18,29
57067,0,2,3,11,16
57068,0,0,6,9,15
57069,0,0,2,1,3
57070,0,0,6,22,28
57072,0,0,1,1,2
57073,0,7,0,15,22
57074,0,0,9,22,31
57075,0,0,6,8,14
57076,2,2,3,13,20
57077,0,0,5,9,14
57078,0,0,8,15,23
57079,0,0,6,18,24
57080,0,0,8,4,12
57082,0,0,7,13,20
57083,0,0,3,4,7
57084,0,0,3,16,19
57085,0,0,9,29,38
57086,0,0,13,20,33
57087,1,0,2,9,12
57088,0,0,10,11,21
57089,1,0,0,4,5
57091,0,1,7,16,24
57092,1,2,8,38,49
57093,1,0,0,25,26
57094,1,0,1,5,7
57095,0,0,2,8,10
57096,0,0,2,7,9
57097,0,0,1,4,5
57098,0,0,7,15,22
57099,0,0,0,7,7
57100,0,1,1,18,20
57101,0,0,10,21,31
57102,0,1,17,27,45
57103,0,3,10,36,49
57104,0,0,11,24,35
57105,0,0,1,19,20
57106,0,2,0,16,18
57107,0,1,17,29,47
57108,0,1,11,23,35
57109,0,0,0,6,6
57110,0,0,1,24,25
57111,0,0,12,28,40
57112,0,0,3,15,18
57113,1,2,8,38,49
57114,0,1,8,23,32
57115,0,1,3,20,24
57116,0,0,14,26,40
57117,1,0,1,5,7
57118,0,0,7,8,15
57119,0,0,9,13,22
57120,0,0,9,38,47
57121,0,2,1,18,21
57122,0,0,1,13,14
57123,0,0,14,24,38
57124,0,0,13,26,39
57125,0,0,13,35,48
57126,0,0,2,7,9
57127,0,0,14,36,50
57128,0,0,1,6,7
57129,0,0,10,17,27
57130,0,0,7,13,20
57132,3,1,2,15,21
57133,0,0,4,9,13
57134,0,0,1,15,16
57135,0,0,7,9,16
57136,0,0,11,12,23
57137,1,0,0,25,26
57139,1,0,3,12,16
57141,0,0,2,8,10
57142,0,0,0,21,21
57143,0,0,1,4,5
57144,0,0,2,17,19
57145,0,7,0,15,22
57146,0,0,8,13,21
57147,0,0,6,11,17
57148,0,0,2,3,5
57149,0,0,5,6,11
57150,0,0,3,23,26
57151,0,1,1,17,19
57152,0,0,1,3,4
57153,1,0,15,25,41
57154,0,1,12,30,43
57155,0,2,1,18,21
57156,0,0,9,37,46
57157,3,1,2,15,21
57158,0,0,7,8,15
57159,0,0,4,37,41
57160,0,0,0,21,21
57161,0,0,0,7,7
57162,0,0,0,21,21
57163,0,0,0,21,21
57164,0,0,6,11,17
57165,0,0,0,7,7
57166,0,0,7,15,22
57167,0,0,1,4,5
57169,2,0,2,17,21
57170,0,0,6,13,19
57171,1,0,1,11,13
57172,0,0,5,18,23
57173,0,0,2,3,5
57174,0,0,9,16,25
57176,0,1,2,10,13
57177,0,0,2,16,18
57178,0,0,6,5,11
57179,0,1,6,19,26
57180,1,1,1,14,17
57181,0,1,5,19,25
57182,0,1,8,15,24
57183,0,0,3,17,20
57184,0,0,5,10,15
57185,0,0,8,8,16
57186,2,0,4,14,20
57189,0,0,5,6,11
57190,0,0,0,1,1
57191,0,0,6,16,22
57192,0,0,4,9,13
57193,0,0,5,15,20
57194,0,0,8,13,21
57195,0,0,5,0,5
57196,0,0,1,4,5
57197,0,1,2,7,10
57198,0,0,3,12,15
57199,0,1,3,1,5
57200,0,0,4,21,25
57201,0,1,8,13,22
57202,0,0,11,11,22
57203,0,0,7,5,12
57204,1,0,1,6,8
57205,1,1,16,29,47
57206,0,0,7,10,17
57207,0,0,2,2,4
57210,0,2,4,11,17
57211,0,0,8,15,23
57212,0,0,3,16,19
57213,0,3,3,28,34
57214,0,0,3,4,7
57215,0,1,7,37,45
57216,0,0,9,15,24
57217,1,0,1,21,23
57218,0,0,2,4,6
57219,0,1,4,8,13
57220,0,0,4,9,13
57221,0,2,11,21,34
57222,0,1,7,15,23
57223,0,0,5,12,17
57224,0,0,1,12,13
57225,0,0,2,8,10
57226,0,0,6,2,8
57227,0,0,6,18,24
57228,0,0,2,18,20
57229,0,1,3,5,9
57230,0,1,10,15,26
57231,0,0,10,13,23
57232,0,0,3,7,10
57233,0,0,3,5,8
57234,1,0,5,9,15
57235,0,0,2,11,13
57236,0,0,8,37,45
57237,0,1,11,38,50
57238,0,0,3,4,7
57239,0,1,13,31,45
57240,0,1,6,41,48
57241,0,1,7,15,23
57242,0,1,4,11,16
57243,0,1,9,40,50
57244,0,0,7,9,16
57245,0,0,9,6,15
57246,0,0,2,40,42
57247,0,0,2,24,26
57248,0,0,1,16,17
57249,0,0,8,25,33
57250,0,0,5,6,11
57251,0,0,13,22,35
57252,0,1,10,21,32
57253,0,0,3,5,8
57254,0,0,10,13,23
57255,0,0,8,11,19
57256,0,1,4,21,26
57257,0,0,4,10,14
57258,0,0,5,19,24
57259,1,1,9,33,44
57260,0,0,12,28,40
57261,0,1,9,38,48
57262,0,0,7,18,25
57263,0,0,12,13,25
57264,0,0,4,9,13
57265,0,1,10,15,26
57266,0,0,1,4,5
57267,1,0,1,21,23
57268,0,0,2,18,20
57269,0,0,5,6,11
57270,1,1,16,29,47
57271,0,3,3,28,34
57272,1,0,5,9,15
57273,1,1,9,33,44
57274,0,0,0,14,14
57275,1,0,10,35,46
57276,1,0,1,11,13
57277,0,0,2,3,5
57278,0,1,7,15,23
57279,6,0,0,25,31
57280,0,2,11,21,34
57281,0,2,11,21,34
57282,0,0,1,4,5
57283,0,0,2,8,10
57284,0,0,4,8,12
57285,0,0,5,9,14
57286,0,0,2,0,2
57287,0,0,7,18,25
57288,3,2,5,21,31
57289,0,2,1,24,27
57290,0,2,4,18,24
57291,0,3,5,15,23
57292,0,0,13,36,49
57293,0,0,8,13,21
57294,0,0,3,10,13
57295,0,0,2,6,8
57296,0,2,1,12,15
57297,0,0,0,9,9
57298,0,0,11,16,27
57299,1,0,4,13,18
57300,1,1,10,19,31
57302,0,0,1,12,13
57304,0,0,6,6,12
57305,0,1,17,29,47
57307,0,1,2,28,31
57308,0,0,6,10,16
57309,0,0,6,9,15
57310,0,0,16,34,50
57311,0,0,6,18,24
57312,0,0,2,7,9
57313,0,0,0,6,6
57314,0,0,3,6,9
57315,0,0,9,13,22
57316,0,0,0,14,14
57317,0,0,0,11,11
57319,0,1,1,18,20
57320,0,0,0,5,5
57321,0,0,3,5,8
57322,0,0,0,4,4
57323,0,0,9,14,23
57324,0,0,0,7,7
57325,0,0,0,5,5
57328,0,0,1,8,9
57329,0,2,2,18,22
57330,0,0,5,0,5
57331,0,0,5,6,11
57332,0,0,5,3,8
57333,0,0,10,25,35
57334,0,0,8,5,13
57335,0,2,15,32,49
57336,0,0,7,6,13
57337,0,0,11,34,45
57338,0,0,8,12,20
57339,0,2,6,9,17
57340,0,2,3,23,28
57341,0,0,0,7,7
57342,0,0,7,3,10
57343,0,0,7,10,17
57344,0,0,11,22,33
57345,0,0,5,22,27
57346,0,0,3,7,10
57347,0,0,1,4,5
57348,0,0,4,20,24
57349,0,0,4,9,13
57350,0,0,4,2,6
57351,0,0,6,11,17
57352,0,0,3,23,26
57353,0,0,8,17,25
57354,1,0,5,13,19
57355,0,1,3,9,13
57356,0,0,7,8,15
57357,0,0,2,23,25
57358,0,0,5,8,13
57359,0,0,10,39,49
57360,0,0,14,8,22
57361,0,0,1,5,6
57362,0,0,0,5,5
57363,0,0,15,18,33
57364,0,0,5,0,5
57365,1,2,1,18,22
57366,0,0,7,6,13
57367,0,0,6,6,12
57368,0,0,6,9,15
57369,0,0,7,15,22
57370,0,0,7,9,16
57371,0,0,2,8,10
57372,0,0,1,21,22
57374,1,0,8,11,20
57375,0,0,7,7,14
57376,1,0,5,9,15
57377,0,0,16,30,46
57378,1,0,10,20,31
57379,0,0,9,17,26
57380,0,0,7,15,22
57381,0,0,8,11,19
57382,0,0,5,3,8
57383,0,0,8,16,24
57384,0,0,4,4,8
57385,0,0,3,2,5
57386,0,1,0,14,15
57387,0,1,15,31,47
57388,0,0,4,12,16
57389,0,0,1,18,19
57390,0,0,1,4,5
57391,2,1,6,34,43
57392,0,0,9,12,21
57393,0,0,5,3,8
57394,0,0,0,7,7
57395,0,0,4,4,8
57396,0,0,6,5,11
57397,0,0,18,16,34
57398,0,0,6,12,18
57399,0,0,1,10,11
57400,0,0,5,1,6
57401,0,0,2,11,13
57402,0,1,7,36,44
57403,0,0,7,9,16
57404,0,0,3,4,7
57405,0,0,1,7,8
57406,0,2,5,42,49
57407,0,1,1,7,9
57408,0,1,4,9,14
57409,0,0,9,15,24
57410,0,0,2,2,4
57411,1,0,5,30,36
57412,0,0,6,9,15
57413,0,0,5,13,18
57414,0,1,14,16,31
57415,0,0,7,11,18
57416,0,0,3,8,11
57417,0,1,4,6,11
57418,0,0,2,5,7
57419,0,0,0,8,8
57420,1,0,2,8,11
57421,2,1,12,35,50
57422,0,1,4,33,38
57423,0,0,1,6,7
57424,0,0,2,14,16
57425,0,0,1,3,4
57426,0,1,1,30,32
57427,0,0,4,11,15
57428,0,0,4,16,20
57429,0,1,10,27,38
57430,1,13,0,17,31
57431,0,0,7,9,16
57432,0,2,1,11,14
57433,0,0,8,14,22
57435,0,0,6,4,10
57436,0,0,0,4,4
57437,0,2,1,7,10
57438,0,1,5,8,14
57439,0,0,7,9,16
57440,1,0,8,19,28
57441,0,1,9,17,27
57442,0,0,5,9,14
57443,0,0,5,16,21
57444,1,1,4,22,28
57445,0,1,5,11,17
57446,0,0,4,9,13
57449,1,2,8,38,49
57450,0,0,2,8,10
57451,0,0,4,8,12
57454,0,0,3,2,5
57455,0,0,1,8,9
57456,0,0,3,7,10
57458,0,0,2,17,19
57459,0,3,19,22,44
57460,0,0,7,11,18
57461,0,1,8,29,38
57462,1,0,7,21,29
57463,0,0,7,15,22
57464,0,0,2,18,20
57465,1,1,4,23,29
57466,0,4,3,10,17
57467,0,0,16,32,48
57468,0,1,11,20,32
57469,0,2,1,14,17
57470,1,1,12,36,50
57471,3,2,5,21,31
57472,0,0,14,21,35
57473,0,3,10,36,49
57474,0,0,13,36,49
57475,0,0,3,2,5
57476,0,0,9,9,18
57477,0,1,6,27,34
57478,0,1,2,17,20
57479,0,0,7,18,25
57480,0,0,11,19,30
57481,3,0,3,20,26
57482,0,0,11,34,45
57483,0,1,17,29,47
57486,0,0,4,27,31
57487,0,0,8,41,49
57488,0,0,3,40,43
57489,0,0,7,24,31
57490,0,1,11,38,50
57491,0,0,6,12,18
57492,0,1,5,14,20
57493,0,1,5,25,31
57494,0,0,14,34,48
57495,0,0,4,5,9
57496,0,0,1,12,13
57497,0,0,8,14,22
57498,2,0,10,31,43
57499,0,2,12,27,41
57500,0,0,14,35,49
57501,0,0,13,24,37
57502,0,1,10,38,49
57503,0,0,18,22,40
57504,0,1,12,30,43
57505,1,0,9,33,43
57506,0,0,2,8,10
57507,0,2,2,31,35
57508,1,1,3,24,29
57509,0,1,12,24,37
57510,0,0,6,15,21
57511,0,1,2,8,11
57512,0,0,14,31,45
57513,0,0,8,27,35
57514,0,0,8,19,27
57515,0,0,0,7,7
57516,1,0,7,21,29
57517,0,0,15,33,48
57518,0,0,6,26,32
57519,1,0,10,38,49
57520,0,0,5,2,7
57521,0,2,16,24,42
57522,0,3,0,11,14
57523,0,0,4,8,12
57524,1,1,17,31,50
57525,0,1,7,35,43
57526,0,0,8,13,21
57527,0,1,4,11,16
57529,0,0,10,40,50
57530,0,1,7,15,23
57531,0,0,6,12,18
57532,1,0,13,30,44
57533,0,0,5,8,13
57534,0,0,6,10,16
57536,0,0,1,9,10
57537,0,0,9,36,45
57538,0,0,1,5,6
57539,1,0,5,9,15
57540,0,0,2,18,20
57541,2,0,3,18,23
57542,0,0,0,5,5
57543,0,0,1,18,19
57544,0,0,0,5,5
57545,0,1,1,18,20
57546,0,1,8,29,38
57547,0,0,6,19,25
57548,1,1,11,33,46
57549,0,1,4,11,16
57550,0,0,3,24,27
57551,1,3,10,27,41
57552,0,0,4,27,31
57553,0,0,3,27,30
57554,0,0,10,12,22
57555,0,0,1,11,12
57556,0,0,0,6,6
57557,0,0,4,15,19
57558,0,0,9,36,45
57559,0,2,14,32,48
57560,0,3,0,11,14
57561,0,1,3,12,16
57562,0,0,9,36,45
57563,1,0,9,33,43
57564,0,1,7,15,23
57565,0,0,1,4,5
57566,0,0,2,24,26
57568,0,0,16,34,50
57569,0,1,8,29,38
57570,0,0,8,13,21
57571,0,1,1,30,32
57572,1,1,4,23,29
57573,0,0,6,6,12
57574,0,0,0,16,16
57575,0,0,7,9,16
57576,0,0,9,12,21
57577,0,0,1,7,8
57578,0,0,8,31,39
57579,0,1,9,17,27
57580,0,1,0,16,17
57581,0,0,2,7,9
57582,0,0,7,19,26
57583,0,0,2,6,8
57584,0,1,6,12,19
57585,0,0,4,11,15
57586,0,0,0,13,13
57587,0,0,3,6,9
57588,0,2,4,13,19
57589,0,0,5,8,13
57590,0,0,3,4,7
57591,0,2,3,12,17
57592,0,0,2,14,16
57593,0,0,8,14,22
57594,0,0,9,9,18
57595,0,1,4,6,11
57596,0,0,3,1,4
57597,0,2,3,10,15
57598,0,0,8,25,33
57599,0,3,0,2,5
57600,0,1,6,29,36
57601,0,0,3,34,37
57603,0,0,6,4,10
57604,0,0,5,7,12
57605,0,0,9,5,14
57606,0,0,6,14,20
57607,0,0,3,1,4
57608,0,0,3,17,20
57609,0,0,6,6,12
57610,0,0,7,12,19
57612,0,0,6,2,8
57614,0,0,4,1,5
57615,0,6,2,11,19
57616,1,0,9,40,50
57617,0,0,5,1,6
57618,0,0,8,18,26
57619,0,1,3,4,8
57620,0,0,4,16,20
57621,0,0,0,7,7
57622,0,0,10,24,34
57623,0,0,3,5,8
57625,0,0,5,0,5
57626,0,1,5,6,12
57627,0,0,6,23,29
57628,0,0,4,4,8
57629,0,0,7,17,24
57630,0,0,16,27,43
57631,0,0,6,4,10
57632,0,0,8,17,25
57633,0,0,0,2,2
57634,0,1,1,3,5
57635,0,0,5,11,16
57636,0,0,6,10,16
57637,0,0,5,2,7
57638,0,0,7,6,13
57639,0,0,7,5,12
57640,0,0,4,2,6
57641,0,1,5,5,11
57642,0,0,12,15,27
57643,0,0,2,0,2
57644,0,0,8,10,18
57646,0,0,4,5,9
57647,0,0,8,4,12
57648,0,0,2,6,8
57649,1,1,7,9,18
57650,0,0,3,11,14
57651,0,0,10,12,22
57652,0,0,3,5,8
57653,0,0,3,2,5
57654,0,0,2,2,4
57655,0,0,1,5,6
57656,0,0,3,3,6
57657,0,0,3,5,8
57658,0,1,3,41,45
57659,0,1,2,27,30
57660,0,0,0,3,3
57661,1,1,7,41,50
57662,0,0,0,5,5
57663,0,1,8,5,14
57664,0,1,3,12,16
57665,0,0,1,2,3
57666,0,2,2,6,10
57667,0,1,0,4,5
57668,0,0,11,14,25
57669,0,0,2,7,9
57670,0,0,6,10,16
57671,0,2,4,8,14
57672,0,0,1,1,2
57674,0,0,8,6,14
57675,0,0,7,16,23
57676,0,0,4,4,8
57677,0,0,1,0,1
57679,0,0,11,22,33
57680,0,0,5,1,6
57681,0,0,9,10,19
57682,0,1,7,5,13
57683,0,2,2,11,15
57684,0,0,9,10,19
57685,0,0,14,22,36
57686,0,0,8,15,23
57688,0,0,6,5,11
57689,0,0,14,25,39
57690,0,0,6,19,25
57691,0,0,1,16,17
57692,0,0,4,18,22
57693,0,0,12,14,26
57694,0,0,2,2,4
57695,1,0,4,21,26
57696,0,0,5,7,12
57697,1,0,10,30,41
57698,0,0,4,8,12
57702,0,0,7,11,18
57703,0,2,8,15,25
57704,0,0,5,0,5
57705,0,0,7,10,17
57706,0,0,2,0,2
57707,0,0,3,2,5
57708,0,1,4,4,9
57709,3,0,4,39,46
57710,0,0,5,7,12
57711,0,0,4,15,19
57712,1,0,2,2,5
57713,0,0,7,14,21
57714,0,0,0,5,5
57715,0,0,12,11,23
57716,0,2,0,13,15
57719,0,1,2,9,12
57720,0,0,4,3,7
57721,0,0,5,2,7
57722,0,0,5,3,8
57723,0,1,6,8,15
57725,0,0,2,1,3
57727,0,0,8,18,26
57728,0,0,4,13,17
57729,0,0,1,8,9
57730,1,0,7,24,32
57732,0,0,2,4,6
57733,2,0,12,16,30
57734,0,0,5,4,9
57736,0,0,2,6,8
57737,0,0,2,17,19
57738,0,0,7,16,23
57739,0,3,13,34,50
57740,0,1,1,30,32
57741,0,0,1,4,5
57742,0,0,6,6,12
57743,0,0,0,5,5
57745,0,2,7,24,33
57746,0,6,10,26,42
57747,0,0,1,6,7
57748,0,0,1,16,17
57749,0,0,2,13,15
57750,0,0,3,4,7
57751,0,0,5,7,12
57752,0,1,0,5,6
57753,0,0,1,5,6
57754,0,1,9,17,27
57755,0,0,4,12,16
57756,0,0,5,10,15
57757,0,0,4,21,25
57758,0,0,2,17,19
57759,1,1,15,33,50
57760,0,3,13,34,50
57761,0,0,8,5,13
57762,0,2,9,18,29
57763,0,0,14,25,39
57764,0,2,4,17,23
57765,0,0,3,10,13
57766,0,0,1,4,5
57767,0,3,6,41,50
57768,0,1,9,34,44
57769,0,2,14,33,49
57770,0,0,9,6,15
57771,0,0,2,6,8
57772,0,0,10,11,21
57773,0,0,1,4,5
57774,0,0,0,5,5
57775,0,0,7,16,23
57776,0,0,1,15,16
57777,0,0,0,21,21
57778,0,1,9,25,35
57779,0,3,0,14,17
57780,0,2,5,26,33
57781,0,0,7,9,16
57782,0,0,1,17,18
57784,0,3,13,34,50
57785,0,1,9,17,27
57786,0,0,0,16,16
57787,1,0,0,19,20
57788,0,0,0,21,21
57790,0,0,1,17,18
57791,0,0,1,5,6
57792,1,1,15,33,50
57793,0,0,1,17,18
57794,0,0,0,21,21
57795,0,0,0,21,21
57796,0,0,0,21,21
57797,0,3,0,14,17
57798,0,1,1,30,32
57799,0,0,8,15,23
57800,0,1,6,22,29
57801,0,0,2,7,9
57802,0,0,13,28,41
57803,2,0,5,39,46
57804,0,0,6,4,10
57805,0,0,3,28,31
57806,0,0,1,6,7
57807,0,0,9,1,10
57808,0,0,11,33,44
57809,0,0,2,6,8
57810,2,0,1,7,10
57811,0,0,0,13,13
57812,0,0,13,1,14
57813,0,0,11,39,50
57814,0,0,14,14,28
57815,0,0,0,17,17
57816,3,1,3,28,35
57817,0,0,4,2,6
57818,1,0,1,5,7
57819,0,0,8,8,16
57820,0,0,10,10,20
57821,0,1,8,7,16
57822,0,0,3,21,24
57823,0,0,10,21,31
57824,0,2,0,37,39
57825,2,0,9,39,50
57826,0,0,10,20,30
57827,0,0,2,19,21
57828,0,0,1,3,4
57829,0,0,5,27,32
57830,0,0,1,7,8
57833,0,0,10,25,35
57834,0,0,0,2,2
57835,0,0,5,10,15
57836,0,0,2,8,10
57837,0,0,3,10,13
57838,0,0,0,11,11
57839,0,0,2,21,23
57840,0,0,5,3,8
57841,1,0,8,16,25
57842,0,0,6,13,19
57843,0,1,2,21,24
57844,0,0,6,10,16
57845,0,1,6,9,16
57846,1,0,8,33,42
57847,0,0,9,21,30
57848,0,0,7,8,15
57849,0,0,7,2,9
57850,0,0,3,4,7
57851,0,0,2,13,15
57852,0,0,11,17,28
57853,0,0,15,16,31
57854,0,0,6,18,24
57855,0,0,1,7,8
57856,0,0,3,16,19
57857,0,0,6,14,20
57858,0,0,7,10,17
57859,0,0,2,10,12
57860,0,0,5,18,23
57861,0,0,2,16,18
57862,0,0,3,7,10
57863,0,0,7,9,16
57864,0,2,6,24,32
57865,0,0,5,23,28
57866,0,0,6,11,17
57867,0,2,4,13,19
57868,0,0,3,14,17
57869,0,1,0,3,4
57870,0,0,4,7,11
57871,1,2,1,31,35
57872,0,0,13,29,42
57873,0,0,7,5,12
57874,0,0,4,8,12
57875,0,3,9,24,36
57876,0,0,2,7,9
57878,0,0,5,10,15
57880,0,0,5,9,14
57882,0,2,3,15,20
57883,0,0,4,3,7
57884,0,0,6,4,10
57885,0,0,7,40,47
57886,0,0,2,5,7
57887,0,0,6,3,9
57888,0,0,4,3,7
57889,1,0,1,5,7
57890,0,6,3,9,18
57891,0,1,6,8,15
57892,1,0,10,38,49
57893,0,0,1,8,9
57895,1,0,4,4,9
57896,0,0,16,21,37
57897,0,1,3,46,50
57898,0,0,3,4,7
57900,0,0,3,7,10
57901,0,0,11,16,27
57902,0,1,5,8,14
57903,0,0,3,2,5
57905,0,0,0,7,7
57906,0,0,13,34,47
57907,0,0,1,8,9
57909,1,0,1,0,2
57910,0,1,2,9,12
57912,0,0,0,9,9
57913,0,0,1,8,9
57914,0,0,6,2,8
57915,3,0,2,5,10
57916,0,2,5,15,22
57917,0,0,3,7,10
57918,0,1,5,9,15
57919,0,0,1,7,8
57920,0,0,0,7,7
57922,0,0,0,5,5
57923,0,0,2,18,20
57924,0,0,1,3,4
57925,0,0,8,15,23
57926,1,0,0,7,8
57927,0,0,3,7,10
57928,1,2,10,18,31
57929,1,0,1,21,23
57930,0,0,13,26,39
57931,1,0,0,7,8
57932,2,1,5,22,30
57933,1,1,4,13,19
57936,0,0,0,8,8
57937,1,0,9,27,37
57938,0,0,7,16,23
57939,1,1,14,34,50
57940,0,0,9,17,26
57942,0,1,9,17,27
57943,0,0,3,19,22
57944,0,0,1,4,5
57945,0,0,2,7,9
57946,0,0,7,14,21
57947,0,0,8,13,21
57948,0,1,10,20,31
57949,0,0,6,16,22
57950,0,1,7,20,28
57951,0,0,3,27,30
57952,0,0,5,13,18
57953,0,1,2,19,22
57954,0,1,0,11,12
57955,0,1,6,10,17
57956,0,0,13,25,38
57957,1,2,5,32,40
57958,0,0,1,2,3
57959,2,1,2,10,15
57960,0,0,9,34,43
57961,0,0,0,7,7
57962,0,0,6,16,22
57963,0,0,1,7,8
57964,0,0,12,19,31
57965,0,0,2,4,6
57966,1,1,3,9,14
57969,0,0,9,16,25
57970,1,0,1,25,27
57971,2,1,2,13,18
57972,0,0,1,10,11
57973,0,0,0,5,5
57974,0,0,1,9,10
57975,0,0,0,8,8
57976,0,0,1,3,4
57978,0,0,5,27,32
57979,0,0,2,18,20
57980,0,0,8,15,23
57981,1,0,9,33,43
57982,0,0,11,39,50
57983,0,0,5,23,28
57984,0,0,0,2,2
57985,0,0,6,4,10
57986,1,0,1,5,7
57987,1,0,1,21,23
57988,1,1,3,35,40
57989,1,0,10,38,49
57990,0,2,5,15,22
57991,1,0,0,7,8
57993,0,0,4,3,7
57994,1,0,0,7,8
57995,0,0,5,35,40
57996,0,0,2,3,5
57997,1,1,15,26,43
57998,0,0,3,19,22
57999,0,0,0,5,5
58000,0,0,1,3,4
58001,1,0,17,29,47
58002,1,1,6,20,28
58003,1,1,2,18,22
58004,0,1,0,11,12
58005,0,0,1,8,9
58006,1,0,0,7,8
58007,1,1,3,35,40
58008,0,0,6,16,22
58009,1,0,9,33,43
58010,0,0,0,7,7
58011,0,0,5,23,28
58012,0,0,2,7,9
58013,0,0,7,14,21
58014,0,0,6,16,22
58015,1,1,3,35,40
58016,0,0,0,2,2
58017,0,1,10,37,48
58018,0,0,1,14,15
58019,1,0,16,33,50
58020,4,1,7,38,50
58021,0,1,17,32,50
58022,0,1,4,5,10
58023,0,0,15,22,37
58024,0,2,4,22,28
58025,0,1,13,30,44
58026,1,1,8,36,46
58027,0,0,2,8,10
58029,0,0,1,17,18
58030,0,0,8,18,26
58031,0,0,6,25,31
58032,0,0,10,25,35
58034,0,0,10,14,24
58035,2,0,1,10,13
58036,1,0,0,12,13
58037,0,1,2,34,37
58038,0,0,2,42,44
58039,0,4,18,28,50
58040,0,2,7,34,43
58041,1,0,8,26,35
58042,0,0,10,18,28
58043,0,0,7,13,20
58044,0,0,2,8,10
58045,0,0,2,13,15
58046,0,0,9,7,16
58048,0,0,5,15,20
58049,0,0,4,10,14
58050,0,0,3,7,10
58051,0,0,8,14,22
58052,0,0,1,18,19
58053,0,0,5,12,17
58054,0,0,3,12,15
58055,0,0,10,18,28
58056,0,0,1,31,32
58057,1,1,11,37,50
58058,0,0,15,25,40
58059,0,0,4,16,20
58060,1,1,16,27,45
58061,0,0,2,15,17
58063,0,0,1,14,15
58064,0,0,19,25,44
58065,1,1,5,18,25
58066,0,1,1,16,18
58067,0,0,6,14,20
58068,1,1,5,11,18
58070,1,0,12,29,42
58071,5,1,3,38,47
58072,0,1,4,23,28
58073,0,0,5,10,15
58074,0,0,4,22,26
58075,0,0,6,2,8
58076,0,0,11,21,32
58077,0,0,10,40,50
58078,0,0,8,12,20
58079,1,0,9,18,28
58080,0,1,3,22,26
58081,1,0,17,31,49
58082,1,0,0,26,27
58083,0,0,4,8,12
58085,0,0,1,8,9
58087,0,1,0,11,12
58088,0,1,5,17,23
58089,0,0,10,15,25
58090,1,0,3,4,8
58092,1,0,6,25,32
58093,0,0,11,24,35
58094,0,0,0,2,2
58095,0,0,0,10,10
58096,0,0,3,9,12
58097,0,0,10,26,36
58098,0,0,8,16,24
58099,0,0,10,15,25
58100,0,0,7,9,16
58101,0,0,1,14,15
58102,1,0,7,11,19
58103,4,0,3,19,26
58104,0,1,3,24,28
58105,2,0,8,14,24
58106,0,0,5,5,10
58107,1,1,12,36,50
58108,0,0,2,18,20
58109,0,0,3,10,13
58110,0,0,12,35,47
58111,1,1,6,23,31
58112,0,0,5,3,8
58113,1,0,5,17,23
58114,1,0,4,9,14
58115,3,0,1,12,16
58116,0,1,1,14,16
58118,1,0,0,4,5
58119,0,0,2,18,20
58120,2,0,8,10,20
58121,0,0,11,35,46
58122,0,0,1,11,12
58123,0,0,8,8,16
58124,0,0,5,23,28
58125,0,0,6,25,31
58126,0,1,7,12,20
58127,0,1,2,23,26
58128,0,1,5,11,17
58129,0,0,2,15,17
58130,2,1,1,11,15
58131,0,0,10,35,45
58132,0,0,15,31,46
58133,0,0,5,11,16
58134,0,0,6,6,12
58135,1,0,0,2,3
58136,2,0,3,24,29
58137,0,0,3,18,21
58139,1,0,0,14,15
58140,1,0,9,30,40
58141,0,0,2,47,49
58142,0,0,9,15,24
58143,1,0,4,22,27
58144,0,1,7,21,29
58145,0,0,1,7,8
58146,2,0,1,34,37
58149,0,0,4,3,7
58150,2,0,1,7,10
58152,0,1,6,28,35
58154,0,0,9,12,21
58155,5,0,4,16,25
58158,0,1,3,15,19
58159,1,1,4,41,47
58160,1,1,10,34,46
58161,0,2,11,36,49
58162,0,0,0,6,6
58163,0,0,5,16,21
58164,0,0,1,8,9
58165,0,0,3,17,20
58166,0,1,2,25,28
58167,0,0,13,27,40
58168,1,0,7,42,50
58169,1,2,5,42,50
58170,0,0,9,8,17
58171,0,1,6,33,40
58172,0,0,19,31,50
58173,0,0,2,6,8
58175,0,1,7,12,20
58176,0,0,6,15,21
58177,0,1,10,29,40
58178,1,1,10,24,36
58179,1,3,10,29,43
58180,0,1,4,33,38
58181,0,1,3,44,48
58182,0,1,3,18,22
58183,0,3,1,16,20
58184,0,0,1,14,15
58185,0,0,2,8,10
58186,0,0,1,3,4
58188,2,0,4,20,26
58189,0,0,3,9,12
58190,4,0,6,40,50
58192,1,0,0,26,27
58193,0,1,3,22,26
58194,1,0,3,26,30
58195,0,0,0,2,2
58197,0,0,7,9,16
58198,2,1,3,30,36
58199,1,0,4,20,25
58200,0,0,1,20,21
58201,2,0,12,34,48
58202,1,0,9,19,29
58203,0,1,1,48,50
58204,2,1,2,25,30
58205,2,2,1,45,50
58207,0,0,3,7,10
58208,0,1,0,10,11
58209,5,0,3,18,26
58210,5,1,7,37,50
58211,1,1,12,36,50
58212,0,0,9,37,46
58213,2,0,11,30,43
58214,0,0,11,25,36
58215,1,0,3,16,20
58216,0,0,8,8,16
58219,0,0,2,6,8
58220,0,0,2,11,13
58221,0,0,6,19,25
58222,1,1,2,7,11
58223,0,0,2,5,7
58224,3,0,2,14,19
58225,0,1,0,3,4
58227,0,0,1,8,9
58229,0,2,0,11,13
58230,0,0,0,5,5
58231,0,0,2,6,8
58232,0,0,1,7,8
58233,0,1,6,33,40
58234,0,1,1,11,13
58235,0,0,2,6,8
58237,1,0,11,22,34
58238,0,0,1,7,8
58239,0,2,4,30,36
58240,0,0,9,11,20
58241,0,1,3,9,13
58242,0,3,2,8,13
58243,0,0,11,10,21
58244,0,2,4,22,28
58245,0,0,5,9,14
58246,0,1,9,8,18
58247,0,0,4,8,12
58248,0,0,2,5,7
58249,0,0,4,8,12
58250,3,0,3,23,29
58251,0,0,5,13,18
58252,1,0,1,9,11
58253,1,1,3,23,28
58254,0,1,11,19,31
58255,0,0,2,8,10
58256,0,0,1,4,5
58257,0,0,3,8,11
58258,1,0,2,6,9
58259,0,1,6,13,20
58260,0,1,10,12,23
58261,0,0,5,3,8
58262,0,0,8,11,19
58263,0,0,2,16,18
58264,0,0,6,13,19
58265,0,0,6,7,13
58266,0,0,5,10,15
58267,0,0,1,4,5
58268,0,0,2,4,6
58269,0,0,8,12,20
58270,0,0,6,16,22
58271,0,0,7,20,27
58272,0,0,2,3,5
58273,1,1,14,29,45
58274,0,0,12,9,21
58275,0,1,1,10,12
58276,0,0,2,3,5
58277,0,0,3,11,14
58278,0,0,12,26,38
58279,0,0,1,4,5
58280,0,0,7,23,30
58281,0,4,13,33,50
58282,0,0,0,15,15
58283,0,0,14,35,49
58284,0,0,14,33,47
58285,0,1,10,28,39
58286,0,0,0,1,1
58287,0,0,12,5,17
58288,1,0,1,9,11
58289,0,1,10,28,39
58290,1,4,6,28,39
58291,0,0,14,33,47
58292,0,0,5,3,8
58293,0,0,0,11,11
58294,0,0,10,15,25
58295,0,1,4,16,21
58296,0,0,18,32,50
58297,0,0,2,6,8
58298,0,0,7,3,10
58299,0,0,1,16,17
58300,0,0,6,16,22
58301,0,0,7,11,18
58302,3,0,3,23,29
58303,0,0,4,12,16
58304,1,0,1,4,6
58305,0,0,7,6,13
58306,0,1,0,11,12
58307,0,0,6,15,21
58308,0,0,2,3,5
58309,0,1,3,5,9
58310,0,0,9,16,25
58311,0,0,2,19,21
58312,0,0,1,7,8
58313,0,0,1,6,7
58314,0,0,8,5,13
58315,0,1,6,7,14
58316,0,1,1,6,8
58317,0,0,6,24,30
58318,0,0,7,25,32
58319,0,0,1,5,6
58320,0,0,3,2,5
58321,0,0,4,15,19
58322,0,1,3,18,22
58325,0,0,1,4,5
58326,5,1,5,39,50
58327,0,0,0,1,1
58328,0,0,3,6,9
58329,0,1,13,29,43
58330,0,0,3,6,9
58331,0,0,9,13,22
58332,0,0,3,4,7
58333,0,0,13,37,50
58334,0,0,7,13,20
58335,0,0,6,25,31
58336,1,1,6,30,38
58337,0,0,10,13,23
58338,0,0,2,4,6
58340,0,0,1,4,5
58341,0,0,4,4,8
58342,0,0,5,4,9
58343,0,0,2,12,14
58344,0,0,4,10,14
58346,1,1,18,30,50
58348,0,0,3,13,16
58349,0,0,14,14,28
58350,0,0,2,10,12
58351,0,2,1,19,22
58352,0,0,2,10,12
58353,1,0,2,17,20
58354,0,0,4,5,9
58355,0,0,3,8,11
58357,0,0,3,8,11
58358,0,0,4,3,7
58359,0,0,0,3,3
58360,0,0,4,7,11
58361,0,0,23,26,49
58362,0,0,4,13,17
58363,0,0,1,1,2
58364,0,2,7,11,20
58365,1,3,19,27,50
58366,1,0,14,19,34
58367,0,0,5,3,8
58368,1,0,13,36,50
58369,0,0,9,13,22
58370,2,1,3,24,30
58371,1,0,9,11,21
58372,1,1,0,9,11
58373,0,0,4,8,12
58374,0,0,13,15,28
58375,0,0,2,17,19
58376,0,0,11,16,27
58377,1,1,4,44,50
58378,0,0,3,5,8
58379,1,0,0,2,3
58380,0,0,3,11,14
58382,0,0,2,6,8
58383,0,3,14,33,50
58384,7,1,3,20,31
58385,0,0,7,32,39
58386,0,0,8,35,43
58387,0,0,3,12,15
58388,1,0,13,36,50
58389,0,1,8,28,37
58390,1,0,13,36,50
58391,0,2,9,11,22
58392,0,0,5,20,25
58393,0,0,8,10,18
58394,0,0,5,5,10
58395,0,0,6,17,23
58396,3,1,9,27,40
58397,0,0,1,24,25
58399,0,1,8,41,50
58400,0,0,7,24,31
58401,0,0,9,22,31
58402,0,0,2,4,6
58403,0,0,7,4,11
58404,0,0,10,32,42
58405,0,1,9,12,22
58406,0,0,15,20,35
58407,0,0,3,6,9
58408,0,0,11,13,24
58409,0,0,0,8,8
58410,0,0,6,16,22
58411,0,1,4,1,6
58412,0,1,11,36,48
58413,0,0,1,12,13
58414,0,0,1,6,7
58415,0,0,0,7,7
58416,0,0,5,14,19
58417,0,0,6,20,26
58418,0,0,17,32,49
58419,0,0,1,16,17
58420,0,0,3,12,15
58421,0,0,4,3,7
58422,0,0,11,34,45
58423,0,1,9,12,22
58424,0,0,4,4,8
58425,0,0,5,11,16
58426,0,3,12,23,38
58427,0,0,0,26,26
58428,0,0,14,13,27
58429,0,0,8,17,25
58430,0,1,3,19,23
58431,0,0,5,9,14
58432,0,0,1,11,12
58433,0,0,4,7,11
58434,0,2,0,3,5
58435,0,0,12,24,36
58436,0,0,2,3,5
58437,0,0,14,35,49
58438,0,2,12,17,31
58439,0,0,9,8,17
58440,1,0,3,23,27
58441,0,0,8,29,37
58442,0,0,4,4,8
58443,0,0,8,15,23
58444,0,0,9,10,19
58445,0,0,0,8,8
58446,0,0,2,10,12
58447,0,1,11,38,50
58448,1,2,25,22,50
58449,0,0,2,4,6
58450,2,5,6,37,50
58451,0,1,11,10,22
58452,0,1,12,30,43
58453,0,0,3,4,7
58454,0,0,11,15,26
58456,0,0,11,30,41
58457,0,0,4,11,15
58458,0,0,14,27,41
58459,0,1,2,9,12
58460,0,0,2,4,6
58461,0,0,4,21,25
58462,0,0,13,18,31
58463,0,0,3,12,15
58464,0,0,5,17,22
58466,0,0,3,6,9
58467,0,0,5,7,12
58468,0,0,10,10,20
58469,0,0,5,5,10
58470,0,0,4,8,12
58471,0,0,0,4,4
58472,0,0,15,19,34
58473,0,0,9,7,16
58475,0,0,1,12,13
58476,1,0,6,17,24
58478,0,1,7,17,25
58479,0,0,8,10,18
58480,0,0,1,8,9
58481,0,1,4,9,14
58483,0,0,6,10,16
58485,0,0,5,16,21
58487,0,4,0,12,16
58488,0,1,13,35,49
58489,0,0,4,20,24
58490,0,2,2,8,12
58491,0,0,12,10,22
58493,0,0,4,12,16
58494,0,0,4,5,9
58495,0,0,13,37,50
58496,1,2,7,13,23
58497,1,0,6,21,28
58498,0,0,3,29,32
58499,0,1,5,27,33
58500,0,0,8,14,22
58501,0,0,4,28,32
58502,0,0,4,9,13
58503,1,0,5,12,18
58504,0,0,16,31,47
58505,1,4,9,20,34
58506,0,0,6,4,10
58507,0,0,10,11,21
58508,0,0,8,10,18
58509,0,0,2,3,5
58510,0,1,10,18,29
58511,0,0,5,26,31
58512,0,0,14,34,48
58513,0,0,6,8,14
58514,0,0,17,32,49
58515,0,1,13,35,49
58516,0,2,17,31,50
58517,0,0,14,13,27
58518,0,0,1,16,17
58519,0,0,9,21,30
58520,0,0,6,14,20
58521,2,0,1,4,7
58522,0,0,12,14,26
58524,0,0,15,18,33
58525,0,0,9,7,16
58526,0,0,13,32,45
58527,0,0,8,14,22
58528,0,0,19,31,50
58529,0,0,8,17,25
58530,2,0,13,35,50
58531,0,0,5,31,36
58532,0,0,5,9,14
58533,0,1,10,31,42
58534,1,1,16,31,49
58535,0,0,3,23,26
58536,0,0,1,7,8
58537,0,0,6,41,47
58538,0,0,8,20,28
58539,0,0,8,17,25
58540,0,0,3,6,9
58541,0,0,1,9,10
58542,0,1,2,11,14
58543,0,0,11,24,35
58544,0,1,16,33,50
58545,0,0,1,10,11
58546,0,0,5,14,19
58547,2,0,0,23,25
58548,0,0,4,11,15
58549,0,0,14,22,36
58550,0,1,11,38,50
58551,0,0,9,13,22
58552,0,4,0,12,16
58553,0,1,4,9,14
58554,0,0,3,29,32
58555,1,0,6,17,24
58556,0,1,2,11,14
58557,1,0,5,12,18
58558,0,0,1,16,17
58559,1,0,6,21,28
58560,0,1,5,27,33
58561,0,0,8,10,18
58562,0,0,4,28,32
58563,0,0,18,27,45
58564,0,1,13,35,49
58565,0,0,1,12,13
58566,0,0,3,29,32
58567,0,1,16,33,50
58568,0,2,2,8,12
58569,0,0,1,4,5
58570,0,1,9,27,37
58571,0,0,7,1,8
58572,6,0,2,21,29
58573,0,1,4,8,13
58574,0,0,3,2,5
58575,0,0,5,11,16
58576,0,0,1,12,13
58577,0,0,4,16,20
58578,0,3,4,25,32
58579,0,1,4,18,23
58580,0,0,13,12,25
58581,0,1,8,16,25
58582,0,0,8,22,30
58583,0,1,10,39,50
58584,0,1,6,18,25
58585,1,0,4,10,15
58586,0,0,5,13,18
58587,0,0,15,22,37
58588,0,0,2,15,17
58589,0,0,8,11,19
58590,0,0,2,9,11
58591,0,0,4,33,37
58592,0,0,7,11,18
58593,0,0,8,14,22
58594,0,4,13,32,49
58595,0,2,0,10,12
58596,0,0,15,22,37
58597,0,1,2,2,5
58598,2,1,6,11,20
58599,0,0,5,8,13
58600,0,0,10,22,32
58601,0,0,1,10,11
58602,0,0,13,12,25
58603,0,0,4,5,9
58604,0,0,1,9,10
58605,0,0,10,11,21
58606,0,0,8,40,48
58607,0,0,1,8,9
58608,0,1,7,24,32
58610,0,0,2,2,4
58611,0,1,4,8,13
58612,0,2,2,31,35
58613,0,0,3,9,12
58614,0,0,8,19,27
58615,0,0,4,6,10
58616,0,1,4,28,33
58617,0,1,9,13,23
58618,0,1,4,17,22
58619,2,0,7,23,32
58621,0,0,12,36,48
58622,0,0,11,10,21
58623,1,0,9,17,27
58624,0,0,4,10,14
58625,0,0,9,29,38
58626,1,0,10,30,41
58627,0,0,8,11,19
58628,0,0,1,3,4
58629,1,0,20,25,46
58630,0,2,3,11,16
58632,0,0,5,13,18
58633,0,0,2,17,19
58634,0,0,0,10,10
58636,0,1,11,38,50
58637,0,1,0,6,7
58639,0,0,5,22,27
58640,0,2,2,4,8
58641,0,0,2,4,6
58642,0,0,6,6,12
58643,0,0,2,3,5
58644,0,0,2,5,7
58645,0,0,9,31,40
58646,0,0,3,9,12
58647,0,0,3,8,11
58648,0,0,4,9,13
58649,0,1,0,4,5
58650,0,0,4,13,17
58651,0,0,5,10,15
58652,0,0,2,4,6
58653,0,0,4,6,10
58654,0,0,6,6,12
58655,0,0,9,5,14
58656,0,2,5,16,23
58657,1,0,4,8,13
58658,0,0,5,6,11
58659,0,0,2,12,14
58660,0,1,13,20,34
58661,0,0,1,10,11
58662,2,1,5,24,32
58663,0,0,4,2,6
58664,1,1,11,22,35
58665,0,1,7,13,21
58666,0,3,5,26,34
58667,1,1,10,20,32
58668,0,0,3,5,8
58669,0,0,9,9,18
58670,0,0,5,9,14
58671,0,0,3,0,3
58673,0,0,7,13,20
58674,1,0,5,16,22
58675,0,1,11,28,40
58676,0,1,3,15,19
58677,1,0,2,13,16
58678,1,0,7,17,25
58679,0,0,4,15,19
58680,0,2,4,23,29
58681,0,1,8,17,26
58682,0,1,2,9,12
58683,0,0,9,15,24
58684,0,0,11,15,26
58685,0,0,7,3,10
58686,0,0,2,9,11
58687,0,0,3,10,13
58688,0,2,7,30,39
58689,2,0,15,33,50
58690,0,2,8,39,49
58691,0,0,4,10,14
58692,2,1,8,21,32
58693,0,0,0,15,15
58694,0,0,4,8,12
58695,0,1,3,3,7
58696,0,0,8,3,11
58697,0,0,2,7,9
58698,0,0,3,18,21
58699,0,0,4,9,13
58700,2,0,1,18,21
58701,0,3,10,28,41
58702,0,0,9,12,21
58703,0,0,6,14,20
58704,0,3,10,24,37
58705,1,0,5,40,46
58706,0,1,4,17,22
58707,0,0,9,12,21
58708,0,1,16,25,42
58709,1,1,7,15,24
58710,0,0,9,8,17
58711,0,0,8,19,27
58712,0,0,4,10,14
58713,0,0,3,4,7
58714,0,1,5,17,23
58716,0,0,4,20,24
58717,0,0,5,12,17
58718,1,1,6,9,17
58719,0,0,6,20,26
58720,0,0,1,9,10
58721,0,0,10,14,24
58722,0,0,6,20,26
58723,0,1,4,3,8
58724,0,0,3,4,7
58725,0,1,8,12,21
58726,1,1,5,19,26
58727,0,0,7,10,17
58728,1,0,0,13,14
58730,0,0,11,20,31
58731,0,0,14,36,50
58734,0,0,7,21,28
58735,1,0,5,9,15
58736,0,0,7,14,21
58737,1,0,5,20,26
58738,0,0,6,17,23
58739,0,0,0,3,3
58740,0,0,3,6,9
58741,0,0,2,3,5
58742,0,1,3,14,18
58743,1,0,0,6,7
58744,0,1,4,14,19
58745,0,0,5,21,26
58746,0,0,8,6,14
58747,1,0,7,4,12
58749,0,0,2,4,6
58750,0,0,5,3,8
58751,0,2,7,9,18
58752,0,0,1,11,12
58753,0,0,7,1,8
58754,1,1,13,26,41
58755,2,4,7,37,50
58756,0,0,8,8,16
58757,0,0,3,9,12
58758,1,2,12,14,29
58759,0,0,6,14,20
58760,0,1,5,18,24
58761,0,0,4,7,11
58762,0,0,4,4,8
58763,0,0,9,14,23
58764,0,0,1,1,2
58765,0,0,5,2,7
58766,0,2,15,22,39
58767,0,0,4,12,16
58769,0,0,6,6,12
58770,0,1,14,25,40
58771,0,1,17,29,47
58772,0,0,7,15,22
58773,0,0,1,5,6
58774,0,0,11,6,17
58775,0,0,6,21,27
58776,0,2,11,37,50
58777,0,0,10,19,29
58778,0,0,2,18,20
58779,0,0,4,7,11
58780,0,1,10,7,18
58781,0,1,3,9,13
58782,0,0,9,16,25
58783,0,0,9,1,10
58784,2,0,1,7,10
58785,0,0,9,17,26
58786,0,0,8,19,27
58787,0,0,12,14,26
58788,0,0,8,15,23
58789,0,0,2,13,15
58790,0,0,6,5,11
58791,0,0,8,4,12
58792,0,0,3,10,13
58794,0,0,7,14,21
58795,0,0,3,3,6
58796,0,0,8,24,32
58797,0,0,9,30,39
58798,0,0,2,1,3
58799,0,0,6,14,20
58800,0,1,9,27,37
58801,0,1,9,16,26
58802,0,0,10,25,35
58803,0,0,10,5,15
58804,1,0,3,7,11
58805,0,0,4,6,10
58806,0,0,6,17,23
58807,2,1,1,9,13
58808,0,0,8,6,14
58809,0,0,0,2,2
58810,0,1,4,7,12
58811,0,3,5,16,24
58812,0,0,12,11,23
58813,0,0,5,12,17
58814,0,0,11,24,35
58815,0,0,3,7,10
58816,0,5,7,13,25
58817,0,1,6,7,14
58818,0,0,4,16,20
58819,0,0,1,4,5
58820,0,0,1,9,10
58822,1,0,4,17,22
58824,0,0,0,5,5
58825,0,3,3,20,26
58826,0,7,4,39,50
58827,1,3,19,27,50
58828,0,0,5,15,20
58829,0,0,5,8,13
58831,0,2,7,11,20
58832,0,0,11,38,49
58833,6,0,2,21,29
58834,2,4,4,10,20
58835,0,0,0,6,6
58836,3,0,0,6,9
58837,2,0,0,11,13
58838,2,0,5,5,12
58839,0,0,9,13,22
58840,0,0,1,4,5
58841,1,0,4,22,27
58842,1,2,9,29,41
58843,0,0,4,26,30
58844,0,0,10,25,35
58845,0,1,4,12,17
58846,0,1,10,33,44
58847,0,1,10,39,50
58848,0,0,22,27,49
58849,0,0,5,15,20
58850,0,1,4,18,23
58851,0,0,10,30,40
58852,0,2,5,18,25
58853,0,1,7,8,16
58854,0,0,5,12,17
58855,0,1,7,9,17
58856,0,2,1,10,13
58857,0,1,9,13,23
58858,0,0,7,7,14
58859,0,0,7,11,18
58860,0,0,2,6,8
58861,0,1,6,15,22
58862,0,0,15,22,37
58863,1,0,6,23,30
58864,0,0,1,10,11
58865,0,0,6,8,14
58866,0,0,10,33,43
58867,0,0,11,38,49
58868,0,0,4,11,15
58869,0,0,5,26,31
58870,0,1,11,21,33
58871,0,0,6,8,14
58872,0,0,7,7,14
58873,0,0,8,7,15
58874,0,0,12,20,32
58875,0,0,0,5,5
58876,0,1,9,6,16
58877,0,0,15,34,49
58878,0,0,7,8,15
58879,2,1,4,13,20
58880,0,1,9,34,44
58881,0,0,7,12,19
58882,0,0,2,42,44
58883,0,0,20,29,49
58884,0,0,1,5,6
58885,0,0,8,33,41
58886,0,0,7,20,27
58887,0,0,4,4,8
58888,0,0,6,31,37
58889,0,0,3,6,9
58890,0,1,10,21,32
58891,0,1,9,27,37
58893,0,0,6,11,17
58894,0,0,6,6,12
58896,0,0,6,7,13
58897,0,0,5,16,21
58898,0,0,5,8,13
58899,0,0,8,7,15
58900,0,0,3,8,11
58901,1,0,9,32,42
58902,0,1,6,43,50
58903,0,1,11,22,34
58904,0,0,13,37,50
58905,0,0,10,16,26
58906,0,3,8,15,26
58907,1,0,9,22,32
58908,1,3,19,27,50
58909,0,1,1,6,8
58910,0,1,6,15,22
58911,0,2,7,5,14
58912,0,0,8,27,35
58913,0,0,14,33,47
58914,1,0,6,6,13
58915,0,2,7,11,20
58916,0,8,2,17,27
58917,0,0,2,4,6
58918,0,0,4,8,12
58919,0,0,8,25,33
58920,0,0,1,6,7
58921,0,0,7,43,50
58922,0,0,5,10,15
58923,0,3,7,24,34
58924,0,1,8,20,29
58925,2,0,5,17,24
58926,0,0,13,24,37
58927,0,1,11,32,44
58928,0,0,11,26,37
58929,0,0,8,11,19
58930,0,0,5,5,10
58931,0,0,11,25,36
58932,0,0,9,11,20
58933,0,0,10,23,33
58934,0,1,0,11,12
58935,1,1,9,17,28
58936,0,0,4,14,18
58937,0,0,4,10,14
58938,0,0,9,5,14
58939,0,0,5,10,15
58941,0,0,8,22,30
58942,0,2,16,32,50
58943,0,0,14,23,37
58944,0,0,9,18,27
58945,0,0,15,22,37
58946,0,0,4,5,9
58947,0,0,10,33,43
58948,0,1,0,9,10
58951,1,2,10,37,50
58952,1,0,0,5,6
58953,0,0,9,17,26
58954,1,0,4,15,20
58955,0,1,11,27,39
58956,0,0,3,7,10
58957,0,0,6,22,28
58958,0,0,6,13,19
58959,1,3,1,20,25
58960,0,1,3,19,23
58961,0,0,1,4,5
58962,0,0,4,4,8
58963,0,0,8,7,15
58964,0,0,0,8,8
58965,0,0,9,16,25
58966,2,0,5,5,12
58967,0,0,11,16,27
58968,0,0,2,3,5
58969,0,0,5,31,36
58970,0,0,7,10,17
58971,0,0,4,4,8
58972,0,1,8,23,32
58973,0,0,4,16,20
58974,1,0,20,25,46
58975,1,0,13,20,34
58977,0,3,3,20,26
58978,0,7,4,39,50
58979,0,0,6,23,29
58980,0,0,3,0,3
58981,0,0,8,19,27
58982,2,4,7,37,50
58983,0,0,4,3,7
58984,0,0,1,4,5
58985,3,0,0,6,9
58986,0,0,9,13,22
58987,0,0,5,1,6
58988,0,0,6,15,21
58989,0,1,5,19,25
58990,0,0,3,47,50
58991,0,2,5,18,25
58992,0,0,4,16,20
58993,0,0,10,36,46
58994,0,0,4,11,15
58995,1,0,9,32,42
58996,0,1,7,9,17
58997,1,0,2,9,12
58998,0,0,1,4,5
58999,0,3,3,20,26
59000,2,4,4,10,20
59001,0,0,13,37,50
59002,0,0,8,19,27
59003,0,0,1,24,25
59004,0,0,4,14,18
59007,0,1,1,48,50
59008,0,0,11,24,35
59009,0,0,1,12,13
59010,0,0,4,6,10
59011,0,1,4,12,17
59012,0,0,8,27,35
59013,0,0,6,6,12
59014,1,1,4,14,20
59015,0,7,4,39,50
59016,6,0,2,21,29
59017,0,0,3,6,9
59018,0,0,15,22,37
59019,0,0,5,15,20
59020,0,2,10,27,39
59023,1,1,8,40,50
59024,0,0,10,13,23
59025,0,0,0,5,5
59026,0,0,4,10,14
59027,0,0,2,13,15
59028,0,0,4,16,20
59029,0,6,6,35,47
59032,0,0,4,16,20
59033,0,0,3,11,14
59034,0,0,8,10,18
59035,0,0,8,20,28
59036,0,0,0,12,12
59037,0,0,1,4,5
59038,0,0,10,7,17
59039,0,0,8,6,14
59040,0,1,5,26,32
59041,0,0,6,6,12
59042,0,0,8,9,17
59043,0,0,3,3,6
59044,0,1,14,30,45
59045,0,0,3,21,24
59046,0,0,0,14,14
59047,0,3,3,8,14
59048,0,0,4,7,11
59049,0,0,7,9,16
59050,0,0,2,31,33
59051,0,1,12,37,50
59052,0,0,1,16,17
59053,0,0,9,6,15
59054,0,0,3,4,7
59055,0,0,2,7,9
59056,0,0,7,11,18
59057,0,0,4,1,5
59058,0,0,5,11,16
59059,0,2,10,27,39
59060,0,0,7,6,13
59061,0,0,7,12,19
59062,0,0,7,8,15
59064,0,0,3,14,17
59065,0,0,12,8,20
59066,0,0,6,2,8
59067,0,1,11,19,31
59068,0,1,17,30,48
59070,1,1,8,40,50
59071,0,0,10,16,26
59072,0,0,4,25,29
59073,0,0,4,28,32
59074,0,0,8,23,31
59075,0,0,12,28,40
59076,0,0,6,26,32
59077,0,0,6,12,18
59078,1,1,6,10,18
59080,1,0,9,25,35
59084,1,0,5,43,49
59085,0,1,4,9,14
59086,0,0,2,3,5
59087,0,0,9,14,23
59088,0,1,3,26,30
59089,0,1,5,11,17
59090,0,2,4,17,23
59091,0,2,10,38,50
59092,0,1,0,4,5
59093,0,2,8,28,38
59094,0,1,3,25,29
59095,0,1,7,37,45
59096,0,0,1,6,7
59097,0,1,4,17,22
59098,1,3,13,31,48
59099,1,0,9,25,35
59100,0,0,15,34,49
59101,0,2,6,39,47
59102,0,0,0,5,5
59103,0,0,12,35,47
59104,0,0,5,21,26
59105,0,0,2,5,7
59106,0,0,8,12,20
59107,0,0,3,3,6
59108,0,1,10,9,20
59109,0,1,2,19,22
59110,1,3,9,37,50
59112,0,0,8,22,30
59113,0,1,9,33,43
59114,0,0,6,8,14
59115,0,0,8,23,31
59116,0,0,8,9,17
59117,0,0,5,2,7
59118,0,0,17,17,34
59119,1,1,13,35,50
59120,0,0,16,17,33
59121,1,2,2,14,19
59122,1,1,6,10,18
59123,0,0,0,5,5
59124,0,0,0,5,5
59125,0,1,2,19,22
59127,1,0,1,2,4
59128,0,0,3,18,21
59129,0,0,6,26,32
59130,1,0,5,43,49
59131,0,0,1,12,13
59132,0,1,1,18,20
59133,0,1,4,9,14
59134,0,0,5,45,50
59135,0,2,8,28,38
59136,1,1,13,35,50
59137,0,0,2,7,9
59139,0,0,2,17,19
59140,1,2,2,14,19
59141,0,0,1,49,50
59142,0,0,1,4,5
59143,0,1,3,25,29
59144,1,0,5,43,49
59145,2,0,5,43,50
59146,1,4,1,27,33
59148,0,0,8,13,21
59149,0,1,9,13,23
59150,0,0,3,1,4
59151,0,0,9,21,30
59152,0,1,13,36,50
59153,0,0,11,24,35
59154,0,0,4,18,22
59155,0,0,16,33,49
59156,0,0,6,24,30
59157,0,0,3,11,14
59158,0,0,1,19,20
59160,0,0,10,21,31
59161,0,0,14,16,30
59162,1,0,8,28,37
59163,0,0,0,8,8
59164,0,0,1,8,9
59165,0,0,4,2,6
59166,0,0,1,11,12
59167,0,1,10,23,34
59168,0,0,0,6,6
59169,0,0,6,12,18
59170,0,0,0,5,5
59171,0,0,1,7,8
59172,0,0,11,28,39
59173,0,0,15,28,43
59174,0,0,2,21,23
59175,0,2,18,30,50
59176,0,1,2,18,21
59177,0,1,5,11,17
59178,0,0,2,15,17
59179,1,1,1,25,28
59180,1,2,2,25,30
59182,0,0,9,28,37
59183,0,0,10,8,18
59184,0,0,7,14,21
59185,0,1,7,7,15
59186,0,1,5,10,16
59187,0,0,11,34,45
59189,0,1,3,10,14
59190,0,0,2,10,12
59191,0,0,6,20,26
59192,0,0,4,14,18
59193,0,0,3,7,10
59194,0,0,6,6,12
59195,0,0,9,24,33
59196,1,0,9,25,35
59197,0,1,2,18,21
59198,1,0,0,9,10
59199,0,3,4,25,32
59200,0,1,9,17,27
59201,0,1,10,13,24
59202,0,0,4,2,6
59203,0,0,1,9,10
59204,0,0,7,6,13
59205,0,1,5,27,33
59206,0,0,11,20,31
59207,0,0,6,13,19
59208,0,0,3,2,5
59209,0,0,1,2,3
59210,0,0,1,7,8
59211,0,0,7,13,20
59212,0,0,0,10,10
59213,0,0,5,6,11
59214,0,0,4,4,8
59215,0,0,11,23,34
59216,0,0,0,7,7
59217,0,0,14,32,46
59219,0,0,10,13,23
59220,0,0,3,7,10
59221,0,0,5,3,8
59222,0,1,9,14,24
59223,0,0,8,16,24
59224,0,0,5,8,13
59225,0,1,5,25,31
59226,0,0,7,19,26
59227,0,0,2,10,12
59228,0,0,3,3,6
59229,0,0,5,3,8
59230,0,0,7,3,10
59231,0,1,5,13,19
59232,0,2,8,9,19
59233,0,0,7,18,25
59234,0,0,8,16,24
59235,0,0,8,13,21
59236,0,0,15,28,43
59237,0,0,17,33,50
59238,1,1,0,6,8
59239,0,0,4,4,8
59240,0,0,2,13,15
59241,0,2,10,24,36
59242,0,0,4,5,9
59243,2,0,10,22,34
59244,0,0,5,11,16
59245,0,0,4,20,24
59246,0,0,3,0,3
59247,0,0,1,13,14
59248,1,1,10,26,38
59249,0,0,3,2,5
59250,0,1,13,11,25
59251,0,1,7,8,16
59252,0,1,4,18,23
59253,0,0,5,3,8
59254,0,0,6,11,17
59256,0,0,8,20,28
59257,0,1,0,43,44
59258,0,0,18,29,47
59259,0,0,5,20,25
59260,1,0,4,5,10
59262,0,0,7,16,23
59263,1,0,9,22,32
59264,0,1,6,18,25
59265,0,0,4,2,6
59267,0,0,8,15,23
59268,0,0,2,6,8
59269,0,0,8,18,26
59270,0,0,4,8,12
59271,0,0,3,8,11
59272,0,1,4,6,11
59273,0,0,2,10,12
59274,3,2,6,39,50
59275,0,0,6,19,25
59276,0,0,5,5,10
59277,0,0,7,8,15
59278,0,2,6,23,31
59279,0,0,7,14,21
59280,0,0,1,12,13
59281,0,0,0,6,6
59282,0,0,6,5,11
59283,0,0,2,6,8
59284,0,0,2,9,11
59285,0,0,4,6,10
59286,0,0,5,44,49
59287,0,0,8,17,25
59288,0,0,0,14,14
59289,0,0,2,17,19
59290,0,0,5,6,11
59291,0,1,13,36,50
59292,0,0,5,7,12
59293,0,0,2,12,14
59294,0,2,7,14,23
59296,0,0,0,6,6
59297,0,1,5,9,15
59299,0,0,3,2,5
59301,0,0,2,20,22
59302,0,0,10,11,21
59303,0,0,1,7,8
59304,0,0,9,1,10
59305,0,2,4,11,17
59306,0,0,5,6,11
59307,0,0,5,10,15
59308,0,0,5,13,18
59309,0,0,14,26,40
59310,1,0,1,7,9
59311,0,0,5,13,18
59312,0,0,5,3,8
59313,0,0,8,16,24
59316,0,0,2,14,16
59317,0,0,3,4,7
59318,0,0,2,6,8
59321,0,0,7,20,27
59322,0,0,3,2,5
59323,0,0,12,10,22
59324,2,0,5,5,12
59325,3,0,2,23,28
59326,0,0,4,8,12
59327,1,1,4,13,19
59328,0,0,4,18,22
59329,0,0,9,11,20
59330,0,0,2,10,12
59331,0,1,2,14,17
59332,0,0,4,6,10
59333,0,1,2,9,12
59334,0,0,0,4,4
59335,0,0,6,5,11
59336,0,0,1,5,6
59338,2,0,0,11,13
59341,0,0,2,5,7
59343,0,1,3,2,6
59345,0,2,2,5,9
59346,1,0,4,10,15
59347,0,0,6,6,12
59348,0,0,7,11,18
59349,0,1,3,14,18
59350,0,0,0,7,7
59352,0,3,3,20,26
59353,1,0,6,17,24
59354,0,0,4,6,10
59355,0,2,9,19,30
59356,2,0,1,24,27
59358,0,0,8,23,31
59359,1,4,1,27,33
59360,0,0,4,6,10
59361,0,0,1,4,5
59362,1,0,3,20,24
59363,0,0,6,19,25
59364,0,2,10,23,35
59365,0,0,14,33,47
59366,1,0,5,6,12
59367,1,0,8,25,34
59368,2,1,3,24,30
59369,2,0,1,7,10
59370,0,0,6,44,50
59371,0,1,7,42,50
59372,0,2,3,38,43
59373,0,1,12,36,49
59374,3,1,8,26,38
59375,0,0,10,19,29
59376,0,0,3,14,17
59377,0,0,15,25,40
59378,0,0,9,29,38
59379,0,0,3,8,11
59380,1,0,6,33,40
59381,0,1,7,24,32
59382,0,3,7,37,47
59383,0,0,15,24,39
59384,0,0,11,11,22
59385,0,0,3,12,15
59386,0,0,10,11,21
59387,0,1,10,23,34
59388,0,0,3,15,18
59389,0,0,10,21,31
59390,0,0,8,16,24
59391,0,0,1,4,5
59392,2,1,11,26,40
59393,0,1,12,19,32
59394,0,1,3,14,18
59395,0,1,14,34,49
59396,0,0,2,45,47
59397,0,0,1,7,8
59398,0,0,9,29,38
59399,0,0,6,12,18
59400,1,0,0,8,9
59401,0,1,9,40,50
59402,0,0,4,25,29
59403,0,0,11,35,46
59404,2,0,1,13,16
59405,0,0,7,14,21
59406,0,0,9,8,17
59407,0,0,8,8,16
59408,0,1,5,10,16
59409,0,0,5,4,9
59410,0,0,13,9,22
59411,0,0,10,23,33
59412,0,0,4,10,14
59413,0,1,8,9,18
59414,0,0,6,44,50
59415,0,1,11,25,37
59416,0,1,10,20,31
59417,5,0,5,23,33
59419,0,0,6,13,19
59420,0,0,6,12,18
59421,0,2,7,4,13
59422,5,0,2,24,31
59423,1,1,17,30,49
59424,1,1,6,40,48
59425,1,0,9,14,24
59426,0,2,10,23,35
59427,0,3,3,20,26
59428,3,0,3,37,43
59429,0,0,13,16,29
59430,0,0,6,6,12
59431,0,0,9,38,47
59432,0,0,0,5,5
59433,1,1,5,29,36
59434,0,0,9,29,38
59435,0,0,7,12,19
59436,0,1,2,17,20
59437,0,1,17,30,48
59438,0,0,9,33,42
59439,0,0,4,1,5
59440,0,0,9,26,35
59441,0,1,3,43,47
59442,0,4,6,19,29
59443,0,0,4,5,9
59446,0,0,10,13,23
59447,0,1,9,19,29
59448,0,1,10,30,41
59449,0,0,1,12,13
59451,0,0,6,21,27
59452,0,0,16,34,50
59453,0,1,0,10,11
59454,0,1,17,30,48
59455,0,0,1,1,2
59456,0,0,14,33,47
59457,0,2,14,34,50
59458,0,0,12,14,26
59459,0,1,3,13,17
59460,0,0,6,5,11
59461,0,0,7,14,21
59462,2,1,4,19,26
59463,0,0,3,16,19
59464,0,0,9,9,18
59465,0,4,11,35,50
59466,0,0,4,6,10
59467,0,2,2,28,32
59468,0,0,19,30,49
59469,0,0,10,31,41
59470,0,0,1,4,5
59471,1,0,5,9,15
59472,0,0,5,9,14
59473,0,0,2,9,11
59474,0,0,17,22,39
59475,0,3,11,35,49
59476,2,1,3,24,30
59477,0,2,11,23,36
59478,0,0,3,11,14
59480,0,0,1,9,10
59481,0,1,4,7,12
59482,0,0,7,20,27
59483,1,0,5,17,23
59484,0,1,11,22,34
59485,0,0,0,7,7
59486,0,0,11,39,50
59487,0,3,0,12,15
59488,0,1,7,20,28
59489,0,1,1,16,18
59492,0,3,14,28,45
59493,0,0,3,6,9
59494,0,0,6,21,27
59495,2,0,1,24,27
59496,1,0,9,25,35
59497,0,0,8,10,18
59498,0,2,6,6,14
59499,2,0,1,7,10
59500,1,2,2,14,19
59501,0,0,7,13,20
59502,0,2,9,19,30
59503,0,0,0,10,10
59504,0,0,8,23,31
59505,0,0,2,12,14
59506,2,0,5,5,12
59507,0,0,0,7,7
59509,0,0,6,44,50
59510,0,0,3,15,18
59511,2,0,9,32,43
59512,0,0,2,12,14
59513,0,0,9,7,16
59514,0,0,1,4,5
59515,0,0,1,7,8
59516,0,0,2,45,47
59517,0,0,5,7,12
59518,0,0,9,23,32
59519,0,0,9,36,45
59520,1,1,6,40,48
59521,2,0,14,34,50
59522,0,3,3,20,26
59524,2,0,7,14,23
59527,1,2,2,14,19
59528,1,0,6,17,24
59529,5,0,2,24,31
59530,0,0,1,4,5
59532,1,1,6,40,48
59533,0,2,3,38,43
59534,0,0,0,4,4
59535,0,0,2,12,14
59536,0,0,8,10,18
59537,1,0,8,25,34
59538,0,0,11,24,35
59539,1,1,3,45,50
59540,1,1,3,39,44
59541,0,0,2,18,20
59542,0,1,5,5,11
59544,0,0,5,4,9
59545,0,0,3,2,5
59546,0,0,1,10,11
59547,0,0,3,10,13
59548,0,0,2,3,5
59549,1,0,0,4,5
59550,0,0,7,4,11
59551,0,0,7,24,31
59552,0,0,0,1,1
59556,0,0,1,3,4
59557,0,0,5,1,6
59558,0,1,0,0,1
59561,0,0,2,4,6
59562,1,2,7,23,33
59563,10,3,3,32,48
59564,0,0,10,12,22
59565,0,0,9,19,28
59566,0,0,6,6,12
59567,0,0,10,13,23
59568,0,0,3,5,8
59569,0,0,3,2,5
59570,0,0,2,14,16
59571,0,5,7,10,22
59572,0,0,1,16,17
59573,0,0,3,18,21
59574,0,0,15,35,50
59575,0,0,10,21,31
59576,0,0,9,22,31
59577,0,0,17,32,49
59578,0,2,14,34,50
59579,0,0,7,24,31
59580,0,0,8,16,24
59581,0,0,12,26,38
59582,0,0,5,12,17
59583,0,0,13,34,47
59584,0,0,7,18,25
59585,0,0,3,19,22
59586,0,0,7,12,19
59587,0,0,16,32,48
59588,0,0,9,19,28
59589,0,0,12,33,45
59590,0,0,2,14,16
59591,0,4,1,13,18
59592,0,1,3,4,8
59593,0,0,12,38,50
59594,0,0,13,25,38
59595,0,1,8,18,27
59596,0,0,8,26,34
59597,0,0,10,13,23
59598,0,3,14,33,50
59599,0,0,15,35,50
59600,0,0,13,22,35
59601,0,3,3,19,25
59602,0,0,16,30,46
59603,0,0,5,13,18
59604,0,1,5,21,27
59605,1,0,17,31,49
59606,0,0,5,16,21
59607,0,0,2,29,31
59608,0,0,6,7,13
59609,0,0,15,34,49
59610,0,0,0,14,14
59611,0,0,15,34,49
59612,0,0,10,17,27
59613,0,0,8,11,19
59614,0,0,5,21,26
59615,0,0,13,37,50
59616,0,1,10,19,30
59617,0,0,4,9,13
59618,0,0,7,12,19
59619,0,0,7,14,21
59620,0,0,3,14,17
59621,0,0,6,14,20
59622,1,1,4,20,26
59623,0,0,11,25,36
59624,0,0,5,18,23
59625,0,0,6,15,21
59626,0,0,9,13,22
59627,0,0,10,40,50
59628,0,0,12,24,36
59629,0,1,19,28,48
59630,0,0,2,2,4
59631,0,3,12,34,49
59632,0,0,8,14,22
59633,0,0,13,32,45
59634,0,0,11,26,37
59635,0,1,7,12,20
59636,0,0,16,33,49
59637,0,0,9,11,20
59638,0,1,10,24,35
59639,0,0,16,19,35
59640,0,0,2,4,6
59641,1,0,10,14,25
59642,0,1,7,13,21
59643,0,0,3,7,10
59644,0,0,16,31,47
59645,0,0,2,11,13
59646,0,0,9,10,19
59647,0,1,7,13,21
59648,0,0,2,10,12
59649,0,1,9,19,29
59650,0,0,6,7,13
59651,0,0,6,9,15
59652,0,0,4,14,18
59653,0,0,5,6,11
59655,0,1,6,16,23
59656,10,3,3,32,48
59657,0,2,18,27,47
59658,0,0,3,18,21
59659,0,0,7,19,26
59660,1,0,3,15,19
59661,0,1,4,14,19
59663,0,0,6,21,27
59664,2,0,7,33,42
59665,3,1,5,35,44
59666,2,1,15,31,49
59667,0,0,6,7,13
59668,0,2,13,21,36
59669,0,0,9,18,27
59670,0,0,11,16,27
59671,1,0,3,35,39
59674,1,2,7,23,33
59675,1,0,1,21,23
59676,0,0,8,20,28
59677,0,0,6,17,23
59678,0,0,3,5,8
59680,0,0,3,6,9
59681,0,1,9,20,30
59682,2,0,7,33,42
59683,0,0,11,26,37
59684,0,1,3,4,8
59685,0,0,0,6,6
59686,0,0,8,41,49
59687,0,0,7,13,20
59688,0,0,9,18,27
59689,0,1,13,28,42
59690,0,0,7,10,17
59691,0,1,7,19,27
59692,0,1,9,20,30
59693,0,0,7,36,43
59694,3,1,5,35,44
59695,1,0,8,23,32
59696,0,1,19,22,42
59697,0,0,1,4,5
59698,0,0,2,9,11
59699,1,0,1,21,23
59700,0,1,3,4,8
59702,0,0,5,11,16
59703,1,0,10,14,25
59704,0,0,1,4,5
59705,1,0,11,17,29
59706,0,1,19,22,42
59707,0,0,6,6,12
59708,0,0,2,9,11
59709,1,0,3,35,39
59710,1,0,1,21,23
59711,0,0,1,9,10
59712,0,1,9,20,30
59713,1,0,6,29,36
59714,0,0,2,7,9
59715,0,0,1,0,1
59716,0,0,4,9,13
59717,0,0,4,3,7
59718,1,2,15,32,50
59719,0,0,20,27,47
59720,0,0,15,35,50
59721,0,0,8,18,26
59722,0,0,7,24,31
59723,0,0,14,15,29
59724,0,0,5,9,14
59725,0,0,9,8,17
59726,0,1,0,12,13
59727,0,1,8,35,44
59728,0,0,0,3,3
59729,0,0,4,2,6
59730,0,1,8,13,22
59731,0,0,5,6,11
59732,0,0,12,21,33
59733,0,0,3,17,20
59734,0,0,0,18,18
59735,0,0,12,11,23
59736,0,0,5,24,29
59737,0,0,10,12,22
59738,0,0,16,20,36
59739,0,0,9,11,20
59740,0,0,4,13,17
59741,0,0,8,30,38
59742,0,0,8,10,18
59743,0,1,10,12,23
59744,0,2,6,11,19
59745,0,0,0,8,8
59746,0,2,17,25,44
59747,0,0,10,15,25
59748,0,0,4,14,18
59749,0,0,9,7,16
59750,1,0,11,23,35
59751,0,0,4,11,15
59752,0,0,6,6,12
59753,0,1,6,4,11
59754,0,0,1,8,9
59755,0,0,10,20,30
59756,0,0,20,29,49
59757,0,0,3,8,11
59758,0,0,11,13,24
59759,0,0,3,14,17
59760,0,0,5,21,26
59761,0,0,3,16,19
59762,0,0,4,22,26
59763,0,0,2,8,10
59764,1,0,1,7,9
59765,0,0,0,12,12
59766,0,0,6,28,34
59767,0,0,14,34,48
59768,0,0,1,5,6
59770,0,0,10,24,34
59771,0,0,5,10,15
59772,5,0,6,31,42
59774,0,2,15,29,46
59775,0,0,10,27,37
59776,0,0,9,11,20
59777,0,0,4,10,14
59778,0,0,2,6,8
59779,0,0,6,6,12
59780,0,1,12,15,28
59781,0,0,11,39,50
59782,0,0,4,11,15
59785,0,0,1,0,1
59786,1,0,11,17,29
59787,1,0,11,33,45
59788,0,0,6,21,27
59789,0,0,9,16,25
59791,0,4,0,3,7
59792,0,0,8,9,17
59793,0,0,16,30,46
59794,0,2,3,44,49
59795,0,0,5,7,12
59796,0,0,11,33,44
59798,1,0,9,12,22
59799,0,1,6,8,15
59800,0,0,8,12,20
59801,0,0,5,9,14
59802,0,0,9,17,26
59803,0,0,2,6,8
59804,0,1,6,33,40
59805,0,0,3,15,18
59806,0,0,10,22,32
59807,0,1,7,15,23
59809,0,0,6,13,19
59810,0,0,6,0,6
59811,0,0,3,3,6
59812,0,0,4,5,9
59813,0,0,8,12,20
59814,0,1,1,14,16
59815,0,0,2,23,25
59816,0,1,21,26,48
59817,0,0,8,30,38
59818,0,2,17,20,39
59819,0,0,4,5,9
59820,0,0,10,13,23
59821,0,0,4,7,11
59823,0,0,5,20,25
59824,0,1,4,21,26
59825,0,0,5,7,12
59826,0,0,9,17,26
59827,0,0,7,16,23
59828,0,0,5,8,13
59829,0,0,2,4,6
59830,0,0,4,3,7
59831,0,0,11,16,27
59832,0,0,2,7,9
59833,0,0,4,12,16
59834,0,1,10,8,19
59835,0,0,7,18,25
59836,0,0,8,20,28
59837,0,0,6,10,16
59838,0,1,10,15,26
59839,0,0,4,15,19
59840,0,0,9,20,29
59841,0,0,5,16,21
59842,0,0,9,9,18
59843,0,0,6,4,10
59844,1,0,2,44,47
59845,0,1,0,12,13
59846,0,0,6,10,16
59847,0,0,13,9,22
59849,0,0,9,19,28
59850,0,1,23,26,50
59851,0,0,7,15,22
59852,0,0,7,30,37
59853,0,0,2,4,6
59854,0,0,5,4,9
59855,0,0,1,8,9
59856,0,0,3,7,10
59858,0,1,5,8,14
59859,0,0,3,6,9
59860,0,1,9,13,23
59861,0,0,12,14,26
59862,0,0,12,20,32
59863,0,0,7,19,26
59864,1,1,6,27,35
59865,0,0,10,11,21
59866,0,0,4,7,11
59867,0,0,8,13,21
59868,0,0,4,8,12
59869,0,0,7,19,26
59871,0,0,5,17,22
59872,0,1,5,4,10
59873,0,0,10,26,36
59874,0,0,8,5,13
59875,0,1,2,13,16
59877,0,0,10,15,25
59878,0,0,4,12,16
59879,0,0,9,10,19
59880,0,0,1,0,1
59881,1,0,7,6,14
59882,0,0,0,4,4
59883,0,0,9,12,21
59884,0,0,4,16,20
59885,0,0,6,13,19
59886,0,0,4,24,28
59887,0,0,6,8,14
59888,0,0,8,15,23
59889,0,0,6,9,15
59890,0,0,15,35,50
59891,0,0,3,10,13
59892,0,0,2,18,20
59894,0,1,2,2,5
59895,0,0,8,21,29
59896,0,0,8,2,10
59897,0,0,3,1,4
59898,0,0,8,1,9
59899,0,0,9,21,30
59900,0,0,8,22,30
59901,0,0,15,26,41
59902,0,1,2,8,11
59903,2,1,7,18,28
59904,0,1,4,5,10
59905,0,0,2,13,15
59906,0,0,3,3,6
59907,0,0,3,3,6
59908,0,1,8,34,43
59910,0,1,8,11,20
59911,0,0,8,29,37
59913,0,0,7,17,24
59914,0,0,6,6,12
59915,0,0,6,29,35
59916,0,0,4,9,13
59917,0,0,0,3,3
59919,0,0,7,16,23
59920,0,0,8,7,15
59921,0,0,11,12,23
59922,0,0,10,14,24
59923,0,1,5,6,12
59924,1,0,11,17,29
59925,0,0,7,10,17
59926,0,0,8,14,22
59927,0,0,5,4,9
59928,0,0,5,12,17
59931,0,0,8,12,20
59932,0,1,0,10,11
59933,0,0,8,11,19
59934,0,0,2,8,10
59935,0,0,6,3,9
59936,2,0,5,6,13
59938,0,0,1,3,4
59939,0,0,14,8,22
59940,0,2,10,10,22
59941,0,0,10,19,29
59942,0,0,2,6,8
59943,0,0,16,23,39
59944,0,0,10,16,26
59945,0,0,12,22,34
59948,1,0,2,20,23
59949,0,0,3,14,17
59950,0,2,8,13,23
59951,4,0,8,36,48
59952,0,0,2,10,12
59953,0,0,8,19,27
59954,0,2,5,16,23
59955,1,0,6,26,33
59956,0,0,3,4,7
59957,0,0,5,7,12
59958,0,0,8,3,11
59960,0,0,7,17,24
59961,0,0,4,13,17
59962,0,0,7,14,21
59963,0,0,3,4,7
59964,0,0,11,30,41
59965,0,0,4,4,8
59968,0,0,1,5,6
59969,0,0,2,2,4
59970,0,0,3,22,25
59974,0,0,7,8,15
59975,0,1,3,4,8
59976,0,0,4,10,14
59977,0,0,7,13,20
59978,0,0,3,13,16
59979,0,0,5,3,8
59980,1,0,6,29,36
59981,0,0,12,25,37
59982,0,0,5,11,16
59983,0,0,4,9,13
59984,0,0,0,1,1
59985,0,0,2,5,7
59986,0,0,10,30,40
59987,0,0,8,17,25
59988,1,1,11,37,50
59989,0,1,8,35,44
59990,0,0,2,17,19
59991,0,0,13,17,30
59992,0,0,8,8,16
59993,0,0,10,8,18
59994,0,2,7,17,26
59996,0,0,6,30,36
59997,0,1,0,5,6
59998,0,0,16,34,50
59999,0,0,12,20,32
60000,0,0,18,32,50
60001,0,0,3,22,25
60002,0,1,13,28,42
60003,0,0,2,18,20
60004,0,0,12,27,39
60005,0,0,9,7,16
60006,0,1,17,32,50
60007,2,0,13,33,48
60008,0,1,11,7,19
60009,0,0,17,33,50
60010,0,0,11,17,28
60011,0,1,15,34,50
60012,0,0,7,14,21
60013,0,0,15,22,37
60014,0,1,9,21,31
60015,0,0,6,8,14
60016,0,0,10,13,23
60017,0,0,16,31,47
60018,0,0,9,11,20
60019,1,0,12,6,19
60020,5,0,3,32,40
60021,0,0,8,24,32
60022,0,0,2,8,10
60023,0,2,4,13,19
60024,0,0,5,13,18
60025,0,0,14,25,39
60026,0,0,6,22,28
60027,0,1,14,35,50
60028,0,2,8,15,25
60029,0,0,8,30,38
60030,0,0,5,16,21
60031,0,2,8,11,21
60032,0,1,13,16,30
60033,0,0,11,13,24
60034,0,0,9,18,27
60035,1,1,7,18,27
60036,0,1,9,21,31
60037,2,1,8,32,43
60038,0,0,8,14,22
60039,0,0,7,27,34
60041,0,0,7,29,36
60042,0,0,10,38,48
60043,0,0,20,25,45
60044,0,0,5,6,11
60045,0,0,6,10,16
60046,0,0,12,28,40
60047,0,0,15,32,47
60048,0,0,14,28,42
60049,0,0,5,8,13
60050,1,0,14,35,50
60051,0,0,7,13,20
60052,0,1,13,32,46
60053,0,0,12,16,28
60054,0,1,3,5,9
60055,0,1,12,22,35
60056,0,0,14,20,34
60057,1,0,12,20,33
60058,0,0,12,38,50
60059,1,0,11,10,22
60060,0,0,16,12,28
60061,0,1,12,37,50
60062,0,0,6,11,17
60063,0,0,3,15,18
60064,0,0,2,7,9
60065,0,0,1,8,9
60066,0,0,8,28,36
60067,0,0,7,20,27
60068,0,0,5,11,16
60069,0,0,13,31,44
60070,0,0,5,8,13
60071,4,0,7,24,35
60072,1,0,15,29,45
60073,0,0,8,42,50
60074,2,0,16,32,50
60075,0,1,7,13,21
60076,0,0,3,2,5
60077,0,0,6,2,8
60078,0,0,3,20,23
60079,0,0,11,4,15
60080,0,1,10,19,30
60081,0,0,10,16,26
60082,0,0,2,3,5
60083,0,0,11,27,38
60084,0,0,5,2,7
60085,0,0,2,19,21
60086,0,0,3,15,18
60087,0,6,6,34,46
60088,0,0,0,8,8
60089,0,0,4,16,20
60090,0,0,8,26,34
60091,0,0,7,22,29
60092,0,0,8,15,23
60093,0,0,11,13,24
60095,0,0,6,6,12
60097,0,2,7,40,49
60098,0,0,13,33,46
60099,0,0,7,24,31
60100,0,0,10,12,22
60101,0,1,4,19,24
60102,0,0,7,28,35
60103,0,1,3,4,8
60104,0,0,5,5,10
60105,0,0,3,8,11
60106,0,0,8,36,44
60107,0,0,4,10,14
60108,0,0,12,25,37
60109,0,2,0,11,13
60110,0,0,1,5,6
60111,0,2,4,21,27
60112,0,0,3,13,16
60113,0,0,5,3,8
60114,0,0,7,13,20
60115,0,0,0,16,16
60116,0,0,3,9,12
60117,0,2,7,40,49
60118,0,1,15,34,50
60119,0,0,9,32,41
60120,0,0,3,2,5
60121,0,0,16,31,47
60122,0,1,11,31,43
60123,0,1,6,8,15
60124,0,0,9,7,16
60125,0,0,3,8,11
60126,0,0,0,8,8
60127,2,1,8,32,43
60128,0,0,3,1,4
60129,0,0,7,9,16
60130,0,1,3,4,8
60131,1,0,6,29,36
60133,0,0,3,19,22
60134,0,2,0,11,13
60135,0,0,0,1,1
60136,0,0,9,24,33
60137,0,1,2,12,15
60138,0,0,11,18,29
60139,0,0,12,17,29
60140,1,0,17,27,45
60141,0,1,19,22,42
60142,0,0,4,5,9
60143,1,1,7,36,45
60144,0,0,5,11,16
60145,0,0,11,29,40
60146,0,1,3,4,8
60147,0,0,3,3,6
60148,0,1,6,8,15
60149,1,0,11,17,29
60150,0,1,19,22,42
60151,0,0,6,6,12
60152,0,0,8,8,16
60153,0,0,5,3,8
60154,0,0,4,10,14
60155,0,2,4,21,27
60156,0,2,7,40,49
60157,0,0,5,11,16
60158,0,1,3,5,9
60159,0,0,2,8,10
60160,0,1,7,9,17
60161,0,0,3,1,4
60162,0,0,5,3,8
60163,1,1,6,39,47
60164,0,1,7,11,19
60165,0,0,5,2,7
60166,1,0,8,15,24
60167,0,0,3,17,20
60168,0,1,4,13,18
60169,0,1,9,15,25
60170,0,0,1,4,5
60173,0,0,0,1,1
60174,0,0,2,9,11
60175,0,1,10,15,26
60176,0,0,7,21,28
60177,0,1,9,40,50
60178,0,1,6,16,23
60179,0,1,4,13,18
60180,0,2,5,10,17
60181,0,1,3,17,21
60182,0,1,3,8,12
60183,0,0,4,10,14
60184,0,0,10,21,31
60185,0,0,2,7,9
60186,0,1,3,3,7
60187,0,0,5,1,6
60188,0,1,3,11,15
60189,0,0,9,21,30
60190,0,1,13,28,42
60191,0,0,4,5,9
60192,0,0,11,37,48
60194,0,0,1,0,1
60195,0,0,2,14,16
60196,1,0,17,32,50
60197,0,0,13,32,45
60198,0,0,8,14,22
60199,0,0,1,5,6
60200,0,0,2,3,5
60201,0,0,2,3,5
60202,2,0,1,24,27
60203,0,0,5,2,7
60204,1,0,9,40,50
60205,0,0,11,10,21
60208,0,1,8,17,26
60209,1,1,5,36,43
60210,0,0,4,5,9
60211,0,0,11,22,33
60212,0,2,8,26,36
60213,1,0,3,8,12
60214,0,0,5,22,27
60215,0,0,11,16,27
60216,0,0,6,8,14
60217,0,0,6,27,33
60218,0,1,12,14,27
60219,0,0,7,17,24
60220,0,0,2,14,16
60221,0,0,0,7,7
60222,1,0,3,35,39
60223,0,0,3,1,4
60224,0,0,4,8,12
60225,0,1,6,19,26
60227,0,0,4,13,17
60228,0,1,6,33,40
60229,0,0,7,27,34
60230,0,0,10,20,30
60231,0,0,2,14,16
60232,0,0,6,25,31
60233,0,0,3,6,9
60234,0,0,4,0,4
60235,0,0,8,10,18
60236,0,1,0,13,14
60237,0,0,3,0,3
60238,0,0,11,20,31
60240,0,1,9,16,26
60241,0,0,5,17,22
60242,0,0,5,12,17
60243,0,0,8,7,15
60244,0,0,5,10,15
60245,0,0,15,26,41
60246,1,4,7,15,27
60247,0,0,3,2,5
60248,0,0,14,19,33
60249,0,0,5,17,22
60250,0,0,7,8,15
60251,0,1,8,11,20
60252,0,0,6,14,20
60253,0,2,7,12,21
60254,0,0,5,20,25
60255,0,0,10,15,25
60256,0,0,2,6,8
60257,0,0,2,3,5
60258,0,0,2,8,10
60259,0,2,9,24,35
60260,2,0,0,7,9
60261,0,0,4,16,20
60262,0,0,0,1,1
60263,0,0,4,5,9
60264,0,0,11,36,47
60265,0,5,9,36,50
60266,0,1,9,29,39
60267,0,1,4,21,26
60268,0,0,10,33,43
60269,0,0,13,17,30
60270,0,0,7,3,10
60272,0,0,0,14,14
60273,0,0,6,9,15
60274,0,0,7,6,13
60275,0,0,1,11,12
60276,0,0,5,3,8
60277,0,6,4,12,22
60278,0,0,3,8,11
60279,0,0,4,3,7
60280,0,0,10,20,30
60281,0,0,2,4,6
60282,0,1,4,18,23
60283,0,0,2,11,13
60284,0,0,6,11,17
60285,0,0,4,4,8
60286,0,0,3,16,19
60287,0,0,4,9,13
60288,0,0,4,13,17
60289,0,1,4,5,10
60290,0,0,3,8,11
60291,0,0,3,11,14
60292,0,0,6,6,12
60293,0,0,3,4,7
60294,3,0,7,40,50
60295,0,1,3,29,33
60296,0,2,3,11,16
60297,0,0,8,15,23
60298,0,0,3,7,10
60299,0,0,3,7,10
60300,0,0,15,31,46
60301,0,0,5,6,11
60302,0,0,13,28,41
60303,0,0,0,13,13
60304,0,0,5,3,8
60305,0,0,6,13,19
60306,0,1,18,20,39
60307,0,0,1,4,5
60308,0,0,4,5,9
60309,0,0,5,8,13
60310,0,0,7,14,21
60311,0,0,3,6,9
60312,0,2,9,23,34
60313,0,0,8,20,28
60314,0,4,2,4,10
60315,0,6,3,33,42
60316,0,0,12,25,37
60317,1,2,11,18,32
60318,0,0,3,21,24
60319,0,0,10,7,17
60320,0,0,7,7,14
60321,0,0,1,11,12
60322,0,0,4,10,14
60323,0,1,6,21,28
60324,3,3,7,32,45
60325,0,0,11,10,21
60326,0,1,1,12,14
60327,0,0,9,13,22
60328,0,0,10,11,21
60329,2,0,6,16,24
60330,0,0,1,4,5
60331,0,0,7,18,25
60332,0,0,1,9,10
60333,0,2,3,7,12
60334,0,0,1,4,5
60336,0,0,0,5,5
60338,0,0,11,16,27
60339,0,3,13,32,48
60340,1,2,7,23,33
60341,0,0,2,8,10
60342,0,0,3,13,16
60343,1,0,2,20,23
60344,0,0,15,21,36
60345,0,0,2,3,5
60346,0,1,2,21,24
60347,0,0,10,22,32
60348,0,0,9,22,31
60349,0,1,15,34,50
60350,0,0,4,12,16
60351,0,0,12,20,32
60352,1,0,9,20,30
60353,0,0,8,25,33
60354,0,1,13,28,42
60355,0,0,8,12,20
60356,0,1,2,25,28
60357,0,1,1,11,13
60358,0,2,11,26,39
60359,3,0,10,18,31
60360,0,1,3,19,23
60361,0,0,14,18,32
60362,1,2,12,34,49
60363,0,0,5,14,19
60364,0,0,6,15,21
60365,0,0,8,9,17
60366,0,0,3,8,11
60367,0,0,10,38,48
60368,1,0,2,31,34
60369,0,0,11,24,35
60370,0,0,15,31,46
60371,0,0,4,5,9
60372,0,3,4,23,30
60373,0,0,5,16,21
60374,0,2,1,16,19
60375,1,0,12,34,47
60376,0,1,5,12,18
60377,0,0,15,17,32
60378,0,2,17,27,46
60379,1,0,7,42,50
60380,0,0,16,15,31
60381,0,0,1,6,7
60382,0,0,11,16,27
60383,0,0,9,25,34
60384,0,1,11,25,37
60385,0,1,6,13,20
60386,0,0,10,24,34
60387,0,0,4,10,14
60388,0,0,2,9,11
60389,0,0,10,40,50
60390,2,0,10,37,49
60391,0,0,5,27,32
60392,6,0,4,32,42
60393,0,1,6,10,17
60394,0,0,7,10,17
60395,0,0,3,13,16
60396,0,0,3,15,18
60397,0,0,11,26,37
60398,0,0,6,9,15
60399,0,0,12,38,50
60400,4,0,7,24,35
60401,0,1,5,24,30
60402,0,0,9,12,21
60403,0,0,3,5,8
60404,0,0,10,17,27
60405,0,1,7,17,25
60406,0,4,12,33,49
60407,0,1,8,8,17
60408,0,0,4,17,21
60409,0,2,3,7,12
60410,1,0,11,16,28
60411,0,0,12,32,44
60412,0,0,8,36,44
60413,0,0,15,19,34
60414,0,0,8,15,23
60415,0,0,5,27,32
60416,0,0,7,11,18
60417,0,0,16,28,44
60418,0,1,14,15,30
60419,0,0,10,13,23
60420,0,0,16,28,44
60421,0,1,4,16,21
60422,0,0,7,27,34
60423,0,0,11,28,39
60424,0,0,8,4,12
60425,0,1,0,17,18
60426,0,0,11,16,27
60427,0,1,6,16,23
60428,0,3,7,40,50
60429,0,0,5,14,19
60430,0,0,9,17,26
60431,0,0,16,31,47
60432,0,0,9,20,29
60433,1,2,7,23,33
60434,0,9,4,9,22
60435,0,0,2,12,14
60437,0,0,6,12,18
60438,0,0,7,12,19
60439,0,1,5,17,23
60440,0,0,5,10,15
60441,0,0,5,4,9
60443,0,0,15,21,36
60444,0,2,5,26,33
60445,0,0,10,23,33
60447,0,0,12,25,37
60448,0,0,7,15,22
60449,0,0,0,5,5
60450,0,0,2,30,32
60451,0,0,2,8,10
60452,0,0,3,13,16
60453,0,3,13,32,48
60454,0,1,14,35,50
60455,0,2,0,11,13
60456,0,0,6,18,24
60457,0,0,5,14,19
60458,1,0,2,31,34
60459,0,1,6,16,23
60460,0,2,0,11,13
60461,0,0,0,6,6
60462,0,1,4,27,32
60464,0,1,1,11,13
60465,3,0,2,12,17
60466,0,0,2,30,32
60468,0,1,15,34,50
60469,0,1,1,11,13
60470,0,3,13,32,48
60471,0,3,13,32,48
60472,0,0,1,4,5
60473,0,0,4,9,13
60474,0,0,2,3,5
60475,0,0,1,4,5
60476,0,0,5,2,7
60477,0,0,7,26,33
60478,0,0,5,25,30
60479,2,0,1,25,28
60480,0,1,2,9,12
60481,0,0,0,8,8
60482,0,0,1,4,5
60483,0,0,1,13,14
60484,0,0,3,9,12
60485,0,0,5,18,23
60486,0,3,8,22,33
60487,0,0,6,24,30
60488,0,0,4,12,16
60489,0,0,5,3,8
60490,0,0,10,12,22
60491,0,1,9,17,27
60492,0,0,4,9,13
60493,0,0,9,16,25
60494,0,0,14,15,29
60495,0,0,6,18,24
60496,0,1,13,11,25
60497,0,0,7,12,19
60498,0,0,11,10,21
60499,0,0,4,9,13
60500,0,0,9,16,25
60501,0,0,13,13,26
60502,0,0,1,5,6
60503,0,1,4,18,23
60504,0,6,2,10,18
60505,0,1,8,23,32
60507,0,0,5,6,11
60508,0,1,2,7,10
60509,1,0,1,20,22
60510,0,0,6,5,11
60511,0,0,1,4,5
60512,0,0,6,9,15
60513,1,0,1,10,12
60514,0,0,8,4,12
60515,0,1,9,25,35
60516,0,0,7,10,17
60517,1,1,9,37,48
60518,0,0,6,17,23
60519,0,0,13,36,49
60520,0,1,20,22,43
60521,0,0,5,7,12
60522,2,1,5,30,38
60523,0,0,5,3,8
60524,0,0,6,9,15
60525,0,0,8,16,24
60526,0,0,6,11,17
60527,0,1,2,10,13
60528,0,0,5,6,11
60529,0,0,15,24,39
60530,0,2,5,13,20
60531,0,1,11,37,49
60532,0,0,6,7,13
60533,0,0,5,13,18
60534,0,0,6,3,9
60535,0,0,4,9,13
60536,0,0,8,10,18
60537,0,0,0,21,21
60538,0,0,1,23,24
60539,0,0,0,8,8
60540,0,0,3,14,17
60541,0,0,6,7,13
60543,0,0,3,2,5
60545,0,2,6,15,23
60546,0,0,10,35,45
60547,0,1,0,7,8
60548,0,0,6,17,23
60549,1,0,3,4,8
60550,0,0,9,18,27
60552,0,1,4,13,18
60553,0,0,2,17,19
60554,0,0,13,37,50
60555,0,1,1,16,18
60556,0,0,20,29,49
60557,0,0,6,14,20
60558,0,0,10,37,47
60559,0,0,9,8,17
60560,0,0,2,11,13
60561,2,0,4,17,23
60562,0,0,17,31,48
60563,0,0,9,17,26
60564,0,0,13,14,27
60565,0,0,9,34,43
60566,0,0,12,26,38
60567,0,0,5,12,17
60568,0,1,6,11,18
60569,0,1,7,15,23
60570,0,0,2,18,20
60571,0,0,10,19,29
60572,0,0,4,9,13
60573,0,0,3,8,11
60574,0,0,4,10,14
60575,0,1,14,35,50
60576,0,0,8,29,37
60577,0,0,6,37,43
60578,1,0,5,18,24
60579,0,1,7,40,48
60580,0,0,11,20,31
60581,0,0,7,9,16
60582,0,0,8,6,14
60583,0,0,4,6,10
60584,0,0,12,15,27
60585,0,1,9,36,46
60586,3,2,5,40,50
60587,0,0,7,33,40
60588,0,0,8,24,32
60589,0,0,10,33,43
60590,0,0,9,18,27
60593,0,1,8,10,19
60594,0,0,2,2,4
60595,0,0,9,18,27
60596,0,0,10,9,19
60597,0,3,8,35,46
60598,2,1,9,31,43
60599,0,0,0,9,9
60600,0,0,12,18,30
60601,0,0,11,15,26
60602,0,0,8,5,13
60603,1,1,6,37,45
60604,0,0,2,9,11
60605,0,1,8,12,21
60606,0,0,9,35,44
60607,0,0,17,27,44
60608,0,0,6,10,16
60609,0,0,13,37,50
60610,2,2,8,38,50
60611,0,1,1,24,26
60612,0,0,16,27,43
60613,0,1,7,10,18
60614,0,0,16,34,50
60615,0,0,7,18,25
60616,0,0,11,39,50
60617,0,0,6,17,23
60618,0,0,0,9,9
60619,0,2,7,36,45
60620,0,0,12,26,38
60621,0,0,6,8,14
60622,0,0,4,12,16
60623,0,0,14,11,25
60624,0,0,13,37,50
60625,1,1,3,13,18
60626,0,0,9,6,15
60627,0,0,3,24,27
60628,0,0,9,18,27
60629,1,0,12,36,49
60630,0,0,12,28,40
60631,0,1,7,9,17
60632,0,0,5,13,18
60633,0,0,9,16,25
60634,0,0,10,32,42
60636,0,0,1,5,6
60637,0,0,7,9,16
60638,0,0,3,11,14
60639,0,0,11,37,48
60640,0,1,7,9,17
60641,0,0,2,18,20
60642,0,1,3,45,49
60643,0,1,0,7,8
60644,0,1,7,40,48
60645,0,2,7,36,45
60647,0,0,1,23,24
60648,0,0,9,18,27
60649,0,0,10,15,25
60650,0,1,7,15,23
60651,3,2,5,40,50
60652,0,0,3,11,14
60653,0,0,0,5,5
60655,0,0,13,37,50
60657,1,0,6,29,36
60658,1,0,4,9,14
60659,0,0,3,4,7
60660,0,1,4,10,15
60661,0,0,3,4,7
60662,0,0,3,6,9
60663,0,0,5,6,11
60664,0,0,15,27,42
60665,0,0,6,11,17
60666,0,0,16,27,43
60667,0,0,11,32,43
60668,0,0,2,12,14
60669,0,1,4,14,19
60670,0,0,3,10,13
60671,0,0,4,25,29
60672,0,2,1,12,15
60673,0,0,0,8,8
60674,0,0,2,16,18
60675,0,0,13,36,49
60676,0,0,3,22,25
60677,0,0,23,27,50
60678,0,3,5,15,23
60679,0,0,7,18,25
60680,0,0,9,20,29
60681,0,0,4,8,12
60683,0,0,1,5,6
60684,0,0,1,7,8
60685,0,0,10,13,23
60686,0,0,2,5,7
60687,1,1,8,32,42
60688,0,0,3,4,7
60689,0,0,9,24,33
60690,0,0,10,29,39
60691,0,0,0,12,12
60692,0,0,2,3,5
60693,0,1,1,6,8
60695,0,2,2,5,9
60696,0,0,7,43,50
60697,0,0,11,16,27
60698,0,0,1,12,13
60699,0,0,10,10,20
60700,0,1,10,35,46
60701,0,0,8,10,18
60702,0,1,6,7,14
60703,0,0,8,18,26
60704,0,0,1,5,6
60705,0,0,9,24,33
60706,0,0,9,25,34
60707,0,0,11,25,36
60708,0,0,1,4,5
60709,0,3,4,32,39
60710,0,1,4,22,27
60711,1,0,8,16,25
60712,0,0,7,16,23
60713,0,0,5,33,38
60714,0,1,11,32,44
60715,0,0,18,32,50
60716,0,0,3,11,14
60717,0,0,6,15,21
60718,0,0,0,6,6
60720,0,0,3,1,4
60721,0,0,8,20,28
60722,0,0,2,8,10
60723,0,0,3,6,9
60724,0,1,4,10,15
60725,0,0,7,15,22
60726,0,0,5,43,48
60727,2,0,9,24,35
60728,0,0,3,10,13
60729,0,0,6,22,28
60730,0,0,8,8,16
60731,0,0,5,22,27
60733,1,0,8,12,21
60734,0,0,2,19,21
60735,0,0,7,12,19
60736,0,2,1,12,15
60737,0,0,3,26,29
60738,0,0,3,10,13
60739,0,1,7,19,27
60740,0,0,8,23,31
60742,0,0,6,8,14
60744,0,0,6,9,15
60745,0,0,3,5,8
60746,0,0,12,17,29
60747,0,0,6,11,17
60748,0,2,7,41,50
60749,0,0,9,14,23
60750,0,0,2,7,9
60751,0,2,6,7,15
60752,0,0,5,19,24
60753,1,2,1,15,19
60754,1,0,2,22,25
60755,1,2,10,23,36
60756,0,1,4,12,17
60757,0,1,11,21,33
60758,0,0,6,10,16
60759,0,0,0,1,1
60761,0,0,11,32,43
60762,0,0,10,14,24
60763,0,0,10,22,32
60764,0,1,16,22,39
60765,0,0,7,13,20
60766,0,0,2,7,9
60767,0,0,6,17,23
60768,0,1,3,11,15
60769,0,0,14,22,36
60770,0,0,2,9,11
60771,0,1,16,22,39
60772,0,1,14,14,29
60773,0,0,13,31,44
60774,0,0,4,14,18
60775,0,0,14,17,31
60776,0,0,3,19,22
60777,0,0,11,22,33
60779,0,0,10,17,27
60780,0,0,12,25,37
60781,0,2,9,10,21
60782,0,1,10,25,36
60783,0,0,5,13,18
60784,0,0,1,6,7
60785,0,0,3,9,12
60786,0,0,7,2,9
60787,0,0,6,2,8
60788,0,0,5,16,21
60789,0,0,7,18,25
60790,0,0,6,3,9
60791,0,2,12,23,37
60792,0,0,7,1,8
60793,0,0,7,8,15
60794,0,1,3,14,18
60795,0,0,6,7,13
60796,0,0,5,5,10
60797,0,0,7,9,16
60798,0,0,6,12,18
60799,0,0,4,15,19
60800,0,0,9,10,19
60801,0,0,6,15,21
60802,0,0,5,18,23
60803,0,1,5,14,20
60804,0,0,9,14,23
60805,0,1,3,17,21
60806,0,1,11,21,33
60807,1,0,5,13,19
60808,0,0,1,5,6
60809,0,0,11,19,30
60810,0,0,5,9,14
60811,0,0,12,15,27
60812,0,0,0,2,2
60813,0,0,7,14,21
60814,0,0,8,4,12
60815,0,0,5,14,19
60816,0,0,6,26,32
60817,0,0,6,8,14
60818,0,0,3,14,17
60819,0,0,0,8,8
60820,0,1,4,10,15
60821,0,0,8,18,26
60822,1,0,5,43,49
60823,0,0,4,22,26
60824,0,1,16,30,47
60825,0,0,1,21,22
60826,0,0,8,29,37
60827,0,0,3,5,8
60828,0,0,8,13,21
60829,0,0,16,32,48
60830,0,0,3,7,10
60831,0,0,0,5,5
60832,0,0,5,18,23
60833,0,0,5,12,17
60834,0,0,3,7,10
60835,0,0,5,17,22
60836,0,0,9,13,22
60837,0,0,19,31,50
60838,0,0,5,3,8
60839,0,0,9,15,24
60840,1,0,3,10,14
60841,0,1,7,11,19
60842,0,0,5,15,20
60843,0,0,4,14,18
60844,0,0,3,6,9
60845,0,0,15,33,48
60846,0,0,13,24,37
60847,0,0,4,8,12
60848,0,0,1,4,5
60849,0,1,18,23,42
60850,0,0,5,14,19
60851,3,0,11,19,33
60852,0,0,9,9,18
60853,0,0,9,8,17
60854,0,0,5,13,18
60855,0,0,5,18,23
60856,0,1,4,9,14
60857,0,0,10,12,22
60858,0,0,3,2,5
60859,0,0,5,4,9
60860,0,0,8,19,27
60862,0,0,7,6,13
60863,0,0,1,11,12
60864,0,0,3,2,5
60865,0,0,10,39,49
60866,0,0,9,21,30
60867,0,0,3,13,16
60868,0,4,6,21,31
60869,0,0,1,24,25
60870,0,0,4,1,5
60871,0,0,15,26,41
60872,0,0,0,5,5
60873,0,2,3,12,17
60874,0,1,4,13,18
60875,0,2,6,15,23
60876,0,1,10,10,21
60877,0,0,5,6,11
60878,0,0,6,24,30
60879,0,0,5,10,15
60880,0,0,1,7,8
60881,0,0,11,8,19
60882,0,0,8,8,16
60883,0,0,7,20,27
60884,0,0,8,16,24
60885,0,1,4,13,18
60886,0,1,3,10,14
60887,0,1,19,29,49
60888,0,0,5,12,17
60889,0,1,8,24,33
60890,0,0,1,7,8
60891,0,0,5,7,12
60892,0,0,6,13,19
60893,1,1,13,25,40
60894,0,0,8,8,16
60895,0,1,9,31,41
60896,0,0,1,4,5
60897,0,0,6,10,16
60898,0,0,4,10,14
60899,0,1,16,21,38
60900,0,0,11,35,46
60901,0,0,3,8,11
60902,0,0,6,5,11
60903,0,0,11,21,32
60904,0,0,5,7,12
60905,0,0,6,20,26
60906,0,0,1,9,10
60908,0,0,11,17,28
60909,0,0,3,18,21
60910,0,0,6,7,13
60911,0,0,4,5,9
60912,0,0,9,26,35
60915,1,0,2,14,17
60916,0,0,5,1,6
60917,0,0,13,26,39
60918,0,0,12,12,24
60919,0,1,4,6,11
60920,0,2,10,15,27
60921,0,0,7,20,27
60922,0,0,11,16,27
60925,0,0,5,15,20
60927,0,1,12,25,38
60928,0,0,6,15,21
60929,0,0,7,13,20
60930,0,0,9,12,21
60931,0,0,2,12,14
60935,0,0,8,12,20
60936,0,0,2,12,14
60937,0,2,3,12,17
60938,0,0,3,7,10
60939,1,0,6,29,36
60940,0,1,4,22,27
60941,0,0,8,11,19
60943,1,2,3,14,20
60944,0,0,3,13,16
60945,0,1,0,7,8
60946,0,0,13,16,29
60947,0,0,2,17,19
60948,0,0,0,5,5
60950,0,0,1,16,17
60951,0,1,7,20,28
60952,0,0,17,33,50
60953,0,0,2,10,12
60954,0,1,13,36,50
60955,0,0,9,36,45
60956,0,0,8,19,27
60957,0,0,2,4,6
60958,1,1,5,24,31
60959,0,0,5,19,24
60960,0,0,17,25,42
60961,0,0,10,30,40
60962,0,0,16,34,50
60963,0,0,13,36,49
60964,0,0,9,18,27
60965,0,2,6,10,18
60966,0,0,4,33,37
60967,0,0,8,28,36
60968,0,0,7,14,21
60969,0,0,5,22,27
60970,0,1,14,25,40
60971,0,0,13,33,46
60972,0,0,3,3,6
60973,0,0,5,22,27
60974,1,2,2,19,24
60975,0,0,15,34,49
60976,0,1,8,28,37
60977,0,0,3,4,7
60978,0,1,5,10,16
60979,0,2,3,15,20
60980,0,0,7,14,21
60981,0,2,6,13,21
60982,0,0,14,34,48
60983,0,0,11,28,39
60984,0,0,3,13,16
60985,0,0,13,20,33
60986,0,0,11,9,20
60988,0,1,6,17,24
60989,0,1,6,7,14
60990,0,0,2,7,9
60991,0,0,4,14,18
60992,0,0,16,28,44
60993,0,0,5,11,16
60994,0,3,3,18,24
60995,0,0,10,24,34
60996,0,0,9,12,21
60997,0,0,1,7,8
60998,0,1,10,18,29
60999,0,0,0,1,1
61000,0,0,12,31,43
61001,0,0,4,29,33
61002,0,0,4,34,38
61003,0,2,17,27,46
61004,0,0,0,7,7
61005,0,0,12,28,40
61006,0,0,16,23,39
61007,0,1,4,38,43
61008,0,1,0,17,18
61010,0,0,7,12,19
61011,0,0,4,23,27
61012,2,0,11,37,50
61013,0,0,3,21,24
61014,0,0,6,17,23
61015,0,2,2,6,10
61016,0,0,4,16,20
61017,0,1,10,31,42
61018,0,0,13,19,32
61019,0,0,4,8,12
61020,0,1,5,14,20
61021,1,0,7,42,50
61022,0,0,13,17,30
61023,0,0,6,12,18
61024,0,0,5,15,20
61025,0,1,14,32,47
61026,3,2,4,27,36
61027,0,0,5,45,50
61028,0,0,14,25,39
61029,0,0,6,15,21
61030,0,0,7,14,21
61031,0,0,13,37,50
61032,0,2,9,21,32
61033,1,0,3,35,39
61034,0,0,10,13,23
61035,0,0,8,11,19
61036,0,0,5,12,17
61037,0,0,5,9,14
61038,0,0,9,30,39
61039,0,1,16,27,44
61040,0,0,9,13,22
61041,1,2,7,39,49
61042,0,1,15,31,47
61043,0,0,10,20,30
61044,0,2,7,41,50
61045,0,0,5,11,16
61046,0,0,11,11,22
61047,0,0,14,35,49
61048,1,0,8,12,21
61049,0,0,14,30,44
61050,0,1,17,24,42
61051,0,0,13,18,31
61052,0,0,19,23,42
61053,0,0,16,34,50
61054,0,0,5,6,11
61055,0,0,10,22,32
61056,0,0,4,9,13
61057,2,0,10,31,43
61058,0,1,3,15,19
61059,0,0,6,10,16
61060,0,1,10,16,27
61061,0,0,3,2,5
61062,0,1,7,18,26
61063,0,0,11,39,50
61064,0,3,23,21,47
61065,0,0,8,13,21
61066,0,1,2,11,14
61067,1,0,10,39,50
61068,0,0,9,26,35
61069,0,0,0,3,3
61070,0,0,3,6,9
61072,0,0,1,7,8
61073,0,0,5,7,12
61075,0,0,0,8,8
61076,0,1,3,16,20
61077,0,0,3,14,17
61078,0,0,1,5,6
61079,0,0,1,4,5
61080,0,0,8,18,26
61081,0,0,10,12,22
61082,1,1,9,39,50
61083,0,1,12,16,29
61084,0,0,10,26,36
61085,0,4,12,33,49
61086,0,0,5,13,18
61087,0,0,1,6,7
61088,0,1,7,42,50
61089,0,0,1,5,6
61090,0,0,12,37,49
61091,0,1,10,37,48
61092,1,1,15,27,44
61093,0,0,4,14,18
61094,4,1,13,31,49
61095,0,0,2,5,7
61096,0,1,7,19,27
61097,0,0,10,9,19
61098,0,0,10,29,39
61099,0,0,6,4,10
61100,0,0,12,23,35
61101,0,0,4,7,11
61102,0,1,7,21,29
61103,0,0,6,16,22
61104,0,0,7,20,27
61105,0,3,1,13,17
61106,0,0,9,12,21
61107,0,0,3,2,5
61108,0,0,7,26,33
61109,0,0,8,6,14
61110,0,0,8,19,27
61111,0,0,10,33,43
61112,0,0,0,5,5
61113,0,1,6,8,15
61114,0,0,11,35,46
61115,0,0,6,17,23
61116,0,0,10,7,17
61117,0,0,13,30,43
61118,0,0,4,9,13
61122,0,0,13,29,42
61123,4,3,7,36,50
61124,0,0,1,14,15
61125,0,1,3,33,37
61126,0,0,7,21,28
61127,0,0,7,16,23
61128,0,0,3,9,12
61129,0,0,4,12,16
61130,0,0,3,31,34
61132,0,0,3,13,16
61133,0,0,9,32,41
61134,0,2,7,27,36
61135,1,6,0,27,34
61136,0,0,7,13,20
61137,0,0,1,4,5
61138,1,1,8,21,31
61139,0,3,14,20,37
61140,0,0,3,3,6
61142,0,0,23,27,50
61143,0,1,15,34,50
61144,0,1,7,15,23
61145,3,1,5,35,44
61147,0,0,10,13,23
61148,0,0,3,22,25
61149,0,0,11,16,27
61150,0,0,9,41,50
61151,0,0,13,16,29
61152,0,1,4,22,27
61153,0,0,0,5,5
61154,0,0,7,15,22
61155,0,0,2,10,12
61156,2,0,7,33,42
61157,0,0,1,4,5
61158,0,0,3,5,8
61159,0,0,7,14,21
61160,0,0,1,17,18
61161,0,0,2,30,32
61163,0,0,1,9,10
61164,0,1,7,18,26
61165,0,1,1,17,19
61166,0,0,2,7,9
61167,0,0,4,16,20
61168,0,1,18,31,50
61169,2,0,7,33,42
61170,0,0,10,24,34
61171,0,0,1,33,34
61173,0,0,12,25,37
61174,4,1,13,31,49
61175,0,0,8,18,26
61177,1,1,9,39,50
61178,0,1,0,5,6
61179,0,1,7,42,50
61180,0,0,9,41,50
61181,0,0,4,14,18
61182,0,0,0,17,17
61183,0,0,1,4,5
61184,0,0,6,32,38
61185,1,0,10,39,50
61186,1,0,6,29,36
61187,0,0,1,5,6
61188,2,0,4,12,18
61189,0,0,7,17,24
61190,2,0,11,37,50
61191,0,0,2,10,12
61192,0,1,7,15,23
61193,3,1,5,35,44
61194,0,1,4,26,31
61195,0,1,15,34,50
61196,0,0,1,16,17
61197,0,2,7,41,50
61198,0,0,2,30,32
61201,0,1,4,26,31
61202,0,0,13,30,43
61203,1,0,3,35,39
61204,0,1,3,10,14
61205,0,1,4,10,15
61206,0,0,2,6,8
61207,0,0,3,0,3
61208,0,0,2,11,13
61209,0,0,4,10,14
61210,0,0,2,7,9
61211,0,0,4,3,7
61212,0,0,0,2,2
61213,0,0,5,3,8
61215,0,1,3,5,9
61216,0,0,7,11,18
61217,0,0,1,24,25
61218,0,0,0,4,4
61219,0,0,0,9,9
61222,0,0,11,20,31
61223,0,0,4,14,18
61224,0,1,2,20,23
61225,0,0,4,5,9
61226,0,0,18,28,46
61227,0,0,6,36,42
61228,0,0,4,10,14
61229,0,0,12,33,45
61230,2,0,0,18,20
61231,0,1,3,8,12
61232,0,0,3,10,13
61233,0,0,4,20,24
61234,0,2,23,21,46
61235,0,1,1,10,12
61236,0,0,8,22,30
61237,0,0,2,8,10
61238,0,0,13,32,45
61239,0,0,2,16,18
61240,0,1,9,13,23
61241,0,0,2,3,5
61242,0,0,2,3,5
61243,0,0,2,7,9
61244,0,1,12,18,31
61245,0,1,10,37,48
61246,0,0,16,27,43
61247,0,0,7,15,22
61248,1,0,11,38,50
61249,0,1,8,37,46
61250,0,0,5,12,17
61251,0,1,1,4,6
61252,2,0,1,29,32
61253,0,0,4,1,5
61254,0,0,4,9,13
61256,0,0,1,6,7
61257,0,0,8,18,26
61258,1,0,5,22,28
61259,0,0,11,16,27
61260,0,0,7,22,29
61261,0,0,6,9,15
61263,0,0,0,10,10
61264,0,0,2,2,4
61265,0,0,0,8,8
61266,0,0,8,20,28
61267,0,0,7,14,21
61268,0,1,5,16,22
61269,0,0,3,3,6
61271,0,1,3,6,10
61272,0,2,3,24,29
61273,0,2,11,35,48
61274,0,1,2,9,12
61275,0,0,4,19,23
61276,0,0,15,24,39
61277,0,0,4,6,10
61278,0,1,6,29,36
61279,0,0,1,4,5
61280,0,0,9,22,31
61282,0,0,8,13,21
61283,0,1,5,18,24
61284,0,0,1,26,27
61285,0,0,5,2,7
61286,0,0,7,9,16
61287,0,0,6,9,15
61288,0,0,3,8,11
61289,0,0,1,26,27
61290,2,1,2,9,14
61291,0,0,2,3,5
61292,0,0,6,11,17
61293,0,0,6,8,14
61294,0,0,3,2,5
61295,0,2,3,32,37
61296,0,1,1,5,7
61297,0,0,9,8,17
61298,0,0,9,16,25
61299,0,0,3,7,10
61300,0,0,7,9,16
61301,0,0,8,15,23
61302,0,0,0,11,11
61303,0,0,2,10,12
61304,0,0,8,9,17
61305,0,0,3,1,4
61306,0,0,3,6,9
61307,0,0,7,24,31
61308,0,0,5,12,17
61309,0,0,3,0,3
61310,0,2,3,10,15
61311,0,0,6,17,23
61312,0,0,4,7,11
61313,0,0,4,12,16
61314,0,2,4,12,18
61315,0,0,6,13,19
61316,0,1,9,38,48
61317,0,0,11,21,32
61318,0,1,5,26,32
61319,0,0,3,8,11
61321,0,0,6,3,9
61322,0,0,9,15,24
61323,0,2,3,20,25
61324,0,0,6,19,25
61325,0,0,4,7,11
61326,0,1,16,26,43
61327,0,0,1,7,8
61328,0,0,6,21,27
61329,0,0,2,13,15
61330,0,0,8,13,21
61331,0,0,2,4,6
61332,0,0,5,15,20
61333,0,0,6,7,13
61334,0,0,4,4,8
61335,0,0,5,7,12
61336,0,0,8,8,16
61337,0,0,8,13,21
61338,0,0,9,17,26
61339,0,0,6,9,15
61340,0,0,6,5,11
61341,0,0,12,20,32
61342,0,1,6,7,14
61344,0,0,5,28,33
61345,0,0,1,9,10
61346,0,1,9,16,26
61347,0,0,2,6,8
61349,0,0,6,3,9
61350,0,0,4,6,10
61351,0,0,9,9,18
61352,0,0,4,3,7
61354,0,0,7,11,18
61355,0,1,7,10,18
61356,0,0,13,12,25
61357,0,0,3,19,22
61358,0,6,10,31,47
61359,0,0,3,4,7
61360,0,0,10,19,29
61361,0,1,2,10,13
61362,0,0,7,4,11
61363,0,0,5,10,15
61365,0,0,2,11,13
61366,0,0,3,5,8
61367,0,0,9,10,19
61368,0,0,0,5,5
61369,0,3,0,13,16
61370,0,0,7,8,15
61372,0,0,9,11,20
61373,0,0,3,8,11
61374,0,0,8,15,23
61375,0,1,19,27,47
61376,0,2,10,20,32
61377,0,0,8,2,10
61379,0,0,13,37,50
61380,0,1,6,3,10
61381,0,0,6,23,29
61382,0,0,9,6,15
61383,0,0,10,21,31
61384,0,0,16,17,33
61385,0,0,5,6,11
61386,0,0,6,6,12
61387,0,2,11,18,31
61388,0,0,2,10,12
61389,0,0,9,14,23
61390,0,0,2,7,9
61391,0,0,3,1,4
61392,0,0,4,6,10
61393,0,0,3,15,18
61394,0,0,3,5,8
61395,0,0,2,4,6
61397,0,0,6,12,18
61398,0,1,6,30,37
61400,0,0,9,15,24
61401,0,0,6,5,11
61402,0,0,1,12,13
61403,0,0,11,7,18
61404,0,0,5,9,14
61405,0,1,3,5,9
61406,0,0,6,11,17
61407,0,0,6,10,16
61408,0,1,4,18,23
61409,0,0,6,4,10
61410,0,0,2,9,11
61411,0,0,11,25,36
61412,0,0,7,7,14
61413,0,0,6,18,24
61414,0,0,1,8,9
61415,0,0,5,4,9
61416,0,2,4,8,14
61417,0,1,9,12,22
61418,0,0,11,14,25
61419,0,0,3,21,24
61420,0,0,15,16,31
61421,0,0,5,9,14
61422,0,0,4,17,21
61423,0,0,8,10,18
61424,0,0,10,27,37
61425,0,0,7,19,26
61426,0,0,8,20,28
61427,0,0,6,18,24
61428,0,0,8,16,24
61430,0,0,4,5,9
61431,0,1,12,17,30
61432,0,0,3,9,12
61433,0,0,4,12,16
61434,0,0,7,8,15
61435,1,0,2,20,23
61436,0,0,6,19,25
61437,0,0,12,13,25
61438,0,0,5,23,28
61439,0,0,10,40,50
61440,0,0,6,6,12
61441,0,0,6,9,15
61442,0,0,5,4,9
61443,0,1,4,8,13
61444,1,0,4,10,15
61445,0,0,0,4,4
61446,0,0,9,8,17
61448,0,0,4,2,6
61449,0,0,6,21,27
61450,0,0,2,25,27
61452,0,0,3,5,8
61453,0,0,2,10,12
61454,0,0,1,5,6
61455,0,0,4,7,11
61456,0,0,3,9,12
61457,0,1,13,36,50
61458,0,0,7,16,23
61459,0,0,13,17,30
61460,0,0,5,12,17
61461,0,0,6,11,17
61462,0,0,4,4,8
61463,0,0,4,7,11
61464,0,1,7,10,18
61465,0,0,1,2,3
61466,0,1,4,10,15
61467,0,2,8,16,26
61468,0,1,2,7,10
61469,0,1,9,28,38
61470,0,0,4,7,11
61471,0,0,2,8,10
61472,0,4,5,16,25
61473,0,2,4,8,14
61475,0,1,3,8,12
61476,0,0,13,11,24
61477,0,0,11,8,19
61479,0,0,8,14,22
61480,0,0,6,17,23
61481,0,0,3,10,13
61482,0,1,4,11,16
61483,0,0,3,12,15
61484,0,1,11,37,49
61485,0,0,2,2,4
61486,0,0,10,22,32
61487,0,0,12,14,26
61488,1,1,18,30,50
61489,0,0,14,20,34
61490,0,1,1,14,16
61491,0,1,3,1,5
61492,0,0,1,3,4
61493,0,1,5,5,11
61494,0,0,1,7,8
61495,0,1,8,17,26
61496,0,0,5,5,10
61497,0,1,2,12,15
61498,0,0,5,6,11
61499,0,0,6,17,23
61500,0,1,4,9,14
61501,0,0,3,6,9
61502,0,1,3,14,18
61503,0,0,4,8,12
61504,0,0,4,4,8
61505,0,1,3,4,8
61506,0,0,1,8,9
61507,0,0,6,9,15
61508,0,0,4,6,10
61509,0,0,4,4,8
61510,0,0,5,2,7
61511,0,0,5,7,12
61512,0,1,3,17,21
61513,0,0,2,7,9
61514,0,0,4,9,13
61515,0,0,6,10,16
61516,0,0,7,13,20
61517,0,0,12,19,31
61518,0,0,10,5,15
61521,1,0,4,11,16
61522,0,0,5,7,12
61523,0,1,4,4,9
61524,0,0,4,3,7
61525,0,0,5,18,23
61526,0,0,8,20,28
61527,0,0,3,2,5
61528,0,0,4,6,10
61529,0,0,12,33,45
61531,0,0,4,3,7
61532,0,0,6,18,24
61533,0,1,7,7,15
61536,0,0,5,2,7
61537,0,0,3,6,9
61538,0,0,7,0,7
61539,0,0,4,6,10
61540,0,0,4,6,10
61542,0,0,3,7,10
61543,0,0,1,4,5
61544,0,0,2,8,10
61545,0,0,4,1,5
61546,0,1,11,17,29
61547,0,0,16,18,34
61548,0,0,1,15,16
61549,0,0,6,19,25
61550,0,0,5,7,12
61551,0,0,10,10,20
61552,0,0,11,12,23
61553,0,1,6,8,15
61554,0,0,3,3,6
61555,0,0,1,7,8
61556,0,0,6,5,11
61558,0,1,14,19,34
61560,0,0,7,10,17
61563,0,0,0,2,2
61564,0,0,15,27,42
61565,0,0,6,14,20
61566,0,0,0,5,5
61567,0,0,4,3,7
61568,0,0,5,7,12
61569,0,0,3,5,8
61570,0,0,13,26,39
61571,0,1,1,14,16
61572,0,0,4,16,20
61573,0,3,13,32,48
61574,1,0,13,31,45
61575,0,0,5,3,8
61576,0,1,3,10,14
61577,1,0,6,26,33
61578,0,0,6,4,10
61579,0,0,4,14,18
61580,0,1,11,34,46
61581,0,0,3,10,13
61582,0,0,2,9,11
61583,0,0,2,3,5
61584,0,0,5,20,25
61585,0,0,3,3,6
61586,1,1,4,44,50
61587,0,0,7,14,21
61588,1,0,5,29,35
61589,0,0,4,14,18
61590,0,0,6,14,20
61591,0,1,2,12,15
61592,0,2,1,6,9
61593,0,0,10,36,46
61594,0,1,2,14,17
61595,0,0,7,32,39
61596,0,0,7,19,26
61597,0,1,1,7,9
61598,0,1,2,15,18
61599,0,0,3,13,16
61600,0,0,0,5,5
61601,0,0,8,26,34
61602,0,0,1,6,7
61603,0,2,0,10,12
61604,0,1,1,9,11
61605,0,0,6,36,42
61606,0,0,6,14,20
61607,0,0,7,20,27
61608,1,0,4,25,30
61609,0,0,13,32,45
61610,0,4,9,18,31
61611,0,0,2,3,5
61612,0,0,15,24,39
61613,0,0,13,26,39
61614,0,1,7,8,16
61615,0,0,6,11,17
61616,0,0,2,4,6
61617,0,0,9,41,50
61618,0,0,0,8,8
61619,0,3,4,25,32
61620,0,1,2,7,10
61621,0,3,13,32,48
61622,0,0,6,10,16
61623,1,2,12,35,50
61624,0,1,0,13,14
61625,0,0,4,4,8
61626,0,2,3,27,32
61627,0,0,1,4,5
61628,0,0,10,23,33
61629,0,1,4,5,10
61630,0,1,9,19,29
61631,0,0,1,9,10
61632,0,0,3,6,9
61633,0,1,5,4,10
61634,0,0,17,28,45
61635,0,0,9,19,28
61637,0,0,5,9,14
61638,0,0,2,3,5
61639,0,1,18,28,47
61640,0,0,9,15,24
61641,0,1,12,18,31
61642,0,0,9,10,19
61643,0,1,4,20,25
61644,0,1,10,37,48
61645,0,0,8,10,18
61646,0,0,11,13,24
61647,0,0,12,17,29
61648,0,1,5,11,17
61649,0,0,10,12,22
61650,0,1,14,35,50
61651,0,0,8,10,18
61652,0,0,10,29,39
61653,0,0,8,8,16
61654,0,0,6,17,23
61655,0,0,4,13,17
61656,0,0,6,12,18
61657,0,1,12,17,30
61658,0,0,4,19,23
61659,0,0,6,22,28
61660,0,0,4,36,40
61661,0,0,0,4,4
61662,0,0,13,19,32
61663,0,0,5,44,49
61664,0,0,6,10,16
61665,0,2,8,17,27
61666,0,0,13,18,31
61667,0,0,1,5,6
61668,0,1,13,36,50
61669,0,1,1,11,13
61670,0,0,4,7,11
61671,0,0,0,9,9
61672,0,0,4,21,25
61673,0,0,3,3,6
61674,0,0,8,14,22
61675,0,0,2,6,8
61676,0,0,9,29,38
61678,0,0,6,27,33
61679,0,0,2,13,15
61680,0,0,11,10,21
61681,0,0,4,29,33
61682,0,0,2,15,17
61683,0,1,3,14,18
61684,0,0,7,8,15
61685,0,0,9,15,24
61687,0,0,10,30,40
61688,0,0,15,27,42
61689,0,0,10,14,24
61690,0,0,3,5,8
61691,0,0,2,10,12
61692,0,0,0,5,5
61693,0,0,7,14,21
61694,0,1,17,24,42
61695,0,0,16,17,33
61696,0,1,12,17,30
61697,0,1,7,20,28
61698,1,0,12,34,47
61699,1,0,19,27,47
61700,0,2,3,3,8
61701,0,0,10,15,25
61702,0,0,5,13,18
61703,0,0,3,6,9
61704,0,0,2,17,19
61705,0,0,2,4,6
61706,0,0,7,16,23
61707,0,0,5,18,23
61708,0,1,3,17,21
61709,0,0,7,9,16
61710,0,0,1,11,12
61711,0,2,13,31,46
61712,0,0,7,6,13
61713,0,0,8,6,14
61714,0,0,9,13,22
61715,0,0,6,20,26
61716,0,1,4,21,26
61717,0,1,10,12,23
61718,0,1,2,8,11
61719,0,0,5,20,25
61720,0,0,18,30,48
61721,2,2,12,21,37
61725,0,0,7,16,23
61726,0,0,9,13,22
61728,0,0,2,2,4
61729,0,0,1,7,8
61730,0,0,3,2,5
61731,0,0,5,9,14
61732,0,0,1,5,6
61733,0,0,16,34,50
61734,0,1,1,14,16
61735,0,0,2,7,9
61736,0,0,4,7,11
61737,1,0,13,31,45
61738,0,0,1,17,18
61739,0,0,1,16,17
61740,0,0,3,16,19
61741,0,0,6,36,42
61742,0,0,0,13,13
61743,0,0,1,19,20
61744,0,0,2,17,19
61745,1,0,0,22,23
61746,0,0,4,16,20
61747,1,0,1,21,23
61748,0,0,6,11,17
61749,0,0,1,5,6
61750,0,0,2,12,14
61751,0,0,5,34,39
61752,0,4,9,18,31
61753,0,0,7,38,45
61754,0,0,1,3,4
61755,0,0,1,5,6
61756,0,1,12,17,30
61757,0,3,13,32,48
61758,0,0,2,4,6
61759,4,1,3,42,50
61760,1,1,4,23,29
61761,0,0,4,7,11
61762,0,0,2,16,18
61763,0,1,1,14,16
61764,0,3,13,32,48
61765,0,1,3,10,14
61766,1,0,6,29,36
61767,0,0,3,4,7
61768,0,0,3,9,12
61769,0,2,10,38,50
61770,0,0,4,4,8
61771,0,0,1,5,6
61772,0,0,8,11,19
61773,0,0,13,37,50
61774,0,1,5,44,50
61775,0,0,8,19,27
61776,0,0,1,8,9
61777,0,0,13,27,40
61778,0,1,3,14,18
61779,1,0,1,16,18
61780,0,0,13,37,50
61781,0,1,1,10,12
61782,0,0,2,19,21
61783,0,3,3,42,48
61784,0,0,4,5,9
61785,0,1,5,44,50
61786,2,3,10,30,45
61787,0,1,3,14,18
61788,0,0,6,10,16
61789,0,0,2,2,4
61790,0,0,0,19,19
61791,1,0,2,28,31
61792,1,0,5,10,16
61793,0,0,8,13,21
61794,0,0,11,19,30
61795,0,2,4,39,45
61796,0,0,3,8,11
61797,0,1,3,22,26
61798,0,0,4,11,15
61799,0,0,9,3,12
61800,0,1,5,10,16
61801,0,0,3,17,20
61802,0,0,1,2,3
61803,0,1,10,37,48
61804,1,0,12,37,50
61805,0,0,8,11,19
61806,0,0,6,17,23
61807,0,0,10,11,21
61808,0,1,13,26,40
61809,0,0,4,3,7
61810,0,2,3,32,37
61811,0,0,1,4,5
61812,0,0,5,33,38
61813,0,1,5,14,20
61814,0,0,5,5,10
61815,0,0,8,10,18
61816,0,0,4,6,10
61817,0,0,4,33,37
61818,0,0,9,11,20
61819,0,0,5,6,11
61820,0,0,2,6,8
61821,0,0,15,20,35
61822,0,1,10,39,50
61823,0,0,1,14,15
61824,0,0,14,28,42
61825,0,0,3,11,14
61826,0,0,7,9,16
61827,1,0,1,18,20
61828,0,0,11,28,39
61829,0,0,7,5,12
61831,0,0,2,10,12
61832,1,0,4,21,26
61833,0,0,18,17,35
61834,0,0,15,16,31
61835,0,4,15,19,38
61836,0,0,3,11,14
61837,0,1,17,32,50
61838,0,0,7,10,17
61839,0,0,2,28,30
61840,0,0,4,17,21
61841,0,0,6,14,20
61842,0,0,2,11,13
61843,0,0,1,11,12
61844,0,0,5,6,11
61845,0,0,2,4,6
61846,0,2,4,13,19
61847,0,0,7,11,18
61848,0,0,5,14,19
61849,1,0,6,29,36
61850,0,0,2,6,8
61851,0,1,2,3,6
61853,0,0,6,6,12
61854,1,2,1,31,35
61855,0,3,5,42,50
61856,0,0,9,6,15
61857,0,0,9,6,15
61858,4,1,2,38,45
61859,0,0,11,19,30
61860,0,1,10,38,49
61862,0,0,12,34,46
61863,0,0,8,15,23
61865,1,0,1,5,7
61866,0,0,3,17,20
61867,0,0,3,2,5
61868,0,0,6,18,24
61869,1,0,4,27,32
61870,0,1,1,4,6
61871,0,0,0,7,7
61872,1,0,0,11,12
61873,0,0,6,9,15
61874,0,0,1,7,8
61875,0,0,5,15,20
61876,0,0,3,9,12
61877,0,1,0,19,20
61878,0,0,6,3,9
61879,0,0,2,3,5
61880,0,0,2,3,5
61881,0,0,1,6,7
61883,1,0,2,27,30
61885,0,0,5,9,14
61887,0,0,0,7,7
61888,0,0,0,1,1
61889,0,1,7,9,17
61890,0,0,0,1,1
61893,0,0,11,24,35
61895,0,0,2,17,19
61900,0,0,5,6,11
61902,0,1,11,37,49
61903,0,0,13,35,48
61904,0,0,0,5,5
61906,0,2,10,38,50
61907,0,0,15,21,36
61908,0,0,1,11,12
61909,0,0,13,16,29
61910,1,0,17,27,45
61911,0,0,5,19,24
61912,0,2,17,30,49
61913,0,0,8,42,50
61914,0,2,7,41,50
61915,0,0,8,19,27
61916,0,0,7,14,21
61917,0,0,18,32,50
61918,0,0,2,6,8
61919,1,0,3,18,22
61920,0,0,6,28,34
61921,4,0,8,34,46
61922,0,0,16,34,50
61923,0,0,11,24,35
61924,0,3,3,42,48
61925,2,0,1,8,11
61926,0,0,3,2,5
61928,0,0,2,13,15
61929,0,1,7,10,18
61930,0,0,6,10,16
61931,0,0,10,40,50
61932,2,0,18,29,49
61933,2,3,10,30,45
61934,0,1,7,15,23
61935,1,0,9,29,39
61936,0,0,4,7,11
61937,0,0,11,30,41
61938,0,0,16,22,38
61939,1,0,9,37,47
61940,0,0,3,9,12
61941,0,0,10,17,27
61942,0,0,8,18,26
61943,0,0,12,34,46
61944,2,1,10,35,48
61945,0,2,11,23,36
61946,0,1,0,11,12
61947,0,0,8,7,15
61948,2,0,7,26,35
61949,0,0,12,13,25
61950,1,0,4,16,21
61951,0,0,6,31,37
61952,0,0,1,23,24
61953,0,0,11,28,39
61955,0,0,5,29,34
61956,0,0,9,19,28
61957,1,0,10,39,50
61958,0,0,2,17,19
61960,0,0,10,27,37
61961,0,0,0,16,16
61962,0,0,7,14,21
61963,0,0,10,15,25
61964,0,1,10,38,49
61965,0,0,9,38,47
61966,0,0,5,20,25
61967,0,2,9,33,44
61968,0,0,3,8,11
61969,0,1,5,22,28
61970,0,1,12,37,50
61971,0,1,6,34,41
61972,0,0,5,23,28
61973,4,0,1,8,13
61974,0,0,7,29,36
61975,1,0,7,5,13
61976,0,1,0,7,8
61977,0,0,4,7,11
61978,0,1,10,31,42
61979,0,0,3,8,11
61981,1,0,15,27,43
61982,0,0,0,5,5
61983,0,0,0,7,7
61984,0,0,5,14,19
61985,0,2,4,21,27
61986,0,0,13,16,29
61987,0,0,3,18,21
61988,0,3,0,9,12
61990,0,0,17,33,50
61991,0,0,0,1,1
61992,1,0,12,34,47
61993,0,0,4,6,10
61994,0,0,11,14,25
61995,0,0,4,18,22
61996,0,1,15,30,46
61997,0,0,10,16,26
61999,0,0,4,12,16
62000,1,0,5,7,13
62002,0,1,4,19,24
62003,0,0,15,21,36
62004,0,0,8,11,19
62005,0,0,0,5,5
62006,0,0,13,35,48
62007,0,0,1,4,5
62008,0,0,1,17,18
62009,0,0,2,4,6
62010,0,1,4,25,30
62011,0,1,12,20,33
62012,0,0,10,17,27
62013,1,1,6,20,28
62014,1,1,3,45,50
62015,1,1,4,44,50
62016,0,1,5,44,50
62017,0,0,0,5,5
62018,0,0,1,5,6
62019,2,0,1,8,11
62020,0,0,2,18,20
62021,1,0,8,41,50
62022,0,0,1,27,28
62023,1,0,9,35,45
62024,0,3,0,9,12
62025,0,1,1,9,11
62026,0,1,6,34,41
62027,5,1,1,13,20
62028,1,0,10,39,50
62029,0,1,10,39,50
62030,1,0,6,29,36
62031,1,0,5,7,13
62034,0,0,0,1,1
62035,0,0,0,5,5
62036,2,0,6,9,17
62037,0,2,4,42,48
62038,2,0,2,20,24
62039,0,2,7,41,50
62040,0,1,12,20,33
62041,0,0,3,17,20
62042,1,1,8,39,49
62044,0,0,11,30,41
62045,0,2,4,21,27
62046,0,1,8,16,25
62047,0,0,15,30,45
62048,0,0,10,24,34
62049,0,1,4,12,17
62050,0,1,12,22,35
62051,0,0,9,7,16
62052,0,1,7,40,48
62053,0,1,4,24,29
62054,1,0,8,20,29
62055,0,1,3,12,16
62056,2,1,19,28,50
62058,0,1,5,22,28
62059,0,0,2,20,22
62060,0,1,5,20,26
62061,1,0,8,30,39
62062,0,0,6,11,17
62063,0,1,6,31,38
62064,1,0,11,29,41
62065,1,0,4,7,12
62066,0,1,17,30,48
62067,0,4,1,8,13
62068,0,1,0,9,10
62069,1,1,6,37,45
62070,0,0,16,34,50
62071,1,0,6,15,22
62072,1,0,1,16,18
62073,0,0,21,29,50
62074,1,0,13,8,22
62075,0,0,1,4,5
62076,0,1,3,9,13
62077,2,1,0,15,18
62078,0,0,8,11,19
62079,0,0,8,18,26
62080,0,0,13,15,28
62081,0,0,5,16,21
62082,0,0,0,13,13
62083,0,0,1,30,31
62087,0,0,9,8,17
62088,0,0,6,17,23
62090,0,0,2,3,5
62091,0,1,9,40,50
62092,0,1,7,20,28
62093,3,0,4,25,32
62094,0,0,3,16,19
62095,0,0,2,13,15
62096,0,1,0,15,16
62097,0,0,6,9,15
62098,0,0,4,18,22
62099,0,0,8,9,17
62100,0,0,14,23,37
62101,0,1,4,3,8
62102,0,1,5,14,20
62103,0,0,8,17,25
62104,0,0,2,4,6
62106,0,0,14,36,50
62107,0,2,5,43,50
62108,1,0,5,16,22
62109,2,1,9,37,49
62110,0,2,0,13,15
62111,2,0,5,39,46
62112,0,0,5,8,13
62113,0,0,0,6,6
62114,2,0,17,30,49
62115,0,2,1,15,18
62116,2,1,8,39,50
62117,0,1,0,15,16
62118,0,0,9,17,26
62119,0,0,3,24,27
62120,1,0,10,35,46
62121,0,1,1,7,9
62122,0,0,1,4,5
62123,2,1,8,39,50
62124,6,0,1,21,28
62125,0,1,0,15,16
62126,0,0,11,24,35
62127,0,2,2,23,27
62128,0,0,16,34,50
62129,1,0,6,15,22
62130,1,0,15,31,47
62131,1,1,3,23,28
62132,0,2,5,43,50
62133,0,0,16,34,50
62134,0,0,8,17,25
62135,3,0,4,25,32
62136,0,0,2,4,6
62137,0,1,2,24,27
62138,1,0,4,13,18
62139,0,0,3,4,7
62140,0,0,4,6,10
62141,0,0,6,4,10
62142,0,0,3,6,9
62143,0,0,4,7,11
62144,0,0,4,12,16
62145,0,0,13,24,37
62146,0,0,7,10,17
62147,0,0,5,19,24
62148,1,0,7,6,14
62149,0,0,3,6,9
62150,0,0,1,6,7
62151,0,0,4,20,24
62152,0,0,7,6,13
62153,0,0,1,13,14
62154,1,2,17,23,43
62155,0,0,7,10,17
62156,1,2,8,13,24
62157,0,1,8,41,50
62158,1,1,6,31,39
62159,0,0,15,34,49
62160,0,0,3,18,21
62161,0,0,6,15,21
62162,0,0,6,13,19
62163,1,0,5,8,14
62164,0,1,6,19,26
62165,0,0,4,19,23
62166,0,2,10,15,27
62168,0,0,1,22,23
62169,0,0,3,16,19
62170,0,0,4,15,19
62171,0,0,3,12,15
62172,0,0,7,15,22
62173,0,0,0,4,4
62174,0,0,1,6,7
62175,0,0,2,25,27
62176,0,0,11,21,32
62177,0,1,7,20,28
62178,1,0,7,22,30
62179,0,0,0,9,9
62180,0,0,6,7,13
62181,0,0,1,9,10
62182,0,3,5,22,30
62183,0,0,3,13,16
62184,0,0,9,20,29
62185,0,0,4,12,16
62186,0,0,3,14,17
62187,0,0,2,3,5
62188,1,1,3,17,22
62189,0,0,1,4,5
62190,0,0,2,19,21
62191,0,2,2,31,35
62192,0,1,7,21,29
62193,0,0,2,5,7
62194,0,0,6,11,17
62195,0,0,6,3,9
62196,0,0,3,1,4
62197,0,0,9,25,34
62199,1,0,0,9,10
62200,0,0,2,10,12
62201,0,0,0,23,23
62202,0,0,4,7,11
62203,0,0,6,12,18
62204,0,2,13,35,50
62205,0,0,4,23,27
62206,0,0,2,10,12
62207,0,0,5,12,17
62208,1,1,9,16,27
62209,0,0,3,6,9
62210,0,0,6,30,36
62211,0,0,1,4,5
62212,0,0,1,2,3
62213,0,0,3,17,20
62215,0,0,9,16,25
62216,0,0,8,11,19
62217,1,0,4,19,24
62218,0,0,1,6,7
62219,0,0,11,10,21
62220,0,0,2,6,8
62221,0,0,2,3,5
62222,0,0,2,0,2
62223,0,0,4,10,14
62224,0,0,10,21,31
62225,0,0,9,14,23
62226,0,0,10,29,39
62227,0,3,22,21,46
62228,0,0,0,7,7
62229,0,0,10,28,38
62230,0,0,6,15,21
62231,0,0,9,4,13
62232,0,0,5,8,13
62233,2,1,8,39,50
62234,1,2,11,24,38
62235,0,1,11,8,20
62236,0,0,6,15,21
62237,0,0,11,11,22
62238,0,1,4,8,13
62239,0,0,4,13,17
62240,0,0,4,6,10
62241,0,0,13,28,41
62242,0,0,3,10,13
62243,0,0,7,9,16
62244,0,0,3,6,9
62245,0,0,8,22,30
62246,0,0,3,14,17
62247,0,0,3,14,17
62248,0,0,0,1,1
62249,0,1,7,17,25
62250,1,0,5,10,16
62251,0,0,7,10,17
62252,0,0,5,14,19
62253,0,0,0,8,8
62254,0,2,1,31,34
62255,0,0,7,20,27
62256,0,0,11,19,30
62257,0,0,6,14,20
62258,0,0,7,11,18
62259,0,0,7,26,33
62260,0,1,3,11,15
62261,0,0,2,7,9
62262,0,1,4,34,39
62263,0,1,5,11,17
62264,0,0,3,17,20
62265,0,0,4,11,15
62266,1,0,3,10,14
62267,0,1,10,15,26
62268,1,0,7,35,43
62269,0,0,10,9,19
62270,0,0,5,21,26
62271,0,0,3,11,14
62272,1,0,3,21,25
62273,0,0,8,15,23
62274,0,0,4,8,12
62275,0,0,10,10,20
62276,0,0,11,17,28
62277,0,0,0,16,16
62278,1,0,3,28,32
62279,0,0,7,10,17
62280,0,0,1,15,16
62281,0,0,11,19,30
62282,4,6,9,23,42
62283,0,1,6,15,22
62284,0,0,7,8,15
62285,0,2,22,15,39
62286,0,2,11,23,36
62287,0,0,5,4,9
62288,0,0,5,8,13
62289,0,0,7,7,14
62290,0,1,0,10,11
62291,0,0,1,7,8
62292,0,0,11,27,38
62293,2,2,6,40,50
62294,1,2,13,23,39
62295,1,2,17,30,50
62296,0,1,8,20,29
62297,0,0,10,7,17
62298,0,0,11,16,27
62299,0,0,11,9,20
62300,0,1,8,11,20
62301,0,1,11,12,24
62302,1,1,7,17,26
62303,0,0,9,19,28
62304,0,1,11,14,26
62305,0,0,5,6,11
62306,0,1,13,32,46
62307,0,0,2,3,5
62308,0,0,3,12,15
62310,0,1,8,7,16
62311,0,0,1,14,15
62312,0,0,9,28,37
62313,0,0,5,5,10
62314,0,0,6,15,21
62315,0,0,10,40,50
62316,0,0,3,11,14
62317,0,0,3,4,7
62318,0,0,0,5,5
62319,0,0,0,2,2
62321,0,0,1,7,8
62322,0,0,7,14,21
62323,1,0,9,10,20
62324,0,0,3,1,4
62325,0,0,5,8,13
62326,0,0,3,11,14
62327,0,2,8,8,18
62328,0,0,7,9,16
62329,0,1,0,11,12
62330,0,1,5,16,22
62331,0,0,0,7,7
62332,0,0,3,10,13
62333,0,0,0,1,1
62334,1,0,6,20,27
62335,1,1,12,21,35
62336,0,0,6,11,17
62338,1,0,3,9,13
62339,0,0,12,26,38
62340,0,0,10,24,34
62341,0,0,9,12,21
62342,0,0,0,5,5
62343,0,4,6,29,39
62344,0,1,4,13,18
62345,0,0,5,9,14
62346,0,0,9,22,31
62347,0,0,7,6,13
62348,0,0,4,5,9
62349,0,0,10,8,18
62350,0,0,5,15,20
62351,1,0,0,11,12
62352,0,0,17,26,43
62353,0,2,4,14,20
62354,0,0,3,6,9
62355,0,0,0,7,7
62356,0,0,9,10,19
62357,0,1,4,19,24
62358,0,3,10,35,48
62359,0,0,6,18,24
62360,0,0,5,7,12
62361,0,0,7,11,18
62362,0,0,5,11,16
62363,0,2,4,23,29
62364,0,1,6,38,45
62365,1,0,2,8,11
62367,0,1,3,17,21
62368,0,0,1,5,6
62369,0,0,10,35,45
62370,0,0,0,1,1
62371,0,0,5,9,14
62372,0,0,6,7,13
62373,0,0,5,3,8
62374,0,0,7,14,21
62375,0,1,9,36,46
62376,0,0,4,9,13
62378,1,0,0,7,8
62379,0,0,8,10,18
62380,0,0,2,16,18
62381,0,0,5,10,15
62382,0,0,3,7,10
62383,0,0,5,13,18
62384,1,0,7,29,37
62385,0,0,14,8,22
62386,1,2,12,25,40
62387,0,0,1,5,6
62388,0,0,1,14,15
62389,0,2,8,29,39
62390,0,0,0,10,10
62391,0,0,2,4,6
62393,0,1,4,8,13
62394,0,0,7,4,11
62395,0,0,4,8,12
62396,0,1,9,21,31
62397,0,0,1,6,7
62398,0,0,0,4,4
62399,0,0,4,6,10
62401,2,3,2,27,34
62402,0,0,1,16,17
62403,0,0,1,1,2
62404,0,0,4,6,10
62405,0,1,12,26,39
62406,1,0,7,6,14
62407,0,0,1,1,2
62408,1,0,5,27,33
62409,0,0,2,0,2
62410,0,0,8,7,15
62411,0,0,4,4,8
62412,0,0,0,6,6
62414,0,0,5,12,17
62415,0,1,8,19,28
62417,0,1,6,18,25
62418,0,0,5,11,16
62420,1,0,5,17,23
62421,0,0,8,10,18
62422,0,0,2,13,15
62423,0,0,5,3,8
62424,0,0,6,7,13
62425,0,0,1,6,7
62426,0,3,5,22,30
62427,0,0,13,21,34
62428,0,0,4,6,10
62429,0,0,3,6,9
62430,0,0,4,15,19
62431,0,0,4,12,16
62432,0,0,0,4,4
62434,0,0,5,2,7
62435,0,0,3,24,27
62436,0,0,8,16,24
62437,2,0,9,20,31
62439,0,0,2,19,21
62440,0,0,0,10,10
62442,0,0,5,5,10
62443,1,0,1,3,5
62444,0,2,11,31,44
62445,0,0,4,14,18
62446,0,1,2,24,27
62447,0,0,13,24,37
62448,0,0,11,38,49
62449,0,0,4,12,16
62450,0,0,3,2,5
62451,1,0,2,27,30
62452,0,0,7,19,26
62453,0,3,2,18,23
62454,1,1,6,37,45
62455,0,0,3,18,21
62456,0,0,2,4,6
62457,0,0,3,24,27
62458,0,0,1,4,5
62459,1,0,0,34,35
62460,2,1,2,12,17
62461,0,0,6,9,15
62462,0,0,1,6,7
62463,1,0,3,16,20
62464,0,0,1,9,10
62465,0,0,4,9,13
62466,0,1,6,32,39
62467,0,0,4,20,24
62468,0,0,9,21,30
62469,0,0,6,21,27
62470,0,0,3,12,15
62471,0,1,5,44,50
62472,0,1,15,9,25
62473,2,1,7,17,27
62474,0,1,8,41,50
62475,1,0,9,39,49
62476,0,0,16,19,35
62477,0,0,1,19,20
62478,2,0,11,37,50
62479,0,0,3,19,22
62480,0,0,2,38,40
62481,0,1,14,35,50
62482,0,2,11,31,44
62483,0,1,6,25,32
62484,0,1,6,14,21
62485,0,1,5,29,35
62486,0,0,2,11,13
62487,1,0,11,34,46
62488,0,0,5,45,50
62489,0,0,14,33,47
62490,0,0,11,38,49
62491,0,0,9,24,33
62492,0,1,15,23,39
62493,2,0,7,14,23
62494,0,2,11,30,43
62495,1,0,4,9,14
62496,0,0,13,37,50
62497,0,0,15,17,32
62498,0,1,10,37,48
62499,0,0,4,14,18
62500,0,0,13,36,49
62501,0,0,5,16,21
62502,0,0,7,25,32
62503,0,0,0,5,5
62504,0,0,7,11,18
62505,0,0,6,7,13
62506,0,0,2,13,15
62507,0,2,0,16,18
62508,0,0,9,8,17
62509,0,0,19,31,50
62510,1,0,5,20,26
62511,0,1,7,21,29
62512,1,4,8,37,50
62513,0,0,8,20,28
62514,0,0,4,16,20
62515,1,0,5,22,28
62516,1,2,9,23,35
62517,0,0,2,13,15
62518,0,0,12,19,31
62519,0,1,9,40,50
62520,0,0,8,28,36
62521,0,2,5,21,28
62522,0,0,15,24,39
62523,0,0,14,30,44
62524,2,0,11,37,50
62525,0,0,10,37,47
62526,0,0,1,5,6
62527,1,1,3,12,17
62528,1,0,11,25,37
62529,0,1,9,21,31
62530,1,0,12,33,46
62531,0,0,5,9,14
62532,0,2,10,38,50
62533,0,0,13,26,39
62534,0,0,5,22,27
62535,0,0,3,5,8
62536,0,0,10,34,44
62537,0,0,4,5,9
62538,2,0,7,14,23
62539,1,6,4,32,43
62540,0,2,3,42,47
62541,0,0,13,35,48
62543,0,1,14,24,39
62546,0,0,15,35,50
62547,0,0,7,33,40
62548,0,0,4,2,6
62549,0,0,14,36,50
62550,0,0,9,10,19
62551,1,0,4,22,27
62552,0,1,0,2,3
62553,0,0,7,12,19
62554,0,0,6,9,15
62555,1,0,8,29,38
62556,0,0,14,36,50
62557,0,0,4,11,15
62558,0,0,15,34,49
62559,0,0,9,23,32
62560,0,0,5,5,10
62561,1,0,2,13,16
62562,0,0,15,32,47
62563,0,1,6,14,21
62564,0,0,10,33,43
62565,0,0,13,21,34
62566,0,0,3,21,24
62567,1,1,4,24,30
62568,0,2,8,30,40
62569,2,0,0,2,4
62570,0,0,4,20,24
62571,0,0,3,2,5
62572,0,0,8,12,20
62573,0,1,16,30,47
62574,0,1,3,12,16
62575,0,0,10,32,42
62576,4,2,1,12,19
62577,0,1,12,6,19
62578,0,3,12,30,45
62579,1,1,14,33,49
62580,0,0,7,34,41
62581,2,0,3,19,24
62583,0,0,7,10,17
62584,0,0,8,1,9
62585,0,0,8,15,23
62586,0,0,5,15,20
62587,1,0,8,31,40
62588,0,0,8,42,50
62589,0,0,15,24,39
62590,0,0,5,16,21
62591,0,0,12,38,50
62592,0,0,16,34,50
62593,0,0,10,5,15
62594,0,0,6,44,50
62595,0,1,4,42,47
62596,0,0,7,21,28
62597,0,1,4,5,10
62598,0,0,14,10,24
62599,1,0,7,24,32
62600,1,0,7,8,16
62602,0,0,8,28,36
62603,0,0,5,20,25
62604,0,0,1,7,8
62605,1,0,1,12,14
62606,0,0,5,15,20
62607,0,0,8,6,14
62608,1,0,3,9,13
62609,0,0,15,22,37
62610,0,2,2,12,16
62611,0,0,4,12,16
62612,1,1,6,22,30
62613,0,0,6,9,15
62614,0,0,10,17,27
62615,2,0,7,17,26
62617,1,0,9,40,50
62618,0,5,10,32,47
62619,0,0,6,18,24
62620,0,2,2,22,26
62621,0,0,4,9,13
62622,0,1,9,20,30
62623,0,0,11,14,25
62624,1,0,6,12,19
62625,0,0,7,32,39
62626,0,0,5,34,39
62627,3,3,1,26,33
62628,1,0,0,5,6
62629,0,0,7,11,18
62630,0,0,3,19,22
62631,1,0,9,11,21
62632,0,1,0,9,10
62633,0,0,7,16,23
62634,0,0,5,9,14
62635,0,0,7,19,26
62636,0,0,12,21,33
62637,0,0,1,21,22
62638,0,0,2,6,8
62639,0,1,8,21,30
62640,1,0,2,2,5
62641,0,0,14,18,32
62642,1,0,4,9,14
62643,0,0,7,8,15
62644,1,0,4,20,25
62645,2,1,2,12,17
62647,0,2,5,43,50
62648,0,0,3,14,17
62649,0,0,4,46,50
62650,0,0,3,18,21
62651,0,0,1,4,5
62652,0,0,6,15,21
62653,1,0,2,27,30
62654,0,0,3,18,21
62655,1,0,7,22,30
62656,0,1,17,31,49
62657,0,1,3,17,21
62658,0,0,10,31,41
62659,13,0,3,26,42
62660,0,1,11,12,24
62661,0,0,15,35,50
62662,0,0,1,4,5
62663,0,0,2,4,6
62664,4,6,9,23,42
62665,0,0,6,14,20
62666,2,0,9,21,32
62667,1,0,5,27,33
62668,0,0,3,18,21
62669,0,0,1,19,20
62670,0,0,3,24,27
62671,1,1,6,37,45
62672,0,0,1,4,5
62673,1,0,0,34,35
62674,1,0,0,11,12
62675,0,0,1,5,6
62676,0,0,1,9,10
62677,0,3,5,22,30
62678,0,0,5,12,17
62679,1,0,4,9,14
62680,1,0,9,35,45
62681,0,0,0,21,21
62682,0,0,4,46,50
62683,0,0,5,45,50
62684,2,1,7,17,27
62685,1,1,3,17,22
62686,0,0,6,13,19
62687,0,0,7,23,30
62689,0,0,13,31,44
62690,1,0,7,35,43
62691,1,0,4,22,27
62692,1,0,15,28,44
62693,0,1,3,12,16
62694,0,0,1,8,9
62697,0,0,0,6,6
62698,0,0,0,13,13
62699,0,0,9,7,16
62700,2,0,3,19,24
62701,4,6,9,23,42
62702,0,0,3,18,21
62703,0,0,0,17,17
62704,0,0,11,38,49
62705,0,1,3,17,21
62706,0,2,5,43,50
62707,1,0,1,12,14
62708,1,2,4,37,44
62709,0,0,1,9,10
62710,1,0,3,16,20
62711,0,0,0,9,9
62712,0,1,17,31,49
62713,2,0,11,37,50
62714,0,0,3,24,27
62715,1,2,4,37,44
62716,2,0,12,36,50
62717,0,0,8,12,20
62718,0,0,0,8,8
62719,0,0,0,5,5
62720,0,0,15,35,50
62721,0,0,1,19,20
62722,1,0,0,34,35
62723,0,0,4,46,50
62724,1,0,0,34,35
62725,4,1,10,31,46
62726,0,0,1,5,6
62727,1,2,4,37,44
62728,0,0,9,22,31
62729,4,2,1,35,42
62730,0,0,7,10,17
62731,1,2,4,37,44
62732,0,2,5,43,50
62733,0,0,15,32,47
62734,0,0,3,1,4
62735,0,0,2,4,6
62736,4,2,1,35,42
62737,0,0,9,22,31
62738,2,0,9,21,32
62739,0,0,1,5,6
62740,0,0,13,36,49
62741,1,0,7,22,30
62742,0,0,4,11,15
62743,0,0,1,11,12
62744,0,0,8,9,17
62745,0,0,2,8,10
62746,0,1,2,11,14
62747,0,0,15,29,44
62748,0,0,1,19,20
62749,0,0,2,7,9
62750,0,0,3,5,8
62751,0,0,5,17,22
62752,0,1,7,10,18
62753,2,0,7,7,16
62754,1,1,10,34,46
62755,0,0,5,12,17
62756,0,1,1,12,14
62757,0,0,8,15,23
62759,0,0,16,32,48
62760,0,0,0,5,5
62761,0,0,11,16,27
62764,0,2,16,27,45
62765,0,0,2,8,10
62766,0,0,6,9,15
62767,0,0,3,7,10
62768,1,0,14,35,50
62769,0,1,7,41,49
62770,0,1,5,31,37
62771,0,0,1,4,5
62772,1,1,9,16,27
62773,1,0,1,19,21
62774,0,0,5,12,17
62775,2,0,9,18,29
62776,0,0,7,8,15
62777,0,0,7,12,19
62778,0,0,6,15,21
62779,0,2,4,24,30
62780,1,0,1,6,8
62781,0,0,8,16,24
62782,0,1,0,11,12
62783,0,0,2,4,6
62784,1,1,0,12,14
62785,0,1,8,15,24
62786,0,0,19,15,34
62787,0,0,8,4,12
62788,0,0,2,5,7
62789,0,0,5,4,9
62790,0,1,15,28,44
62791,0,0,8,22,30
62792,0,2,15,33,50
62793,0,0,4,9,13
62794,0,1,2,10,13
62795,0,1,12,13,26
62796,0,0,18,17,35
62797,0,0,3,3,6
62798,0,1,12,11,24
62799,0,0,1,10,11
62800,0,0,4,7,11
62801,0,0,4,7,11
62802,0,0,6,13,19
62803,0,0,11,9,20
62804,0,0,5,4,9
62805,1,0,5,31,37
62806,0,1,7,12,20
62807,0,1,11,20,32
62808,0,0,11,4,15
62809,2,0,7,39,48
62810,0,0,4,9,13
62811,0,3,13,33,49
62812,0,1,12,13,26
62813,3,1,5,41,50
62814,0,0,11,17,28
62815,0,0,4,6,10
62816,0,0,3,14,17
62817,0,0,10,15,25
62818,0,1,9,16,26
62819,0,0,4,4,8
62820,2,0,1,13,16
62821,0,0,4,41,45
62822,0,0,5,2,7
62823,0,1,5,7,13
62825,0,1,9,15,25
62826,0,1,8,41,50
62828,0,1,0,9,10
62829,0,0,12,13,25
62830,0,0,7,12,19
62831,0,0,2,17,19
62832,0,0,9,11,20
62833,0,0,8,6,14
62835,0,0,4,18,22
62836,0,0,6,11,17
62837,0,0,2,3,5
62838,0,1,9,37,47
62839,0,1,8,17,26
62840,0,0,12,34,46
62841,0,1,0,11,12
62842,0,0,0,9,9
62843,0,4,8,37,49
62844,0,1,8,41,50
62845,0,1,18,25,44
62846,0,0,4,11,15
62847,0,2,13,35,50
62848,0,0,7,17,24
62849,0,1,9,15,25
62850,0,0,17,27,44
62851,0,0,17,26,43
62852,0,0,7,23,30
62853,0,0,11,34,45
62854,0,1,2,21,24
62855,1,0,5,25,31
62856,0,0,13,37,50
62857,0,1,7,30,38
62858,0,0,0,3,3
62859,0,0,7,12,19
62860,0,0,9,18,27
62861,0,0,6,17,23
62862,0,0,4,12,16
62863,0,1,7,20,28
62864,0,3,2,17,22
62865,0,0,8,18,26
62866,0,0,18,23,41
62867,0,0,12,15,27
62868,0,0,4,5,9
62869,0,0,8,5,13
62870,0,0,8,10,18
62871,0,0,3,5,8
62872,1,0,1,13,15
62873,0,0,17,33,50
62874,0,0,6,15,21
62875,0,2,0,4,6
62876,0,0,17,32,49
62878,0,1,10,9,20
62879,3,1,3,14,21
62880,4,0,2,10,16
62881,3,1,3,43,50
62882,0,0,1,13,14
62883,1,0,5,35,41
62884,0,1,4,17,22
62885,0,1,0,15,16
62886,0,2,12,34,48
62887,0,0,14,35,49
62889,0,3,3,20,26
62890,0,1,9,12,22
62891,0,1,0,10,11
62892,0,0,11,17,28
62893,0,0,10,27,37
62894,0,2,1,5,8
62895,0,0,6,26,32
62896,0,0,9,15,24
62897,0,1,1,8,10
62898,0,0,0,13,13
62899,0,0,11,39,50
62900,0,0,8,13,21
62902,1,0,9,40,50
62903,0,0,7,20,27
62905,0,2,16,31,49
62906,0,0,3,6,9
62907,0,0,4,4,8
62908,0,1,2,17,20
62909,1,0,9,10,20
62910,0,1,4,22,27
62912,1,0,9,29,39
62913,0,0,1,15,16
62914,0,0,7,5,12
62915,0,0,6,12,18
62916,0,0,5,7,12
62917,0,0,5,29,34
62918,0,0,2,7,9
62919,0,1,10,26,37
62920,0,1,0,8,9
62921,0,0,4,18,22
62922,0,0,8,6,14
62923,0,0,15,29,44
62924,0,0,4,4,8
62926,1,0,5,12,18
62927,0,0,3,7,10
62928,0,0,1,15,16
62929,4,0,2,10,16
62930,0,0,5,40,45
62931,1,0,9,40,50
62932,0,2,1,5,8
62933,0,1,0,15,16
62934,0,3,3,20,26
62935,0,2,16,30,48
62937,0,1,0,15,16
62938,0,1,10,26,37
62939,0,0,16,32,48
62940,0,0,16,32,48
62941,0,0,11,16,27
62942,0,1,2,11,14
62943,0,1,10,26,37
62944,0,0,5,7,12
62945,0,0,11,39,50
62946,1,0,1,3,5
62947,0,0,5,1,6
62948,0,0,8,25,33
62949,0,0,5,8,13
62950,0,0,3,8,11
62951,0,0,4,12,16
62952,0,2,5,6,13
62953,0,0,10,19,29
62954,0,0,4,1,5
62955,0,1,11,27,39
62956,1,1,8,17,27
62957,0,3,18,29,50
62958,0,0,13,27,40
62959,0,1,19,30,50
62960,0,0,2,7,9
62961,0,0,0,6,6
62962,0,0,1,25,26
62963,0,1,10,26,37
62964,1,1,10,24,36
62965,1,0,4,28,33
62966,1,1,4,5,11
62967,0,0,13,31,44
62968,0,0,6,13,19
62969,0,1,9,15,25
62970,0,0,2,4,6
62971,0,0,1,13,14
62972,0,0,14,26,40
62973,1,1,8,21,31
62974,0,0,3,14,17
62975,0,0,1,34,35
62976,0,1,0,11,12
62977,0,2,15,23,40
62978,0,0,2,12,14
62979,0,0,9,30,39
62980,0,0,9,13,22
62981,0,0,9,4,13
62982,0,0,5,18,23
62983,0,0,4,5,9
62984,0,0,13,24,37
62985,0,0,3,20,23
62986,0,1,1,19,21
62987,0,0,4,19,23
62988,0,0,8,22,30
62989,0,0,1,5,6
62990,0,0,6,13,19
62991,0,0,7,16,23
62992,0,0,7,7,14
62993,0,1,4,34,39
62994,0,0,7,15,22
62995,0,0,5,12,17
62996,0,0,5,3,8
62997,0,0,2,19,21
62998,0,0,11,28,39
62999,0,0,1,5,6
63000,0,0,1,15,16
63001,0,0,0,23,23
63002,0,0,11,25,36
63003,0,1,4,14,19
63004,0,2,5,6,13
63005,0,0,11,26,37
63006,0,0,4,11,15
63007,0,0,5,6,11
63009,0,0,3,16,19
63010,0,0,0,7,7
63012,2,0,1,7,10
63013,0,0,12,28,40
63014,0,0,6,5,11
63015,0,0,9,19,28
63016,0,0,11,35,46
63017,0,0,0,5,5
63018,0,0,2,6,8
63019,0,1,15,27,43
63020,0,0,9,13,22
63021,0,0,4,17,21
63022,0,2,2,8,12
63023,0,0,0,6,6
63024,0,0,8,12,20
63025,0,1,6,39,46
63026,0,0,1,11,12
63027,0,0,7,4,11
63028,0,0,9,11,20
63029,0,0,2,3,5
63030,0,1,0,9,10
63032,0,0,2,5,7
63033,0,0,7,11,18
63034,0,0,9,15,24
63035,1,1,6,21,29
63036,0,0,10,19,29
63037,0,0,7,14,21
63038,0,0,10,7,17
63039,0,0,6,5,11
63041,1,0,6,12,19
63042,0,0,3,6,9
63043,0,0,4,7,11
63044,3,1,3,43,50
63045,2,1,3,19,25
63046,0,1,13,25,39
63047,0,0,0,11,11
63048,0,0,5,13,18
63049,0,0,2,16,18
63050,0,0,4,6,10
63051,0,1,7,29,37
63052,0,0,5,35,40
63053,0,2,1,22,25
63054,0,0,4,11,15
63055,0,2,9,8,19
63056,0,0,5,16,21
63057,0,0,9,12,21
63058,0,0,14,19,33
63059,0,0,11,6,17
63060,0,0,10,18,28
63062,0,0,5,5,10
63063,0,0,8,13,21
63064,0,0,5,15,20
63065,0,0,7,8,15
63066,0,0,13,29,42
63067,0,0,11,18,29
63068,0,0,10,18,28
63069,0,1,7,28,36
63070,0,0,4,12,16
63071,0,1,8,16,25
63072,0,1,7,20,28
63073,0,0,10,15,25
63074,0,1,5,38,44
63075,0,0,8,25,33
63076,0,1,9,18,28
63077,0,0,7,13,20
63078,0,1,4,9,14
63079,0,0,6,4,10
63080,0,0,8,21,29
63082,0,0,5,7,12
63083,0,0,7,30,37
63084,0,0,2,2,4
63085,0,1,10,29,40
63086,0,0,4,18,22
63087,0,0,6,17,23
63088,0,1,11,31,43
63089,0,0,11,19,30
63090,0,1,2,27,30
63091,0,1,7,13,21
63092,0,0,11,20,31
63093,0,0,6,13,19
63094,0,0,3,1,4
63095,0,0,0,1,1
63096,0,1,4,23,28
63097,0,2,4,24,30
63098,0,0,10,20,30
63099,0,0,9,11,20
63100,0,0,3,8,11
63101,0,0,4,10,14
63102,0,0,2,14,16
63105,0,0,10,26,36
63106,0,0,4,13,17
63107,0,1,14,34,49
63108,0,0,6,12,18
63109,2,0,5,19,26
63110,0,1,9,29,39
63111,0,0,9,10,19
63112,0,0,2,11,13
63113,0,0,7,18,25
63115,0,2,12,11,25
63116,0,0,10,36,46
63117,0,0,15,29,44
63118,0,0,3,5,8
63119,0,0,9,11,20
63120,0,0,7,19,26
63121,0,0,2,7,9
63122,0,0,0,1,1
63123,0,2,15,22,39
63124,0,1,3,7,11
63125,0,0,9,19,28
63126,0,0,3,10,13
63127,0,1,13,36,50
63128,0,1,18,25,44
63129,0,0,3,1,4
63130,0,1,6,12,19
63131,0,0,2,17,19
63132,0,0,2,3,5
63133,0,0,6,11,17
63134,0,0,2,18,20
63135,0,0,6,1,7
63136,0,1,6,31,38
63137,0,0,3,12,15
63138,0,0,3,3,6
63139,1,0,5,37,43
63140,1,0,12,20,33
63141,2,0,0,9,11
63142,0,0,5,7,12
63143,0,1,4,12,17
63144,0,0,3,7,10
63145,4,2,1,28,35
63146,0,0,7,4,11
63147,0,0,7,19,26
63148,0,0,6,12,18
63149,0,0,0,12,12
63150,1,0,1,12,14
63151,0,0,9,7,16
63152,0,0,7,7,14
63153,1,1,3,31,36
63154,1,0,2,17,20
63155,0,0,4,4,8
63156,0,2,7,10,19
63157,0,1,1,9,11
63158,0,0,1,5,6
63159,0,2,3,18,23
63160,0,0,6,12,18
63161,0,0,6,15,21
63162,0,0,3,4,7
63163,0,0,7,30,37
63164,0,0,4,5,9
63165,1,0,3,10,14
63166,0,0,3,11,14
63167,0,0,12,20,32
63168,0,0,1,9,10
63170,0,0,10,14,24
63173,0,0,3,5,8
63174,1,0,2,10,13
63175,0,0,4,9,13
63176,0,0,0,1,1
63177,0,0,1,6,7
63178,0,0,10,30,40
63179,0,0,3,10,13
63180,0,0,0,6,6
63181,1,1,3,11,16
63182,0,1,3,10,14
63183,0,0,6,11,17
63184,0,2,5,24,31
63185,2,2,11,30,45
63186,0,0,0,12,12
63187,1,1,8,25,35
63188,0,0,0,2,2
63190,0,0,0,7,7
63191,0,0,0,4,4
63192,0,0,0,5,5
63194,0,0,3,1,4
63197,0,0,5,12,17
63199,0,0,0,6,6
63200,0,0,4,6,10
63201,0,0,4,1,5
63202,0,0,3,3,6
63203,1,0,1,3,5
63204,0,0,5,15,20
63205,0,4,18,28,50
63206,1,1,3,11,16
63207,0,0,8,5,13
63208,3,0,4,25,32
63209,0,0,1,4,5
63210,0,1,3,21,25
63211,0,0,5,14,19
63212,0,0,4,3,7
63213,0,0,3,24,27
63214,2,1,5,13,21
63215,1,0,5,27,33
63216,0,0,2,5,7
63217,0,0,0,2,2
63218,0,0,6,7,13
63219,1,0,1,3,5
63220,0,1,5,21,27
63221,0,0,3,15,18
63222,0,0,10,20,30
63223,0,0,5,15,20
63224,0,2,2,30,34
63225,3,0,1,10,14
63227,1,0,4,18,23
63228,0,1,11,27,39
63229,0,0,2,44,46
63230,0,0,5,7,12
63231,0,0,6,12,18
63232,0,0,3,11,14
63234,0,0,10,13,23
63235,1,0,7,42,50
63236,1,0,4,28,33
63237,0,0,2,4,6
63238,0,2,2,21,25
63239,0,0,5,6,11
63240,0,1,2,14,17
63241,0,1,2,11,14
63242,0,4,18,28,50
63243,1,0,1,7,9
63244,0,0,9,22,31
63245,0,0,10,27,37
63246,0,0,10,10,20
63247,0,0,12,30,42
63248,0,0,0,9,9
63249,0,0,9,28,37
63250,0,1,10,19,30
63251,1,0,10,21,32
63252,0,1,8,41,50
63253,0,0,5,7,12
63254,0,1,0,12,13
63255,0,0,8,33,41
63256,1,0,4,19,24
63257,0,0,4,11,15
63258,1,2,8,38,49
63259,0,1,8,13,22
63260,1,0,5,24,30
63261,0,1,0,2,3
63262,0,0,5,10,15
63263,1,0,5,24,30
63264,0,1,1,14,16
63265,0,0,17,24,41
63266,0,0,9,15,24
63267,0,0,11,23,34
63268,1,0,7,13,21
63269,0,0,0,3,3
63270,0,0,0,5,5
63271,0,1,8,26,35
63272,0,0,9,16,25
63273,0,0,13,24,37
63274,1,0,6,13,20
63275,0,0,5,4,9
63276,0,1,1,26,28
63277,0,0,12,22,34
63278,0,0,5,14,19
63279,0,1,0,9,10
63280,0,0,1,9,10
63281,0,0,2,14,16
63282,0,0,15,23,38
63283,0,1,8,17,26
63284,0,0,16,34,50
63285,1,2,7,29,39
63286,0,0,1,4,5
63287,0,1,18,31,50
63288,0,0,5,7,12
63289,0,1,3,22,26
63290,0,0,12,28,40
63291,0,0,5,35,40
63292,7,0,3,39,49
63293,0,1,11,19,31
63294,0,4,5,39,48
63295,0,1,0,15,16
63296,0,0,16,26,42
63297,0,1,7,28,36
63298,1,0,3,13,17
63299,5,0,3,39,47
63300,0,0,0,7,7
63301,0,0,3,17,20
63302,0,0,12,12,24
63303,5,1,3,38,47
63304,0,1,5,22,28
63305,0,1,2,27,30
63306,0,0,4,22,26
63307,0,0,10,37,47
63308,1,0,14,34,49
63309,3,0,5,42,50
63310,0,1,2,25,28
63311,0,0,8,23,31
63312,0,0,5,30,35
63313,0,0,1,12,13
63314,1,2,12,32,47
63315,4,1,5,40,50
63316,0,0,9,18,27
63317,0,1,12,6,19
63318,0,0,9,19,28
63319,0,0,6,9,15
63320,0,0,5,22,27
63321,0,0,2,19,21
63322,0,1,1,14,16
63323,0,0,10,35,45
63324,0,0,5,10,15
63325,0,0,13,16,29
63326,0,3,8,38,49
63327,1,0,14,23,38
63328,0,0,8,8,16
63329,1,0,2,7,10
63330,0,0,5,18,23
63331,1,0,0,11,12
63332,0,1,12,37,50
63333,0,0,5,17,22
63334,0,0,8,18,26
63335,1,2,3,38,44
63336,0,0,9,12,21
63337,2,0,3,28,33
63338,3,0,2,19,24
63339,0,1,12,37,50
63340,0,2,15,25,42
63341,0,0,16,34,50
63342,0,0,18,27,45
63343,0,0,10,3,13
63344,1,1,8,16,26
63345,1,0,10,36,47
63346,1,1,12,36,50
63347,0,0,11,11,22
63348,0,1,4,25,30
63349,1,0,1,3,5
63350,0,0,3,7,10
63351,0,0,4,13,17
63352,0,0,0,7,7
63353,0,0,5,11,16
63354,0,0,1,17,18
63355,1,0,4,13,18
63356,0,0,2,1,3
63357,1,0,4,21,26
63358,0,0,4,15,19
63359,1,0,5,29,35
63362,0,0,13,9,22
63363,0,2,1,16,19
63364,1,0,1,16,18
63365,0,1,9,40,50
63367,2,0,4,30,36
63368,0,0,13,16,29
63369,0,1,6,35,42
63370,0,1,4,34,39
63371,0,0,8,16,24
63372,0,0,5,13,18
63373,0,0,10,13,23
63374,3,0,4,25,32
63376,0,0,5,5,10
63377,0,1,9,15,25
63378,0,1,1,19,21
63379,0,1,6,14,21
63380,2,0,0,9,11
63381,1,2,8,24,35
63382,0,1,0,9,10
63383,0,0,20,27,47
63384,0,1,3,21,25
63385,0,0,10,18,28
63386,1,0,6,15,22
63387,1,2,0,23,26
63388,0,1,8,16,25
63389,0,0,3,11,14
63390,2,1,2,45,50
63391,0,0,2,5,7
63392,1,1,3,11,16
63393,0,0,0,4,4
63394,0,2,5,24,31
63395,0,0,11,39,50
63396,0,0,3,24,27
63397,0,0,7,19,26
63398,1,0,1,3,5
63399,1,0,5,27,33
63400,3,0,8,22,33
63401,0,1,2,14,17
63402,1,0,7,42,50
63403,0,2,2,21,25
63404,0,0,10,40,50
63405,0,0,0,16,16
63406,2,3,4,14,23
63407,3,0,1,10,14
63410,1,0,15,27,43
63411,1,0,1,17,19
63412,0,1,2,20,23
63413,0,1,2,14,17
63414,0,1,3,22,26
63415,1,0,4,19,24
63416,0,0,4,11,15
63417,0,1,0,2,3
63418,0,0,5,10,15
63419,1,2,8,38,49
63421,0,0,0,7,7
63422,0,0,15,23,38
63423,1,1,12,36,50
63424,1,0,9,18,28
63425,0,0,1,10,11
63426,1,0,3,21,25
63427,3,0,5,42,50
63428,0,0,8,8,16
63430,0,0,5,17,22
63431,0,0,0,5,5
63432,0,1,9,40,50
63433,0,0,0,5,5
63434,0,0,4,9,13
63436,0,1,2,27,30
63437,2,0,4,30,36
63438,0,1,2,25,28
63439,0,0,1,5,6
63440,1,1,1,28,31
63441,3,1,1,21,26
63442,6,1,1,10,18
63443,0,0,2,16,18
63444,0,0,0,10,10
63445,0,0,4,14,18
63447,0,1,6,39,46
63448,0,1,1,26,28
63449,0,0,3,9,12
63450,0,0,3,24,27
63451,1,2,6,15,24
63452,0,1,12,37,50
63453,0,0,20,27,47
63455,1,2,0,23,26
63456,1,0,3,13,17
63457,3,0,5,29,37
63458,0,0,5,9,14
63459,0,0,0,7,7
63460,0,1,12,37,50
63461,1,0,6,15,22
63462,0,0,10,26,36
63463,0,2,2,21,25
63464,0,0,10,26,36
63465,0,0,10,26,36
63466,0,0,20,27,47
63467,2,1,5,13,21
63468,0,0,11,39,50
63469,0,0,1,15,16
63470,1,2,8,24,35
63471,3,0,4,25,32
63472,0,0,6,8,14
63473,0,0,7,15,22
63474,0,3,8,30,41
63475,0,1,7,7,15
63476,0,0,9,41,50
63477,0,0,10,35,45
63478,0,0,4,12,16
63479,0,0,7,11,18
63480,1,0,4,24,29
63481,0,0,4,0,4
63482,0,0,13,15,28
63483,0,1,5,14,20
63484,1,0,16,28,45
63485,0,0,7,11,18
63486,0,0,7,12,19
63487,1,0,11,30,42
63488,0,0,5,15,20
63489,0,0,4,16,20
63490,1,0,7,10,18
63491,0,0,6,19,25
63492,0,1,7,11,19
63493,0,2,0,10,12
63494,0,1,13,23,37
63495,0,0,10,28,38
63496,0,0,7,2,9
63497,1,0,5,5,11
63498,0,0,2,14,16
63500,0,1,8,41,50
63501,0,0,8,9,17
63502,0,3,8,30,41
63503,1,0,5,5,11
63504,1,0,4,24,29
63505,0,1,13,23,37
63506,0,0,5,30,35
63507,0,2,16,30,48
63508,0,1,5,14,20
63510,1,0,12,21,34
63511,0,1,7,14,22
63512,1,0,7,10,18
63513,0,1,7,11,19
63514,0,0,13,37,50
63515,0,0,11,30,41
63516,0,0,6,14,20
63517,0,0,2,16,18
63518,0,0,10,16,26
63519,0,0,2,21,23
63520,0,0,10,18,28
63521,0,0,4,17,21
63522,0,0,4,9,13
63523,0,0,7,40,47
63524,0,1,7,23,31
63525,0,1,18,22,41
63526,0,1,9,23,33
63527,0,0,10,19,29
63528,0,0,6,24,30
63529,0,0,9,18,27
63530,0,0,8,11,19
63531,0,0,0,1,1
63532,0,0,7,11,18
63533,0,0,5,5,10
63534,0,0,12,25,37
63535,0,0,7,12,19
63536,0,1,3,7,11
63537,0,0,5,10,15
63538,0,0,4,9,13
63539,0,0,2,17,19
63540,0,0,6,8,14
63541,0,0,9,16,25
63542,0,0,9,10,19
63543,0,0,4,7,11
63544,1,0,1,4,6
63545,0,0,11,13,24
63546,0,0,9,15,24
63547,0,0,3,17,20
63548,0,0,10,40,50
63549,0,0,4,6,10
63550,1,0,7,16,24
63551,0,0,8,9,17
63552,0,0,11,3,14
63553,0,0,7,9,16
63554,0,0,2,6,8
63555,1,0,15,34,50
63556,0,1,7,10,18
63557,0,0,14,19,33
63558,0,0,3,31,34
63559,0,0,0,5,5
63560,0,0,0,1,1
63561,0,0,5,2,7
63562,0,0,1,8,9
63563,0,0,3,16,19
63564,0,0,10,19,29
63565,0,0,4,3,7
63566,0,0,12,15,27
63567,0,0,11,25,36
63568,1,1,4,17,23
63569,0,0,8,8,16
63571,0,1,9,29,39
63572,0,0,3,12,15
63573,1,0,0,7,8
63574,0,0,1,15,16
63575,0,1,7,40,48
63576,0,0,0,8,8
63577,0,1,1,19,21
63578,0,0,4,26,30
63579,0,0,9,23,32
63580,0,0,14,29,43
63581,0,0,2,12,14
63582,0,0,2,10,12
63583,0,1,9,20,30
63584,0,0,4,3,7
63585,0,0,2,7,9
63586,0,0,1,9,10
63587,0,0,0,5,5
63588,0,0,5,11,16
63589,0,0,6,8,14
63590,0,0,8,12,20
63591,0,0,1,11,12
63592,0,0,3,10,13
63593,0,0,0,12,12
63594,0,0,9,21,30
63595,0,0,5,26,31
63596,0,0,2,10,12
63597,0,0,4,16,20
63598,0,0,5,8,13
63599,0,0,6,16,22
63600,0,0,2,3,5
63601,0,0,12,21,33
63602,1,0,5,27,33
63603,0,3,3,4,10
63606,0,0,2,3,5
63607,1,0,5,4,10
63608,0,0,0,10,10
63610,0,0,4,9,13
63611,0,0,5,8,13
63612,0,0,4,8,12
63613,0,0,10,20,30
63614,1,0,3,7,11
63615,0,0,1,15,16
63616,0,0,6,10,16
63617,0,0,5,8,13
63618,0,0,5,15,20
63619,0,1,1,5,7
63620,0,0,7,10,17
63621,0,1,0,9,10
63622,0,0,4,9,13
63623,0,0,0,5,5
63624,0,0,3,22,25
63625,0,0,8,23,31
63626,0,0,13,37,50
63627,0,0,0,5,5
63628,0,0,7,8,15
63629,0,0,0,9,9
63631,0,0,3,6,9
63632,1,0,12,32,45
63633,0,0,11,29,40
63634,0,0,12,38,50
63635,1,0,7,14,22
63636,0,0,2,16,18
63637,0,0,11,28,39
63638,0,0,3,22,25
63639,0,0,11,30,41
63640,0,0,4,13,17
63641,0,1,4,6,11
63642,0,0,9,16,25
63643,0,0,9,18,27
63644,0,0,9,13,22
63645,0,0,12,22,34
63646,1,0,9,13,23
63647,1,0,7,13,21
63648,0,0,11,23,34
63649,0,1,0,9,10
63650,0,0,12,13,25
63651,0,0,6,8,14
63652,0,0,1,13,14
63653,0,1,6,31,38
63654,1,0,12,29,42
63655,0,0,5,18,23
63656,0,0,7,10,17
63658,0,0,4,12,16
63659,0,0,3,9,12
63660,0,0,6,10,16
63661,0,0,10,34,44
63662,1,0,8,28,37
63663,0,1,1,13,15
63664,0,0,17,24,41
63665,1,0,6,21,28
63666,0,0,2,4,6
63667,0,0,5,8,13
63668,0,0,5,17,22
63669,0,0,6,13,19
63670,0,0,4,8,12
63671,2,1,1,14,18
63672,0,0,1,4,5
63673,0,0,5,9,14
63674,0,1,13,31,45
63675,0,0,12,22,34
63676,0,0,6,9,15
63677,0,0,8,18,26
63679,0,5,16,29,50
63680,0,4,11,35,50
63681,0,0,12,17,29
63682,0,0,2,7,9
63683,1,0,3,40,44
63684,0,0,6,24,30
63685,3,0,8,33,44
63686,0,0,5,9,14
63687,1,1,7,26,35
63688,0,0,8,10,18
63689,2,0,2,13,17
63690,0,0,5,11,16
63691,0,4,0,21,25
63692,0,0,3,11,14
63693,0,0,7,8,15
63694,1,1,2,5,9
63695,0,0,0,1,1
63696,0,2,1,13,16
63697,0,0,2,3,5
63698,0,0,5,15,20
63701,0,0,1,15,16
63702,0,0,2,7,9
63703,0,1,1,5,7
63704,0,1,7,10,18
63705,1,0,6,15,22
63706,1,1,4,17,23
63707,0,0,11,25,36
63708,0,0,0,5,5
63709,0,0,4,9,13
63710,0,0,0,5,5
63711,1,0,0,1,2
63712,0,0,5,12,17
63713,0,1,13,19,33
63714,2,0,5,12,19
63715,0,0,14,28,42
63716,0,0,0,9,9
63717,0,0,4,9,13
63718,0,0,3,9,12
63719,0,1,2,12,15
63721,0,2,16,20,38
63722,0,0,11,39,50
63723,1,1,2,5,9
63724,0,0,0,5,5
63725,1,0,6,15,22
63726,2,1,1,14,18
63727,0,0,4,9,13
63728,0,0,5,11,16
63729,0,1,7,16,24
63730,0,0,9,5,14
63731,0,2,2,12,16
63732,0,1,6,4,11
63733,0,0,4,29,33
63734,0,0,8,16,24
63735,0,0,10,17,27
63736,0,0,5,22,27
63737,0,0,10,10,20
63738,0,0,2,4,6
63739,0,0,4,6,10
63740,1,0,4,31,36
63741,0,0,3,13,16
63742,0,0,6,12,18
63743,1,3,9,21,34
63744,0,1,11,15,27
63745,0,0,4,4,8
63746,0,0,2,22,24
63747,0,0,10,15,25
63748,0,0,6,7,13
63749,0,0,5,17,22
63750,1,2,4,35,42
63751,0,0,5,12,17
63752,0,2,5,2,9
63753,0,1,6,38,45
63754,0,0,10,16,26
63755,0,0,6,17,23
63756,0,1,7,5,13
63757,0,1,12,13,26
63758,0,0,4,6,10
63759,0,0,7,11,18
63760,0,0,4,8,12
63761,1,0,10,28,39
63762,0,0,9,9,18
63763,0,0,2,9,11
63764,0,0,7,13,20
63765,0,0,7,9,16
63767,0,1,7,16,24
63770,0,0,8,16,24
63771,1,1,10,38,50
63772,1,0,4,28,33
63773,0,1,10,18,29
63774,0,1,7,7,15
63775,0,1,3,13,17
63776,0,0,14,36,50
63777,0,0,4,3,7
63778,0,1,3,9,13
63779,0,1,0,15,16
63780,1,0,3,10,14
63781,0,0,8,6,14
63782,0,0,2,4,6
63783,0,0,3,4,7
63784,0,0,2,25,27
63785,0,0,10,15,25
63786,0,0,7,12,19
63787,0,0,10,16,26
63788,0,0,3,6,9
63789,0,0,3,8,11
63790,0,0,6,10,16
63791,0,0,15,16,31
63792,0,1,5,9,15
63793,0,0,13,37,50
63794,0,1,7,7,15
63795,2,1,3,25,31
63796,0,1,0,19,20
63797,1,1,6,14,22
63798,0,0,4,3,7
63799,0,1,10,36,47
63800,0,0,9,20,29
63801,0,0,5,10,15
63802,1,0,9,22,32
63803,0,0,13,37,50
63804,0,1,11,14,26
63805,0,0,15,24,39
63807,0,1,5,35,41
63808,0,0,16,28,44
63809,0,1,3,28,32
63810,0,0,16,28,44
63811,0,0,8,23,31
63812,0,0,4,8,12
63813,0,0,15,32,47
63814,0,1,7,8,16
63815,0,1,7,6,14
63816,0,1,8,9,18
63817,0,1,7,14,22
63818,0,0,5,6,11
63819,0,0,7,15,22
63820,0,0,3,32,35
63821,0,0,15,33,48
63822,0,0,14,18,32
63823,0,1,11,11,23
63824,0,0,6,10,16
63825,0,0,8,18,26
63826,0,0,7,9,16
63827,2,1,3,25,31
63828,0,1,0,19,20
63829,0,0,18,29,47
63830,0,1,7,7,15
63831,0,0,0,2,2
63832,0,0,3,5,8
63833,0,0,3,8,11
63834,0,2,16,31,49
63835,0,1,6,35,42
63836,0,0,1,19,20
63837,0,0,1,21,22
63838,0,0,0,2,2
63839,0,1,11,11,23
63840,0,1,5,35,41
63841,0,0,5,14,19
63842,0,1,10,38,49
63843,0,0,5,4,9
63845,0,0,4,6,10
63846,0,0,10,13,23
63847,0,2,1,8,11
63848,0,1,9,26,36
63849,0,0,6,21,27
63850,0,0,12,31,43
63851,0,0,6,42,48
63852,0,0,8,13,21
63853,0,0,15,14,29
63854,0,1,5,16,22
63855,1,1,1,7,10
63856,0,0,4,1,5
63857,0,0,17,18,35
63858,0,0,7,6,13
63859,0,0,3,11,14
63860,0,0,4,13,17
63861,0,0,7,10,17
63862,0,0,8,11,19
63863,0,0,7,9,16
63864,0,3,6,7,16
63865,0,0,5,4,9
63866,0,0,5,4,9
63867,0,0,9,15,24
63868,0,0,2,6,8
63869,0,0,9,27,36
63870,0,0,4,4,8
63871,0,0,7,26,33
63872,0,0,4,6,10
63873,0,1,12,16,29
63874,0,0,6,4,10
63875,0,0,11,15,26
63876,0,0,8,16,24
63877,0,0,0,6,6
63878,0,0,1,9,10
63879,0,1,2,9,12
63880,0,0,5,9,14
63881,0,0,12,12,24
63882,0,2,10,15,27
63883,0,0,5,12,17
63884,0,0,5,11,16
63885,1,0,2,22,25
63886,0,0,5,3,8
63887,0,0,0,5,5
63888,0,0,10,20,30
63889,0,1,10,24,35
63890,0,2,9,17,28
63893,0,0,1,5,6
63894,0,0,9,28,37
63895,0,0,8,21,29
63896,0,0,0,5,5
63897,0,0,10,32,42
63898,0,1,8,7,16
63899,0,0,9,10,19
63900,0,0,2,9,11
63901,0,0,12,8,20
63902,0,1,7,20,28
63903,0,0,3,5,8
63904,0,0,6,5,11
63905,0,0,8,11,19
63906,0,1,13,22,36
63907,0,0,11,7,18
63908,0,0,8,8,16
63909,1,0,6,39,46
63910,0,0,9,16,25
63911,0,0,4,2,6
63912,0,1,10,6,17
63914,0,1,12,20,33
63915,0,0,2,10,12
63916,0,0,3,2,5
63917,0,0,1,4,5
63918,0,0,15,26,41
63919,0,0,6,12,18
63920,0,0,10,13,23
63921,0,0,4,10,14
63922,0,0,14,16,30
63924,0,1,0,5,6
63925,0,0,3,10,13
63926,0,0,1,8,9
63927,0,0,0,7,7
63928,0,0,0,5,5
63929,0,0,9,11,20
63930,0,0,0,14,14
63931,0,1,4,44,49
63932,0,2,2,14,18
63933,0,0,8,11,19
63934,0,0,4,8,12
63935,0,0,10,13,23
63936,0,0,8,12,20
63937,0,1,0,10,11
63939,0,0,10,15,25
63940,0,0,3,28,31
63941,0,0,2,8,10
63942,0,0,3,12,15
63943,0,0,1,8,9
63945,0,0,0,2,2
63946,0,1,8,15,24
63947,0,1,0,5,6
63948,0,0,5,16,21
63949,1,0,8,11,20
63950,0,0,5,8,13
63952,0,1,10,38,49
63953,0,0,3,5,8
63954,1,0,1,21,23
63955,0,5,3,26,34
63956,0,0,5,8,13
63957,0,0,5,9,14
63958,0,0,1,3,4
63959,1,1,1,44,47
63960,0,0,8,9,17
63961,0,0,9,14,23
63962,0,0,21,29,50
63963,1,1,10,33,45
63964,0,0,0,5,5
63965,0,1,16,26,43
63966,0,0,4,11,15
63967,0,0,8,11,19
63968,1,0,6,42,49
63969,0,1,8,15,24
63970,1,0,4,25,30
63971,0,0,9,20,29
63972,0,1,10,38,49
63973,0,0,7,21,28
63974,0,0,2,11,13
63975,1,0,8,11,20
63976,0,0,3,9,12
63977,0,1,7,16,24
63978,0,0,2,12,14
63979,0,0,5,8,13
63980,0,0,1,6,7
63981,0,0,11,24,35
63982,0,1,14,16,31
63983,0,1,12,36,49
63984,0,0,9,10,19
63985,0,1,9,36,46
63987,0,4,6,19,29
63988,0,0,10,10,20
63989,2,1,8,33,44
63990,1,0,12,37,50
63991,0,0,3,6,9
63993,1,0,1,12,14
63994,0,0,5,20,25
63996,1,0,12,5,18
63997,0,0,8,25,33
63998,1,0,3,16,20
63999,0,0,9,19,28
64000,0,0,2,4,6
64001,0,0,2,14,16
64002,0,0,2,12,14
64003,0,0,1,7,8
64004,0,1,14,35,50
64005,0,0,11,36,47
64006,0,0,14,27,41
64007,0,0,18,31,49
64008,0,1,3,26,30
64009,0,0,9,29,38
64010,0,0,5,9,14
64012,1,0,1,21,23
64013,0,0,0,2,2
64014,0,5,3,26,34
64015,0,1,10,38,49
64016,1,1,8,40,50
64017,0,0,3,5,8
64018,0,0,1,3,4
64019,0,0,0,14,14
64020,2,0,10,38,50
64021,1,1,8,40,50
64022,0,0,2,11,13
64023,0,0,0,15,15
64024,0,0,11,21,32
64025,0,0,3,9,12
64027,0,0,0,14,14
64028,0,0,0,2,2
64029,0,3,6,7,16
64030,1,1,1,44,47
64031,0,0,3,28,31
64032,0,1,14,35,50
64034,0,0,1,12,13
64035,0,1,8,15,24
64036,1,1,8,40,50
64037,0,1,3,26,30
64038,0,0,8,4,12
64039,0,0,3,3,6
64040,0,1,10,30,41
64041,0,0,2,11,13
64042,1,1,8,14,24
64043,0,0,5,15,20
64044,0,2,11,26,39
64047,0,0,3,2,5
64048,0,0,2,8,10
64049,0,1,6,7,14
64050,0,0,7,21,28
64051,0,0,7,9,16
64052,0,0,1,4,5
64053,0,1,2,6,9
64054,0,2,6,4,12
64055,0,0,4,12,16
64056,0,3,7,15,25
64057,0,0,1,5,6
64058,0,0,3,7,10
64060,2,0,8,12,22
64062,1,0,7,25,33
64063,2,1,3,25,31
64064,0,0,0,9,9
64065,0,3,11,5,19
64067,0,0,0,5,5
64069,0,0,3,4,7
64070,0,0,1,4,5
64071,0,0,3,9,12
64072,0,0,3,0,3
64073,0,0,10,17,27
64074,0,0,2,12,14
64075,1,1,3,4,9
64076,0,0,11,4,15
64077,0,0,7,5,12
64080,1,0,13,34,48
64081,0,0,18,18,36
64082,1,0,10,39,50
64083,3,0,4,15,22
64084,0,0,8,7,15
64085,0,0,0,1,1
64086,0,0,3,11,14
64087,0,0,7,11,18
64088,0,0,3,16,19
64089,0,0,18,30,48
64090,2,0,3,18,23
64091,0,0,3,9,12
64092,1,10,4,35,50
64093,0,0,4,4,8
64094,0,0,4,18,22
64095,0,0,3,2,5
64096,0,0,2,6,8
64097,0,2,12,27,41
64098,0,0,0,6,6
64100,0,1,6,17,24
64101,0,0,2,15,17
64102,0,0,11,10,21
64103,0,1,10,35,46
64104,0,0,0,7,7
64105,0,0,14,24,38
64106,0,2,6,10,18
64108,0,0,7,12,19
64109,0,2,2,14,18
64110,0,3,6,16,25
64111,0,1,16,20,37
64112,0,0,14,24,38
64114,3,0,3,25,31
64115,0,0,7,21,28
64116,0,0,4,4,8
64117,0,0,15,35,50
64118,0,1,21,21,43
64119,1,0,13,34,48
64120,3,0,4,15,22
64121,0,1,3,14,18
64122,0,1,6,17,24
64123,0,1,10,35,46
64124,1,4,7,19,31
64125,0,0,1,6,7
64126,0,0,0,7,7
64127,0,0,0,9,9
64128,0,0,10,26,36
64130,0,1,21,21,43
64131,0,1,16,20,37
64132,0,2,6,10,18
64133,0,0,10,26,36
64134,0,0,7,12,19
64136,1,0,7,20,28
64137,0,0,5,11,16
64138,1,0,2,13,16
64139,0,0,3,8,11
64140,0,1,8,21,30
64141,0,0,7,26,33
64142,0,0,6,15,21
64143,0,3,3,14,20
64144,0,0,4,4,8
64145,0,0,7,12,19
64146,0,0,5,10,15
64147,0,0,9,18,27
64148,0,0,10,11,21
64149,0,0,3,23,26
64150,0,0,1,1,2
64151,0,0,4,10,14
64152,0,0,4,6,10
64153,0,0,15,25,40
64154,0,0,1,4,5
64155,0,2,10,21,33
64156,0,0,5,4,9
64157,0,0,7,17,24
64158,0,0,7,22,29
64159,0,0,8,13,21
64160,0,0,2,6,8
64161,0,0,5,10,15
64162,0,0,9,17,26
64164,0,0,3,5,8
64165,0,3,7,28,38
64166,0,1,17,18,36
64167,0,0,7,12,19
64168,0,1,5,5,11
64169,0,0,3,17,20
64170,0,1,17,18,36
64171,0,0,8,7,15
64172,0,0,3,16,19
64173,0,0,2,6,8
64174,0,1,4,3,8
64175,0,0,9,21,30
64176,2,0,15,32,49
64178,0,0,4,8,12
64179,0,0,5,2,7
64180,0,0,12,35,47
64181,0,0,16,31,47
64182,0,0,6,18,24
64183,0,0,5,32,37
64184,0,1,13,16,30
64185,1,1,5,18,25
64186,3,0,16,31,50
64187,0,0,7,8,15
64188,0,1,20,26,47
64189,0,0,2,7,9
64190,0,0,14,23,37
64191,0,0,7,19,26
64192,1,0,2,2,5
64193,0,0,1,4,5
64194,0,7,1,10,18
64196,0,0,2,6,8
64197,0,0,3,5,8
64198,0,0,2,5,7
64199,0,1,20,26,47
64200,0,0,12,12,24
64201,0,1,5,9,15
64202,0,0,7,17,24
64203,0,0,0,4,4
64204,0,0,3,2,5
64205,0,0,7,12,19
64206,0,0,7,12,19
64207,0,0,1,4,5
64208,0,0,5,8,13
64209,0,0,13,19,32
64210,0,0,8,10,18
64211,0,0,10,40,50
64212,0,0,2,2,4
64213,0,0,6,15,21
64214,0,0,4,7,11
64215,0,0,3,2,5
64216,0,0,11,30,41
64217,0,0,4,19,23
64218,0,0,20,24,44
64219,0,1,5,17,23
64220,0,0,3,2,5
64221,0,0,1,4,5
64222,0,0,0,1,1
64223,0,1,15,34,50
64224,0,0,4,9,13
64225,0,0,10,27,37
64226,0,0,7,6,13
64227,0,1,9,14,24
64228,0,0,10,21,31
64229,0,0,17,25,42
64230,0,0,5,9,14
64231,0,0,1,5,6
64232,0,1,13,21,35
64233,0,0,5,9,14
64234,0,0,4,0,4
64235,0,1,3,16,20
64236,0,2,9,15,26
64237,0,1,6,9,16
64238,0,1,7,13,21
64239,0,3,4,7,14
64240,0,0,8,10,18
64241,0,0,14,27,41
64242,0,2,8,4,14
64243,0,1,5,17,23
64244,0,0,9,11,20
64245,0,0,5,3,8
64247,0,0,3,6,9
64248,0,5,10,28,43
64249,0,2,6,10,18
64250,0,0,2,8,10
64251,0,1,7,8,16
64252,0,0,7,5,12
64253,0,0,7,7,14
64255,0,0,5,2,7
64257,0,4,4,7,15
64258,0,0,5,8,13
64259,0,0,6,13,19
64260,0,0,0,1,1
64261,0,0,3,3,6
64262,0,0,6,4,10
64263,0,0,5,12,17
64264,0,2,6,10,18
64265,0,2,4,9,15
64266,0,0,1,4,5
64267,0,0,7,8,15
64268,0,0,6,5,11
64269,0,0,6,13,19
64270,0,0,5,8,13
64271,1,0,7,25,33
64273,0,0,8,7,15
64274,0,1,6,17,24
64275,0,0,2,16,18
64277,0,0,9,24,33
64278,0,0,9,14,23
64279,0,0,1,5,6
64280,0,0,3,8,11
64281,0,0,3,3,6
64282,0,4,4,7,15
64283,0,0,4,4,8
64284,1,1,10,13,25
64285,0,0,0,1,1
64286,0,0,14,9,23
64287,0,0,6,5,11
64288,0,0,12,8,20
64289,1,0,7,15,23
64290,0,1,7,13,21
64291,0,0,1,7,8
64292,0,0,4,2,6
64294,1,0,6,11,18
64295,0,3,2,3,8
64296,0,1,3,4,8
64297,0,0,5,3,8
64298,0,0,0,1,1
64299,0,0,6,5,11
64300,0,0,7,14,21
64301,0,0,0,1,1
64302,0,0,0,10,10
64303,0,0,4,11,15
64304,0,1,16,20,37
64305,0,0,7,12,19
64306,0,0,8,11,19
64307,0,0,1,6,7
64308,0,0,0,5,5
64309,4,1,7,38,50
64310,0,0,0,13,13
64311,0,0,0,2,2
64312,3,0,4,15,22
64313,0,0,0,5,5
64314,0,3,17,17,37
64315,0,0,1,4,5
64316,0,0,0,1,1
64317,0,0,0,10,10
64318,0,0,8,21,29
64319,2,0,3,18,23
64320,1,2,10,33,46
64321,0,0,4,18,22
64322,0,0,3,6,9
64323,0,0,2,4,6
64324,0,0,3,9,12
64325,0,0,18,30,48
64326,0,2,9,18,29
64327,0,0,1,12,13
64328,0,0,2,2,4
64329,0,0,7,21,28
64330,0,0,0,7,7
64331,2,0,8,12,22
64332,0,0,1,7,8
64333,0,0,9,22,31
64334,10,3,3,32,48
64335,0,0,4,4,8
64336,1,0,0,12,13
64337,0,0,14,16,30
64338,0,0,11,37,48
64339,0,0,10,13,23
64340,0,2,3,10,15
64341,0,0,7,9,16
64342,0,0,12,14,26
64343,5,0,6,31,42
64344,0,0,7,22,29
64345,0,0,7,19,26
64346,0,0,15,35,50
64347,0,0,6,22,28
64348,0,0,4,24,28
64349,2,0,8,28,38
64350,0,0,14,24,38
64351,2,0,11,29,42
64352,0,0,8,28,36
64353,0,1,14,26,41
64354,0,1,2,7,10
64355,1,0,6,18,25
64356,1,0,16,33,50
64357,0,2,7,15,24
64358,0,0,3,7,10
64359,0,0,4,2,6
64360,0,0,7,21,28
64361,0,0,12,15,27
64362,3,1,7,39,50
64363,0,0,15,27,42
64364,0,0,12,17,29
64365,0,0,6,6,12
64366,0,0,6,10,16
64367,0,0,7,18,25
64368,0,0,12,15,27
64369,0,0,2,3,5
64370,0,0,1,12,13
64371,0,3,5,15,23
64372,3,5,3,22,33
64373,0,0,3,22,25
64374,0,0,3,5,8
64375,0,3,14,33,50
64376,0,1,5,17,23
64377,0,0,4,4,8
64379,0,0,2,2,4
64380,10,3,3,32,48
64381,0,1,18,31,50
64382,0,0,5,12,17
64383,0,0,2,10,12
64384,1,1,9,30,41
64385,3,0,3,15,21
64386,0,0,0,6,6
64388,1,2,10,33,46
64389,0,1,10,31,42
64390,4,1,7,38,50
64391,0,0,16,34,50
64392,0,0,14,10,24
64393,0,2,13,30,45
64394,0,1,10,22,33
64395,0,0,11,20,31
64396,0,0,7,21,28
64397,0,0,14,23,37
64398,0,0,2,2,4
64399,0,1,6,9,16
64400,0,0,17,27,44
64401,2,0,3,18,23
64402,0,0,20,27,47
64403,2,0,2,26,30
64404,0,0,16,34,50
64405,0,0,9,4,13
64406,1,4,7,19,31
64407,0,0,4,18,22
64408,0,0,0,1,1
64411,0,0,1,7,8
64412,0,0,6,18,24
64413,0,0,14,16,30
64414,0,5,7,22,34
64415,0,1,6,17,24
64416,0,0,1,7,8
64417,0,0,0,7,7
64419,0,0,8,15,23
64420,0,0,8,9,17
64421,0,1,12,28,41
64422,0,0,9,14,23
64423,0,0,11,16,27
64424,1,0,2,13,16
64425,0,0,8,2,10
64426,0,0,9,25,34
64428,0,0,11,33,44
64429,0,0,5,16,21
64430,0,0,9,15,24
64431,0,4,8,36,48
64432,0,0,11,6,17
64433,0,0,5,4,9
64434,0,1,6,8,15
64436,0,0,4,9,13
64437,0,0,3,2,5
64438,0,0,6,15,21
64439,0,1,0,10,11
64440,0,0,3,8,11
64441,0,0,12,4,16
64442,0,0,5,11,16
64443,0,2,15,33,50
64444,0,0,11,8,19
64445,0,0,9,8,17
64446,0,0,1,6,7
64447,0,1,8,10,19
64448,0,0,4,1,5
64449,0,3,10,20,33
64450,0,0,9,12,21
64451,0,0,12,20,32
64452,1,2,16,31,50
64453,0,0,5,1,6
64454,0,0,13,32,45
64455,0,0,14,9,23
64456,0,0,8,8,16
64457,0,0,4,4,8
64458,0,0,3,9,12
64459,0,0,9,13,22
64460,0,0,7,8,15
64461,0,0,9,7,16
64463,0,0,10,7,17
64464,0,1,7,15,23
64466,0,0,7,10,17
64467,0,0,7,5,12
64468,0,0,3,12,15
64469,0,0,4,16,20
64470,0,0,8,20,28
64472,0,0,13,20,33
64473,0,0,10,13,23
64474,0,0,8,15,23
64475,0,0,4,5,9
64476,0,0,9,14,23
64477,0,1,7,27,35
64478,0,0,4,10,14
64479,0,0,16,21,37
64480,0,0,8,2,10
64481,0,1,8,30,39
64482,0,0,5,4,9
64483,0,0,2,7,9
64484,0,0,5,9,14
64485,0,0,6,13,19
64486,0,0,2,3,5
64487,0,0,3,8,11
64488,0,0,7,6,13
64489,0,0,1,7,8
64490,0,0,6,11,17
64491,0,0,6,6,12
64492,0,0,8,5,13
64493,0,0,22,27,49
64494,0,0,13,37,50
64495,0,0,3,10,13
64496,0,0,2,4,6
64497,0,0,5,4,9
64498,0,1,1,18,20
64499,0,1,8,15,24
64500,0,0,7,19,26
64501,0,0,3,9,12
64502,0,0,11,13,24
64503,0,0,2,2,4
64504,0,0,4,4,8
64506,0,1,6,16,23
64507,0,0,6,7,13
64508,0,0,2,3,5
64509,1,0,3,15,19
64510,1,0,12,22,35
64511,0,2,11,8,21
64512,0,0,10,26,36
64513,0,0,4,14,18
64514,0,0,5,14,19
64515,0,2,12,27,41
64517,1,0,0,34,35
64518,0,0,5,3,8
64519,0,0,2,9,11
64520,0,1,7,5,13
64521,0,0,4,4,8
64522,0,0,4,13,17
64523,0,1,16,31,48
64524,0,1,8,10,19
64525,0,1,9,5,15
64527,0,1,5,14,20
64529,0,0,2,6,8
64530,1,0,4,9,14
64531,0,0,9,33,42
64532,0,0,11,23,34
64533,0,0,3,8,11
64534,0,0,3,13,16
64535,0,1,11,19,31
64536,0,0,11,16,27
64537,0,0,12,24,36
64538,0,0,0,1,1
64540,0,2,2,14,18
64541,0,0,1,4,5
64542,0,0,11,13,24
64543,1,0,13,34,48
64544,0,0,18,30,48
64545,0,2,3,18,23
64546,2,1,6,18,27
64547,0,1,3,7,11
64549,0,1,6,9,16
64550,0,0,7,21,28
64551,0,0,10,32,42
64552,0,0,1,13,14
64554,0,0,5,11,16
64556,0,0,3,32,35
64557,0,3,7,15,25
64558,0,0,8,20,28
64559,0,1,7,13,21
64560,0,3,6,16,25
64561,0,0,14,16,30
64562,0,0,4,12,16
64563,0,0,0,7,7
64564,0,0,3,6,9
64565,0,3,2,10,15
64567,0,0,8,21,29
64568,0,0,8,18,26
64569,0,0,15,30,45
64570,1,0,10,19,30
64571,0,0,8,17,25
64572,0,0,10,13,23
64573,0,0,7,10,17
64574,0,0,13,23,36
64575,0,0,12,27,39
64576,0,0,5,24,29
64577,0,0,1,9,10
64578,0,0,7,9,16
64579,0,0,13,16,29
64580,0,0,6,4,10
64581,1,0,10,13,24
64582,0,1,5,14,20
64583,0,1,0,23,24
64584,0,1,12,31,44
64585,0,1,15,34,50
64586,0,0,7,28,35
64588,0,1,16,29,46
64589,0,0,9,31,40
64590,0,0,9,6,15
64591,0,0,1,5,6
64592,0,0,11,22,33
64593,0,0,22,25,47
64594,0,0,3,13,16
64595,0,1,9,17,27
64596,0,0,8,16,24
64597,0,0,5,6,11
64598,0,0,1,4,5
64599,0,0,9,33,42
64600,0,0,8,12,20
64601,0,1,3,7,11
64602,0,0,3,6,9
64603,0,0,6,17,23
64604,0,0,2,48,50
64605,0,0,5,8,13
64606,0,0,11,28,39
64607,0,0,7,10,17
64608,0,1,7,10,18
64609,0,0,4,25,29
64610,0,0,7,21,28
64611,0,0,3,32,35
64612,0,0,15,21,36
64613,1,3,2,36,42
64614,1,0,13,34,48
64615,0,0,1,13,14
64616,0,0,6,13,19
64617,0,0,8,20,28
64618,0,0,2,2,4
64619,0,1,18,31,50
64620,0,3,2,10,15
64621,0,0,0,7,7
64622,0,0,14,16,30
64623,0,5,7,22,34
64624,1,0,0,34,35
64626,0,1,6,9,16
64627,0,2,13,21,36
64628,0,1,2,22,25
64629,3,2,8,19,32
64630,1,0,7,8,16
64631,0,1,6,11,18
64633,0,1,10,20,31
64634,0,2,4,11,17
64635,0,0,9,12,21
64636,0,0,4,2,6
64637,0,0,10,15,25
64638,0,0,11,17,28
64639,0,0,11,11,22
64640,0,0,4,6,10
64641,0,0,9,12,21
64642,0,2,8,17,27
64643,0,0,10,18,28
64644,0,0,6,16,22
64645,0,0,5,0,5
64646,0,0,10,22,32
64647,0,0,2,4,6
64649,0,3,13,15,31
64650,0,0,8,19,27
64651,0,0,11,18,29
64652,0,0,5,4,9
64653,0,0,6,14,20
64654,4,1,5,25,35
64655,0,0,7,8,15
64656,0,0,2,6,8
64657,0,0,17,33,50
64658,0,0,1,0,1
64659,0,3,2,4,9
64661,0,1,3,1,5
64662,0,1,3,13,17
64663,0,1,3,6,10
64664,0,4,2,19,25
64665,0,1,7,24,32
64666,0,1,7,8,16
64667,0,0,4,4,8
64668,0,0,14,24,38
64669,0,0,7,10,17
64670,0,2,2,14,18
64671,0,0,3,6,9
64673,0,3,7,15,25
64674,0,0,1,7,8
64675,0,0,2,7,9
64676,0,1,2,5,8
64677,0,0,8,22,30
64678,1,0,13,31,45
64679,0,0,1,6,7
64680,0,0,7,10,17
64681,1,1,6,33,41
64682,0,1,1,4,6
64683,0,1,3,13,17
64684,1,1,6,17,25
64685,0,0,10,14,24
64686,0,3,6,41,50
64687,5,1,6,29,41
64688,0,5,7,22,34
64689,0,0,15,19,34
64690,2,0,2,26,30
64691,0,0,4,4,8
64692,0,0,17,33,50
64693,0,1,9,9,19
64694,0,0,7,10,17
64695,0,4,2,19,25
64696,0,0,1,7,8
64697,0,0,6,9,15
64698,0,0,16,19,35
64699,1,0,13,34,48
64700,0,1,3,14,18
64701,0,0,18,8,26
64702,0,0,1,5,6
64703,0,0,1,12,13
64704,0,0,2,9,11
64705,0,0,11,26,37
64706,0,0,5,6,11
64707,0,2,2,14,18
64708,0,0,6,12,18
64709,0,0,15,32,47
64710,0,0,17,33,50
64711,0,0,7,12,19
64712,1,0,10,19,30
64713,1,2,14,33,50
64714,0,0,10,11,21
64715,0,0,2,4,6
64717,0,0,9,21,30
64718,2,1,7,16,26
64719,2,0,5,14,21
64720,0,0,16,15,31
64721,2,0,4,12,18
64722,0,0,6,6,12
64723,0,0,7,10,17
64724,0,0,7,7,14
64726,0,0,3,3,6
64727,0,0,6,8,14
64728,0,0,8,11,19
64730,0,5,7,22,34
64731,0,0,17,27,44
64732,0,1,14,29,44
64733,0,0,3,32,35
64734,0,0,3,2,5
64735,0,1,10,10,21
64736,0,0,5,17,22
64737,1,0,9,11,21
64738,0,0,16,19,35
64739,0,0,6,9,15
64740,0,0,5,7,12
64741,1,0,8,9,18
64742,0,0,6,5,11
64743,0,0,4,5,9
64745,0,0,7,7,14
64746,0,0,1,10,11
64747,1,0,11,20,32
64748,0,0,7,12,19
64749,0,3,0,10,13
64750,0,0,11,9,20
64751,0,1,4,2,7
64752,0,0,4,14,18
64753,0,0,3,6,9
64754,0,0,12,24,36
64755,0,0,1,3,4
64756,0,0,19,14,33
64757,0,0,6,11,17
64758,0,0,4,10,14
64759,0,0,7,9,16
64760,0,0,6,21,27
64761,0,0,7,7,14
64762,0,0,9,31,40
64763,0,0,15,13,28
64764,0,0,7,9,16
64765,0,0,14,10,24
64766,0,0,7,15,22
64767,0,0,8,7,15
64768,0,0,4,2,6
64769,0,0,1,7,8
64770,0,0,11,23,34
64771,0,0,1,3,4
64772,0,0,4,5,9
64773,0,0,1,7,8
64774,0,0,11,7,18
64775,0,0,1,15,16
64777,0,0,7,9,16
64778,0,0,3,4,7
64779,0,1,4,11,16
64780,0,0,3,16,19
64782,0,0,1,0,1
64783,0,2,12,36,50
64784,0,1,11,16,28
64785,0,0,11,12,23
64787,0,0,5,7,12
64788,0,0,3,15,18
64791,0,0,9,12,21
64792,0,1,14,31,46
64793,0,0,3,3,6
64794,0,0,10,19,29
64795,0,0,8,14,22
64796,0,0,3,12,15
64797,0,0,4,5,9
64798,0,0,0,5,5
64800,0,0,7,6,13
64802,0,2,9,15,26
64803,1,1,8,13,23
64804,0,0,6,10,16
64805,0,0,1,0,1
64806,0,0,6,14,20
64807,0,0,9,22,31
64808,0,0,9,11,20
64809,0,0,4,18,22
64810,0,0,3,20,23
64811,0,0,12,3,15
64812,1,10,4,35,50
64813,0,1,0,16,17
64815,0,1,12,18,31
64816,0,0,2,6,8
64817,0,0,4,7,11
64820,0,2,7,26,35
64822,0,0,5,10,15
64823,0,0,9,24,33
64824,0,0,9,37,46
64825,0,0,6,17,23
64827,0,0,4,5,9
64828,0,0,10,16,26
64829,1,3,5,14,23
64830,0,0,1,7,8
64832,0,0,1,4,5
64833,0,0,6,13,19
64834,0,0,7,5,12
64835,1,0,5,20,26
64836,0,0,10,18,28
64837,0,0,4,18,22
64838,0,0,2,2,4
64839,0,0,2,15,17
64840,0,0,1,4,5
64841,0,0,4,18,22
64842,1,1,21,25,48
64843,0,0,3,13,16
64844,1,0,0,34,35
64845,0,1,3,4,8
64847,1,0,0,12,13
64848,0,0,2,15,17
64849,0,0,0,1,1
64850,0,0,14,16,30
64851,0,0,1,4,5
64852,0,0,8,5,13
64853,0,0,14,36,50
64854,0,0,3,2,5
64855,0,0,6,8,14
64857,0,0,2,12,14
64858,0,0,10,13,23
64859,0,0,13,37,50
64860,1,2,18,28,49
64861,0,0,7,9,16
64862,0,0,13,33,46
64863,0,0,7,6,13
64864,0,0,15,35,50
64865,0,0,4,2,6
64867,1,0,13,20,34
64868,0,0,9,23,32
64869,1,0,9,38,48
64870,0,0,5,16,21
64871,0,0,6,11,17
64872,0,0,9,3,12
64873,0,1,2,16,19
64874,0,0,8,11,19
64875,0,0,13,33,46
64876,0,0,17,33,50
64877,2,0,2,9,13
64878,0,0,8,17,25
64879,1,0,16,33,50
64882,0,1,10,20,31
64883,0,0,7,12,19
64884,0,0,5,3,8
64885,1,1,10,38,50
64886,3,0,8,39,50
64887,0,0,7,10,17
64888,1,0,13,36,50
64889,0,0,0,1,1
64890,2,0,10,19,31
64891,0,0,17,30,47
64892,0,0,16,32,48
64893,0,1,18,31,50
64894,0,0,6,16,22
64895,0,0,11,7,18
64896,0,0,6,10,16
64897,0,1,3,11,15
64898,0,0,5,12,17
64899,0,0,12,38,50
64900,0,0,22,19,41
64901,0,0,1,6,7
64902,0,0,8,10,18
64903,0,0,7,22,29
64904,0,0,3,19,22
64905,1,0,12,14,27
64906,0,0,11,7,18
64907,0,0,7,8,15
64908,0,0,4,18,22
64909,0,0,13,6,19
64910,1,0,0,16,17
64911,0,0,3,16,19
64912,0,1,6,43,50
64913,0,0,6,0,6
64914,0,0,7,26,33
64916,0,0,10,15,25
64917,0,0,10,14,24
64918,0,0,10,27,37
64919,3,0,3,20,26
64920,0,0,14,13,27
64921,5,1,8,36,50
64922,0,1,14,33,48
64923,0,0,4,11,15
64924,7,2,1,40,50
64925,0,0,6,11,17
64926,1,0,9,23,33
64927,0,0,12,21,33
64928,0,0,7,7,14
64929,0,0,5,8,13
64930,0,0,9,24,33
64931,0,0,9,12,21
64933,0,1,2,20,23
64934,0,0,6,13,19
64935,0,1,7,22,30
64936,0,0,8,9,17
64937,0,0,10,20,30
64938,0,0,9,4,13
64939,0,0,9,31,40
64941,0,0,3,7,10
64942,0,0,4,18,22
64943,0,0,0,1,1
64944,0,5,7,22,34
64945,3,1,7,39,50
64946,0,0,2,15,17
64947,1,0,0,34,35
64948,0,0,14,16,30
64950,0,0,16,34,50
64952,0,3,6,41,50
64954,2,0,7,19,28
64955,0,5,7,22,34
64956,0,0,16,34,50
64957,1,1,3,24,29
64958,0,1,11,16,28
64959,0,1,6,43,50
64960,1,10,4,35,50
64961,1,0,3,13,17
64962,0,0,8,17,25
64963,0,5,7,22,34
64964,0,0,3,5,8
64965,0,0,3,8,11
64966,1,1,7,30,39
64967,0,0,18,32,50
64968,0,1,6,9,16
64969,0,1,8,28,37
64970,0,0,7,6,13
64971,0,0,5,6,11
64972,0,0,0,4,4
64973,0,0,1,2,3
64976,0,0,2,6,8
64977,0,0,0,6,6
64978,0,0,10,26,36
64979,0,0,8,20,28
64981,0,0,3,8,11
64983,0,0,1,0,1
64985,0,0,1,6,7
64989,0,0,9,31,40
64990,0,0,10,36,46
64991,0,1,3,14,18
64992,0,0,6,12,18
64993,0,0,4,24,28
64994,0,0,7,12,19
64995,0,1,2,5,8
64996,0,1,3,13,17
64997,0,1,7,4,12
64998,0,0,12,38,50
64999,1,0,4,33,38
65000,0,0,8,20,28
65001,0,0,4,3,7
65002,0,0,3,7,10
65003,1,0,2,8,11
65005,0,0,9,4,13
65006,0,0,6,27,33
65007,0,0,13,32,45
65008,0,2,17,31,50
65009,0,0,5,2,7
65010,1,0,7,38,46
65011,0,0,4,9,13
65012,0,0,2,4,6
65013,0,0,4,9,13
65014,0,0,2,1,3
65015,0,0,6,9,15
65016,0,3,2,9,14
65017,0,0,8,10,18
65018,1,0,9,25,35
65019,0,0,3,2,5
65020,0,0,6,10,16
65021,0,1,13,25,39
65022,1,1,7,26,35
65023,0,0,1,8,9
65024,0,0,5,2,7
65025,0,1,2,14,17
65026,0,0,13,26,39
65027,0,2,14,10,26
65028,0,0,5,4,9
65029,0,1,4,16,21
65030,0,0,4,14,18
65031,1,1,6,41,49
65032,0,0,8,7,15
65033,0,1,13,25,39
65034,0,0,1,7,8
65035,0,0,0,8,8
65036,0,0,4,10,14
65037,0,1,9,24,34
65038,0,0,6,8,14
65039,0,0,6,3,9
65040,0,1,10,14,25
65041,0,0,3,7,10
65042,0,0,2,6,8
65043,1,1,4,10,16
65044,0,1,2,14,17
65045,4,1,1,8,14
65046,4,1,4,41,50
65047,0,1,13,29,43
65048,1,0,7,42,50
65049,0,0,4,8,12
65050,0,0,10,22,32
65052,0,0,6,10,16
65053,0,0,2,14,16
65055,0,0,5,17,22
65056,0,0,8,8,16
65057,0,0,13,19,32
65058,0,1,13,29,43
65059,0,0,6,8,14
65060,1,0,2,5,8
65061,3,1,8,30,42
65062,0,0,1,3,4
65064,0,0,5,3,8
65065,0,0,10,13,23
65066,1,1,3,12,17
65067,0,0,6,8,14
65068,0,0,5,2,7
65070,0,0,4,3,7
65071,0,0,6,10,16
65072,2,0,7,37,46
65074,0,0,8,7,15
65075,0,0,4,2,6
65077,0,1,8,6,15
65078,0,0,3,11,14
65079,0,0,11,10,21
65080,0,1,8,7,16
65081,2,0,7,37,46
65082,1,0,12,20,33
65083,0,0,11,15,26
65084,0,0,5,15,20
65085,0,0,6,11,17
65086,0,1,3,17,21
65087,0,0,17,29,46
65088,0,1,17,22,40
65089,0,0,11,11,22
65090,1,1,10,26,38
65091,0,1,3,46,50
65092,0,0,1,9,10
65093,0,0,10,4,14
65095,0,1,1,10,12
65097,0,2,15,28,45
65098,0,1,10,17,28
65099,1,3,3,12,19
65100,0,0,9,16,25
65101,1,1,6,34,42
65102,1,0,2,2,5
65103,0,0,9,12,21
65104,2,0,1,2,5
65105,0,0,1,4,5
65107,0,0,2,1,3
65108,0,0,1,7,8
65109,0,0,3,8,11
65110,0,0,6,9,15
65111,0,0,1,7,8
65112,0,0,0,6,6
65114,0,0,15,27,42
65117,0,0,7,11,18
65119,0,0,8,14,22
65120,0,0,11,38,49
65122,1,0,8,4,13
65123,0,0,7,20,27
65125,0,0,0,10,10
65128,0,0,3,4,7
65130,0,0,3,2,5
65135,0,1,11,16,28
65136,0,0,15,35,50
65137,4,1,7,38,50
65138,0,0,14,23,37
65139,0,0,1,13,14
65140,0,0,7,6,13
65141,0,0,4,4,8
65142,0,0,4,2,6
65143,0,0,3,6,9
65144,0,0,4,9,13
65145,0,0,16,19,35
65146,0,0,1,12,13
65147,4,1,5,25,35
65148,0,1,10,35,46
65149,0,0,2,4,6
65150,0,0,1,7,8
65151,0,0,5,7,12
65152,0,0,4,2,6
65154,0,0,5,6,11
65155,0,0,1,4,5
65156,2,0,3,8,13
65158,0,0,0,10,10
65159,0,0,5,7,12
65160,1,0,0,12,13
65161,2,0,0,3,5
65162,0,0,7,15,22
65163,3,0,3,25,31
65165,2,0,2,21,25
65166,1,0,7,25,33
65167,0,2,15,26,43
65168,0,1,1,28,30
65169,2,0,1,8,11
65170,1,0,6,16,23
65171,0,0,4,20,24
65172,0,0,14,19,33
65173,0,0,15,31,46
65174,1,0,11,32,44
65175,5,0,3,19,27
65176,0,0,8,14,22
65177,3,1,8,26,38
65178,0,2,8,17,27
65179,0,0,8,14,22
65180,0,0,8,5,13
65181,1,0,5,19,25
65182,0,0,12,23,35
65183,0,0,11,16,27
65184,1,0,3,7,11
65185,0,0,5,12,17
65186,0,0,8,37,45
65187,0,1,13,36,50
65188,0,0,0,8,8
65189,0,0,15,30,45
65190,0,0,5,12,17
65191,0,0,14,33,47
65192,0,0,9,11,20
65193,0,0,12,34,46
65194,0,0,20,23,43
65195,1,1,1,10,13
65196,0,0,6,17,23
65197,0,1,4,24,29
65199,0,3,1,28,32
65200,0,0,4,4,8
65201,0,2,16,19,37
65202,0,0,1,10,11
65203,2,0,6,12,20
65204,0,0,3,18,21
65205,1,1,7,38,47
65206,0,0,13,37,50
65207,8,1,6,35,50
65208,0,0,4,10,14
65209,0,0,0,6,6
65210,1,1,7,26,35
65211,0,0,5,9,14
65212,3,0,3,18,24
65213,0,0,11,21,32
65214,1,0,4,19,24
65215,0,1,5,21,27
65216,0,3,16,29,48
65217,0,4,1,19,24
65218,0,0,6,9,15
65219,0,1,1,13,15
65220,0,0,6,6,12
65221,0,0,16,18,34
65222,0,3,9,38,50
65223,0,0,10,26,36
65224,1,0,0,17,18
65225,1,0,1,5,7
65226,1,0,13,24,38
65227,2,0,4,9,15
65228,0,1,10,10,21
65229,0,0,5,14,19
65230,0,1,9,19,29
65231,0,0,1,6,7
65233,0,0,0,17,17
65234,3,0,0,8,11
65235,0,0,6,4,10
65236,0,1,10,35,46
65237,1,0,5,16,22
65238,0,0,4,11,15
65239,0,2,4,16,22
65240,0,1,10,19,30
65241,0,0,8,19,27
65242,1,0,5,11,17
65243,0,0,5,27,32
65244,0,0,16,19,35
65245,1,0,1,17,19
65246,3,1,1,8,13
65250,1,0,0,4,5
65252,0,0,2,4,6
65253,2,0,8,17,27
65254,0,0,6,15,21
65255,0,1,6,4,11
65256,0,0,1,7,8
65257,2,0,3,8,13
65258,5,0,3,39,47
65259,2,0,10,24,36
65261,0,0,3,6,9
65263,0,2,13,30,45
65264,0,0,1,7,8
65265,0,0,1,13,14
65266,0,0,8,12,20
65268,0,0,14,23,37
65269,1,0,15,34,50
65271,0,0,10,13,23
65272,0,0,20,27,47
65273,0,0,1,12,13
65274,0,0,6,9,15
65275,0,0,20,30,50
65276,0,0,11,20,31
65277,0,0,4,18,22
65278,0,0,1,7,8
65281,1,2,4,43,50
65282,2,1,16,30,49
65283,0,0,0,17,17
65284,1,0,0,4,5
65285,0,2,13,30,45
65286,0,0,4,16,20
65288,3,1,1,8,13
65289,5,1,4,23,33
65290,0,0,1,13,14
65291,0,1,11,16,28
65292,0,0,8,14,22
65293,3,0,4,15,22
65294,0,2,3,21,26
65295,10,3,3,32,48
65296,0,0,3,1,4
65297,1,10,4,35,50
65298,0,3,2,10,15
65299,0,0,2,6,8
65300,1,0,8,15,24
65301,10,3,3,32,48
65302,0,0,15,35,50
65303,3,0,11,34,48
65304,2,0,9,35,46
65305,3,0,4,15,22
65306,0,0,8,28,36
65307,0,3,2,10,15
65308,0,0,15,35,50
65309,1,10,4,35,50
65310,3,0,4,15,22
65311,5,2,4,39,50
65312,0,0,8,28,36
65313,0,0,15,35,50
65314,5,2,4,39,50
65315,0,0,2,6,8
65316,0,0,0,7,7
65317,0,0,0,7,7
65318,0,3,7,15,25
65319,0,0,6,19,25
65320,0,0,1,4,5
65321,0,0,6,10,16
65322,0,0,1,6,7
65323,0,1,3,12,16
65325,0,0,3,8,11
65326,1,0,11,35,47
65327,0,1,3,14,18
65328,0,1,18,30,49
65329,0,3,17,17,37
65330,0,0,5,4,9
65331,1,0,7,19,27
65332,0,0,10,12,22
65333,0,0,7,12,19
65334,0,0,6,10,16
65335,0,0,8,31,39
65336,0,0,4,2,6
65337,0,0,4,8,12
65338,0,0,1,4,5
65340,0,1,2,8,11
65341,0,0,12,28,40
65342,0,2,9,18,29
65343,0,0,2,5,7
65345,0,0,6,10,16
65346,0,7,1,10,18
65347,0,1,4,44,49
65348,0,0,3,6,9
65349,1,1,5,18,25
65350,0,0,9,13,22
65351,0,0,5,7,12
65352,0,0,12,35,47
65353,0,0,7,12,19
65354,0,1,14,26,41
65355,0,0,10,5,15
65356,1,0,13,35,49
65357,2,0,3,36,41
65358,0,0,14,32,46
65359,0,0,10,8,18
65360,0,0,12,37,49
65361,0,1,6,20,27
65362,0,0,5,9,14
65363,0,3,2,10,15
65364,0,0,4,18,22
65365,0,0,14,12,26
65366,0,0,14,36,50
65367,0,0,11,23,34
65368,0,0,9,8,17
65369,0,0,14,31,45
65370,0,0,3,2,5
65371,0,0,17,27,44
65372,2,0,3,18,23
65373,0,0,20,27,47
65374,0,0,7,18,25
65375,3,0,3,25,31
65376,0,0,9,8,17
65377,3,4,4,29,40
65378,0,1,6,24,31
65379,0,3,5,19,27
65380,0,0,3,3,6
65381,0,0,1,4,5
65382,2,0,15,33,50
65383,0,0,2,15,17
65384,0,0,14,33,47
65385,1,0,7,20,28
65386,0,1,3,14,18
65387,0,0,3,6,9
65388,1,0,10,26,37
65389,2,0,3,18,23
65390,0,2,13,30,45
65391,1,10,4,35,50
65392,0,0,5,5,10
65393,0,0,1,7,8
65394,0,0,2,12,14
65395,0,2,6,4,12
65396,0,0,10,11,21
65397,0,0,20,27,47
65398,3,0,3,25,31
65399,1,0,13,34,48
65400,0,0,17,27,44
65401,1,0,7,20,28
65402,0,2,13,30,45
65403,0,0,3,9,12
65404,0,0,14,32,46
65405,0,0,1,5,6
65406,0,1,9,10,20
65407,2,0,15,33,50
65408,0,0,14,31,45
65409,0,0,7,21,28
65410,3,0,4,15,22
65411,5,2,4,39,50
65412,0,1,10,22,33
65413,3,0,3,25,31
65414,0,0,14,33,47
65415,5,1,3,17,26
65416,0,0,0,1,1
65417,0,0,0,7,7
65418,1,4,7,19,31
65419,1,0,16,25,42
65420,2,0,3,18,23
65421,0,0,20,27,47
65422,0,2,13,30,45
65423,0,1,6,24,31
65424,0,0,12,37,49
65425,2,0,15,33,50
65426,0,0,3,16,19
65427,0,0,3,9,12
65428,1,0,10,39,50
65429,0,0,0,1,1
65431,0,0,5,5,10
65432,0,1,6,20,27
65433,0,0,18,18,36
65434,0,0,3,11,14
65435,0,0,18,30,48
65436,0,0,10,11,21
65437,0,0,14,32,46
65438,0,1,16,20,37
65440,0,0,15,35,50
65441,0,7,1,10,18
65442,0,1,4,44,49
65443,0,1,21,21,43
65444,0,0,14,36,50
65445,0,2,9,18,29
65446,5,2,4,39,50
65447,0,0,2,6,8
65448,0,0,0,7,7
65449,1,0,0,12,13
65450,0,0,7,6,13
65451,0,0,3,6,9
65452,0,0,9,1,10
65453,0,0,14,23,37
65454,0,0,4,13,17
65455,0,0,2,4,6
65456,0,0,11,20,31
65457,0,1,3,12,16
65458,0,0,2,9,11
65459,0,0,11,19,30
65460,0,0,0,7,7
65462,0,0,1,7,8
65463,0,0,5,7,12
65464,1,0,0,12,13
65465,0,0,0,10,10
65467,0,0,0,7,7
65468,0,0,12,4,16
65469,0,1,23,26,50
65470,0,0,3,11,14
65471,0,1,18,27,46
65472,0,0,6,9,15
65473,0,0,5,3,8
65474,0,0,9,21,30
65475,0,0,7,14,21
65476,0,0,13,26,39
65477,0,0,6,14,20
65478,0,0,7,21,28
65479,0,0,13,8,21
65480,0,0,4,11,15
65482,0,1,2,10,13
65483,0,0,3,7,10
65484,0,0,5,11,16
65485,0,0,4,7,11
65486,0,0,7,11,18
65487,0,1,12,24,37
65488,0,3,17,22,42
65489,0,0,10,15,25
65490,0,3,1,22,26
65491,0,0,2,16,18
65492,0,0,8,9,17
65493,0,0,8,10,18
65494,0,1,3,9,13
65495,0,0,8,19,27
65496,0,0,6,6,12
65497,0,0,3,21,24
65498,0,0,2,2,4
65499,0,1,14,35,50
65500,1,4,12,33,50
65501,0,0,2,6,8
65502,0,0,12,4,16
65503,0,0,11,31,42
65504,0,0,9,17,26
65505,0,0,3,6,9
65506,0,0,8,16,24
65507,0,0,17,27,44
65508,0,0,8,14,22
65509,3,0,4,15,22
65510,0,0,11,26,37
65511,0,0,7,15,22
65512,0,0,7,19,26
65513,0,0,15,27,42
65514,0,0,9,12,21
65515,0,0,8,19,27
65516,0,3,17,17,37
65517,5,0,6,31,42
65518,0,0,7,9,16
65519,1,0,11,32,44
65520,0,0,5,24,29
65521,0,0,18,30,48
65522,0,1,14,26,41
65523,0,0,19,28,47
65524,0,0,11,14,25
65525,0,0,15,33,48
65526,2,3,3,14,22
65527,0,0,4,1,5
65528,3,2,9,35,49
65529,0,0,17,32,49
65530,0,2,3,10,15
65531,0,0,11,22,33
65532,0,0,4,12,16
65533,0,0,16,34,50
65534,0,0,11,35,46
65535,2,3,3,14,22
65536,0,2,13,30,45
65537,0,5,7,22,34
65538,2,0,3,18,23
65539,0,2,13,30,45
65540,0,0,14,10,24
65541,0,0,9,4,13
65542,0,0,3,9,12
65543,0,0,20,27,47
65544,0,4,16,19,39
65545,0,0,17,27,44
65546,0,0,5,12,17
65547,1,0,11,32,44
65548,0,0,4,12,16
65549,0,0,14,16,30
65550,0,0,16,34,50
65551,3,1,7,39,50
65552,1,0,8,38,47
65553,5,0,2,14,21
65554,2,0,2,26,30
65556,0,1,10,31,42
65557,0,0,7,21,28
65558,5,1,6,29,41
65559,5,0,2,14,21
65560,0,0,11,26,37
65561,0,0,7,14,21
65562,3,0,4,15,22
65563,0,1,2,7,10
65564,0,0,6,18,24
65565,0,0,2,4,6
65566,0,0,1,4,5
65567,0,0,0,1,1
65568,0,1,2,7,10
65569,1,0,6,18,25
65570,0,0,7,19,26
65571,5,1,6,29,41
65572,0,0,2,6,8
65573,0,0,7,14,21
65574,1,0,11,32,44
65575,0,0,9,22,31
65576,2,0,2,26,30
65577,0,1,18,31,50
65578,3,1,7,39,50
65579,0,0,0,7,7
65580,0,0,5,12,17
65581,1,0,8,38,47
65582,0,0,3,9,12
65583,0,0,13,28,41
65584,0,0,0,1,1
65585,0,0,2,6,8
65586,0,0,5,12,17
65587,0,2,9,18,29
65588,0,2,13,30,45
65589,0,0,18,30,48
65590,0,0,4,4,8
65591,0,0,9,22,31
65592,2,0,3,18,23
65593,0,0,7,21,28
65594,0,0,3,16,19
65595,3,1,7,39,50
65596,1,4,7,19,31
65597,0,0,20,27,47
65598,0,7,1,10,18
65599,0,0,8,28,36
65600,0,2,6,10,18
65601,0,0,1,7,8
65602,0,1,16,20,37
65603,0,0,7,12,19
65604,0,0,0,7,7
65605,0,0,9,33,42
65606,0,0,3,13,16
65607,0,0,2,4,6
65608,0,1,6,10,17
65609,0,0,1,6,7
65610,0,0,1,17,18
65611,0,0,0,7,7
65612,0,3,7,15,25
65613,0,0,4,9,13
65615,0,2,2,17,21
65616,0,1,8,30,39
65617,1,0,1,15,17
65618,0,0,1,4,5
65619,0,0,7,14,21
65620,0,0,13,32,45
65621,0,0,4,9,13
65622,1,1,9,26,37
65623,0,0,6,23,29
65624,0,0,7,14,21
65625,0,0,10,7,17
65626,0,1,3,7,11
65627,0,0,15,24,39
65628,0,1,20,29,50
65629,0,0,6,9,15
65630,0,0,3,11,14
65631,0,0,3,7,10
65632,0,0,18,13,31
65633,0,0,6,7,13
65634,0,0,6,9,15
65635,0,0,3,3,6
65636,0,0,5,11,16
65637,0,0,4,2,6
65638,0,4,8,36,48
65639,0,0,5,6,11
65640,0,0,11,8,19
65641,0,2,12,21,35
65642,0,0,4,8,12
65643,0,0,2,1,3
65644,0,0,10,13,23
65645,0,0,5,4,9
65646,0,0,8,8,16
65647,1,0,12,37,50
65648,0,1,0,23,24
65649,0,0,8,17,25
65650,2,0,15,33,50
65651,0,0,14,36,50
65652,0,0,12,37,49
65653,1,1,9,30,41
65654,0,0,7,19,26
65655,1,1,9,26,37
65656,1,1,9,36,47
65657,0,0,13,37,50
65658,0,0,10,9,19
65659,0,0,3,5,8
65660,0,0,11,9,20
65661,0,1,12,31,44
65662,2,0,5,29,36
65663,0,2,15,23,40
65664,0,0,16,18,34
65665,0,0,12,32,44
65666,0,0,12,27,39
65667,0,0,11,28,39
65668,0,2,23,25,50
65669,0,0,9,21,30
65670,0,0,6,9,15
65671,0,0,7,15,22
65672,0,0,5,6,11
65673,0,0,8,39,47
65674,1,1,12,32,46
65675,0,0,3,11,14
65676,0,0,3,10,13
65677,0,0,8,7,15
65678,0,0,7,19,26
65679,0,0,1,13,14
65680,0,0,15,26,41
65681,0,0,10,28,38
65682,2,0,5,29,36
65683,0,0,16,34,50
65684,0,0,9,21,30
65685,0,0,1,7,8
65686,0,0,4,25,29
65687,0,0,1,1,2
65688,0,0,5,24,29
65690,0,0,15,35,50
65692,0,0,5,5,10
65694,1,3,2,36,42
65695,0,0,3,10,13
65696,0,5,7,22,34
65697,1,0,7,20,28
65698,1,0,6,19,26
65699,0,0,6,26,32
65700,0,0,18,27,45
65701,1,0,13,34,48
65702,3,0,1,13,17
65703,2,0,5,29,36
65704,1,0,7,20,28
65705,1,0,11,31,43
65706,0,0,10,11,21
65707,0,1,4,6,11
65708,0,0,14,16,30
65709,1,0,0,34,35
65710,0,0,6,13,19
65711,2,0,15,33,50
65712,0,1,2,13,16
65713,1,0,0,34,35
65715,0,0,15,21,36
65716,0,0,7,21,28
65717,0,0,7,14,21
65719,0,1,18,31,50
65720,0,1,10,22,33
65721,0,0,5,11,16
65722,0,0,0,7,7
65723,0,0,1,4,5
65724,0,0,3,32,35
65725,0,0,7,14,21
65726,5,0,4,7,16
65727,0,0,15,21,36
65728,0,0,7,21,28
65729,0,0,18,30,48
65730,0,0,3,11,14
65731,1,3,2,36,42
65732,0,0,5,5,10
65733,0,0,10,11,21
65734,2,0,15,33,50
65735,0,0,12,37,49
65736,1,0,7,20,28
65737,0,2,12,27,41
65738,4,1,5,25,35
65739,0,0,3,6,9
65740,0,0,4,2,6
65741,0,0,3,1,4
65742,0,0,3,7,10
65743,0,0,2,0,2
65744,0,0,1,7,8
65745,0,3,7,15,25
65746,1,0,3,4,8
65747,1,1,4,5,11
65748,0,0,0,1,1
65749,0,0,7,14,21
65750,0,0,11,29,40
65751,0,0,9,33,42
65752,0,0,1,2,3
65753,0,0,5,3,8
65754,0,1,14,14,29
65755,0,0,2,4,6
65756,0,0,4,9,13
65757,0,0,1,7,8
65758,0,0,0,10,10
65759,0,0,0,14,14
65760,0,0,1,1,2
65761,0,0,14,13,27
65762,0,0,11,5,16
65763,0,0,8,9,17
65764,0,1,12,24,37
65765,1,0,12,37,50
65766,0,0,4,9,13
65767,0,0,9,12,21
65768,0,1,7,7,15
65769,0,1,12,28,41
65770,0,0,4,7,11
65771,0,0,2,4,6
65772,0,0,5,11,16
65773,0,0,7,9,16
65774,0,0,7,10,17
65775,0,0,3,15,18
65776,0,1,0,8,9
65777,0,0,11,19,30
65778,0,0,10,33,43
65779,0,0,7,43,50
65780,0,1,17,25,43
65781,0,0,5,11,16
65782,0,0,6,13,19
65783,0,0,16,32,48
65784,0,0,8,5,13
65785,0,0,11,5,16
65786,0,0,14,31,45
65787,0,0,8,31,39
65788,0,0,3,6,9
65789,8,0,6,25,39
65790,0,0,2,4,6
65791,0,0,8,28,36
65792,0,1,12,36,49
65793,1,0,14,33,48
65794,0,0,9,15,24
65795,0,0,10,9,19
65796,0,0,6,5,11
65797,0,0,14,24,38
65798,0,0,2,10,12
65799,0,0,14,12,26
65800,0,1,7,25,33
65801,0,0,6,8,14
65802,0,0,10,11,21
65803,0,0,5,7,12
65804,0,0,11,16,27
65805,0,0,8,24,32
65806,0,0,11,15,26
65807,1,0,7,12,20
65808,0,0,8,42,50
65809,1,0,1,11,13
65810,0,0,3,22,25
65811,0,1,12,30,43
65812,0,2,3,25,30
65813,1,0,8,15,24
65814,0,1,2,10,13
65815,0,0,2,10,12
65816,0,0,7,41,48
65817,0,0,14,36,50
65818,0,0,1,7,8
65819,2,0,4,12,18
65820,0,5,7,22,34
65821,0,1,10,28,39
65822,0,1,2,10,13
65823,0,0,7,43,50
65824,0,1,9,9,19
65825,0,1,3,6,10
65826,5,0,2,14,21
65827,5,1,6,29,41
65828,2,0,2,26,30
65829,5,0,2,14,21
65831,0,0,5,11,16
65832,5,1,6,29,41
65833,2,0,2,26,30
65834,0,3,2,4,9
65835,0,0,4,4,8
65836,0,2,12,17,31
65838,0,0,5,6,11
65839,1,0,6,8,15
65840,0,0,2,3,5
65841,0,0,7,6,13
65842,0,0,5,24,29
65843,0,0,14,21,35
65844,0,1,14,29,44
65845,1,1,3,29,34
65846,0,2,12,22,36
65847,0,0,14,20,34
65848,1,0,5,20,26
65849,0,0,3,11,14
65850,0,0,17,32,49
65851,0,0,2,4,6
65852,0,1,11,9,21
65853,0,0,2,7,9
65854,0,1,14,31,46
65855,0,1,16,33,50
65856,0,0,6,8,14
65857,0,0,3,2,5
65858,0,0,18,30,48
65859,0,0,10,32,42
65860,1,1,7,22,31
65861,0,2,3,16,21
65862,0,0,3,10,13
65863,0,0,9,16,25
65864,1,1,1,7,10
65865,0,1,9,25,35
65866,0,0,8,18,26
65867,1,1,5,16,23
65869,0,0,1,7,8
65870,0,0,3,32,35
65871,0,0,6,1,7
65872,0,0,7,3,10
65873,0,0,2,13,15
65874,0,0,12,37,49
65875,0,0,13,14,27
65876,0,0,10,40,50
65877,0,0,1,8,9
65878,1,0,13,34,48
65879,1,0,13,32,46
65880,0,2,4,28,34
65881,0,0,14,27,41
65882,0,3,10,21,34
65883,0,0,13,23,36
65884,0,0,14,27,41
65885,0,0,12,19,31
65886,0,0,16,34,50
65887,0,1,18,31,50
65888,0,1,10,18,29
65889,0,1,3,14,18
65890,0,2,11,16,29
65891,0,1,6,6,13
65892,0,0,9,19,28
65893,0,0,6,20,26
65894,0,0,13,35,48
65895,2,0,11,18,31
65897,1,1,13,30,45
65898,0,0,12,27,39
65899,0,0,9,31,40
65900,1,0,14,35,50
65901,0,0,7,18,25
65902,0,0,9,14,23
65903,1,0,19,30,50
65904,0,0,13,23,36
65905,0,1,2,10,13
65906,0,5,7,22,34
65907,0,0,9,17,26
65908,0,1,1,11,13
65909,0,1,15,23,39
65910,0,1,6,6,13
65911,0,0,9,23,32
65912,0,1,3,14,18
65914,0,0,16,34,50
65915,0,0,4,1,5
65916,1,0,13,34,48
65917,1,0,12,26,39
65918,0,1,2,10,13
65919,0,0,17,27,44
65921,0,0,1,7,8
65923,0,0,1,7,8
65924,0,0,9,23,32
65925,0,0,3,32,35
65926,0,0,1,7,8
65927,1,0,0,12,13
65928,1,0,7,11,19
65929,0,0,3,13,16
65931,1,0,0,12,13
65932,0,3,7,15,25
65933,0,0,4,8,12
65934,0,0,11,17,28
65935,0,1,7,22,30
65936,0,0,7,21,28
65937,0,0,5,3,8
65938,0,0,1,8,9
65939,0,0,10,28,38
65940,0,0,7,11,18
65941,0,3,0,6,9
65942,0,1,7,20,28
65943,0,0,10,7,17
65944,0,0,3,2,5
65945,0,0,8,7,15
65946,0,0,6,9,15
65947,0,0,17,27,44
65948,0,0,7,12,19
65949,0,0,0,1,1
65950,0,0,3,11,14
65951,0,0,4,14,18
65952,0,0,18,18,36
65953,0,0,3,6,9
65954,0,0,9,22,31
65955,0,0,3,5,8
65956,0,0,18,32,50
65957,0,0,9,28,37
65958,0,0,4,14,18
65959,0,0,4,10,14
65960,0,0,14,33,47
65961,0,0,19,14,33
65963,0,0,14,33,47
65964,0,1,15,22,38
65965,0,0,16,31,47
65966,0,0,9,23,32
65967,2,0,1,16,19
65968,0,0,2,13,15
65969,1,0,18,31,50
65970,0,1,7,16,24
65971,0,1,12,37,50
65972,0,0,9,14,23
65973,0,0,12,12,24
65974,0,0,7,27,34
65975,1,0,11,18,30
65976,2,1,5,24,32
65977,0,3,13,34,50
65978,0,1,11,36,48
65979,0,0,8,9,17
65980,0,0,0,5,5
65981,0,0,19,20,39
65982,0,0,14,33,47
65983,1,0,5,33,39
65984,0,0,9,6,15
65985,0,0,20,30,50
65986,0,0,2,19,21
65987,0,0,17,32,49
65988,1,0,14,35,50
65989,0,1,10,31,42
65990,0,0,0,5,5
65991,0,0,8,10,18
65992,1,0,15,33,49
65993,1,2,15,32,50
65994,0,1,10,37,48
65995,0,0,18,32,50
65996,1,0,9,35,45
65997,0,0,0,13,13
65998,0,0,2,19,21
65999,0,0,7,27,34
66000,0,2,16,32,50
66001,1,0,5,33,39
66002,0,0,4,14,18
66003,1,1,3,24,29
66004,0,0,4,6,10
66005,0,0,4,26,30
66006,2,0,10,19,31
66007,0,0,5,12,17
66008,0,0,13,6,19
66009,0,0,8,11,19
66010,0,0,0,1,1
66012,1,0,7,25,33
66013,1,0,0,16,17
66014,0,0,7,43,50
66015,0,0,11,23,34
66016,0,0,14,33,47
66017,0,0,5,14,19
66019,0,0,13,27,40
66020,1,0,4,16,21
66021,0,0,16,32,48
66022,3,0,3,20,26
66023,0,0,7,26,33
66024,1,1,7,36,45
66025,0,0,14,16,30
66026,0,0,2,19,21
66029,0,0,6,13,19
66030,1,2,3,12,18
66031,0,1,4,13,18
66032,0,0,8,11,19
66033,0,0,9,4,13
66034,1,0,0,34,35
66035,3,1,7,39,50
66036,1,0,0,34,35
66037,0,0,6,17,23
66038,0,1,10,31,42
66040,0,0,9,22,31
66041,5,1,3,17,26
66042,0,0,14,33,47
66043,0,0,0,1,1
66044,3,1,7,39,50
66045,1,1,21,25,48
66046,0,0,18,18,36
66048,0,0,0,1,1
66049,0,0,9,22,31
66050,3,1,7,39,50
66052,0,0,4,13,17
66053,0,1,14,23,38
66054,0,0,7,12,19
66055,0,0,14,28,42
66056,0,1,7,33,41
66057,0,0,8,31,39
66058,0,0,7,7,14
66059,0,0,7,6,13
66060,0,0,4,28,32
66061,0,0,3,1,4
66062,1,0,10,39,50
66063,0,1,10,16,27
66064,0,0,1,12,13
66065,0,1,9,6,16
66066,1,0,14,35,50
66067,0,0,13,32,45
66068,0,2,12,36,50
66069,0,1,1,1,3
66070,0,0,1,5,6
66071,0,0,3,14,17
66072,0,1,3,23,27
66073,0,0,7,5,12
66074,0,0,1,7,8
66075,0,0,12,22,34
66076,0,1,3,23,27
66078,0,0,6,8,14
66079,0,0,4,19,23
66080,0,0,6,12,18
66081,0,0,5,11,16
66082,0,0,10,22,32
66083,0,3,6,37,46
66084,1,4,12,24,41
66085,4,0,7,30,41
66086,1,1,9,30,41
66087,1,0,8,29,38
66088,1,0,2,19,22
66089,0,0,14,10,24
66091,0,1,8,15,24
66092,0,0,5,13,18
66093,0,1,0,4,5
66094,0,0,3,6,9
66095,0,0,14,36,50
66096,0,0,20,26,46
66097,1,0,5,25,31
66098,0,0,5,18,23
66099,0,0,9,18,27
66100,0,1,10,4,15
66101,1,1,8,19,29
66102,0,0,2,8,10
66103,0,1,2,19,22
66104,0,0,7,12,19
66105,0,0,2,17,19
66106,0,1,3,14,18
66107,1,0,5,35,41
66108,0,0,10,14,24
66109,1,0,16,29,46
66110,9,0,5,27,41
66111,0,0,8,19,27
66112,0,0,0,5,5
66113,1,0,4,33,38
66114,0,0,10,36,46
66115,1,0,7,16,24
66116,0,1,3,14,18
66117,0,0,14,36,50
66118,4,0,1,10,15
66119,0,2,2,30,34
66121,0,0,0,5,5
66122,0,0,4,28,32
66123,0,0,1,6,7
66124,1,0,10,34,45
66125,1,0,9,35,45
66126,0,0,1,13,14
66127,0,0,14,10,24
66128,2,0,9,28,39
66129,0,0,9,15,24
66130,0,0,3,20,23
66131,0,0,1,13,14
66132,0,0,1,6,7
66133,1,0,10,39,50
66134,1,0,0,12,13
66135,0,0,4,3,7
66136,0,0,1,6,7
66137,3,0,12,35,50
66138,0,0,3,6,9
66139,0,0,7,6,13
66140,0,0,4,9,13
66141,0,0,11,20,31
66142,0,0,7,24,31
66143,0,0,14,23,37
66144,0,0,4,2,6
66145,4,1,5,25,35
66146,0,0,4,2,6
66147,0,0,1,7,8
66148,0,0,1,4,5
66149,1,0,0,12,13
66150,0,0,5,7,12
66152,0,0,2,4,6
66153,0,0,5,6,11
66154,0,0,0,10,10
66155,0,0,3,7,10
66156,0,0,13,21,34
66157,0,0,17,33,50
66158,1,2,14,26,43
66159,1,0,5,4,10
66160,0,1,12,33,46
66161,0,1,1,16,18
66162,0,1,23,26,50
66163,0,0,0,25,25
66164,0,0,7,11,18
66165,0,1,2,17,20
66166,0,0,1,2,3
66167,0,1,17,31,49
66168,1,0,15,34,50
66169,0,0,11,25,36
66170,0,1,3,6,10
66171,0,2,1,13,16
66172,1,1,20,28,50
66173,0,0,7,9,16
66174,0,0,1,9,10
66175,1,0,11,20,32
66176,0,0,5,10,15
66177,0,0,12,15,27
66178,0,0,6,1,7
66179,1,1,1,26,29
66180,0,0,8,9,17
66182,0,0,4,14,18
66183,0,0,2,4,6
66184,0,0,4,9,13
66185,0,0,13,23,36
66186,1,0,8,41,50
66187,0,0,6,15,21
66188,1,0,2,6,9
66189,0,0,4,4,8
66190,0,0,9,20,29
66191,0,0,7,17,24
66192,0,0,5,31,36
66193,0,0,12,23,35
66194,0,1,1,16,18
66195,0,0,9,26,35
66196,0,2,6,21,29
66197,0,2,1,13,16
66198,0,0,5,7,12
66199,0,0,15,35,50
66200,1,1,20,28,50
66201,0,1,3,21,25
66202,0,1,12,33,46
66203,3,0,8,26,37
66205,5,0,0,22,27
66206,0,0,2,9,11
66207,4,1,7,38,50
66208,0,1,12,37,50
66209,0,1,11,38,50
66210,0,3,6,41,50
66211,1,2,2,28,33
66212,0,0,7,20,27
66213,0,0,9,29,38
66214,0,1,1,17,19
66215,0,0,0,8,8
66216,0,1,2,20,23
66217,0,0,10,15,25
66218,0,2,2,23,27
66219,0,0,9,23,32
66220,2,0,1,8,11
66221,0,0,12,19,31
66222,1,0,2,2,5
66223,0,3,6,41,50
66224,0,2,1,13,16
66225,1,0,3,26,30
66226,0,1,1,13,15
66227,1,1,7,38,47
66228,1,0,16,33,50
66229,4,0,6,39,49
66230,0,0,10,21,31
66231,0,0,6,7,13
66233,0,0,0,8,8
66234,0,0,7,17,24
66236,1,3,10,36,50
66238,1,0,17,30,48
66239,1,0,3,21,25
66240,8,1,6,35,50
66242,0,1,8,12,21
66244,0,1,4,25,30
66245,0,0,8,10,18
66246,1,1,4,20,26
66247,3,0,3,25,31
66248,1,0,8,41,50
66249,5,1,0,22,28
66250,0,0,6,37,43
66251,1,0,10,24,35
66252,7,0,0,10,17
66253,5,0,3,19,27
66254,7,1,0,38,46
66255,0,2,13,30,45
66256,1,0,11,32,44
66257,5,1,4,23,33
66259,1,0,11,16,28
66260,0,1,3,6,10
66261,0,0,20,27,47
66262,0,0,10,17,27
66263,0,0,1,7,8
66264,0,0,3,12,15
66265,0,0,9,23,32
66266,0,0,1,7,8
66268,1,0,11,32,44
66269,3,0,3,25,31
66270,0,0,1,7,8
66271,0,0,20,27,47
66272,0,0,10,26,36
66273,0,2,13,30,45
